nom_du_musee,année,region,ville,payant,gratuit,total,id_museofile
Musée de l'Abbaye Saint-Michel,2009,MIDI-PYRENEES,GAILLAC,2613,669,3282,
Musée Raymond Lafage,2009,MIDI-PYRENEES,LISLE-SUR-TARN,1898,4429,6327,
Musée Benoît de Puydt,2009,NORD-PAS-DE-CALAIS,BAILLEUL,6590,0,6590,
Musée Portuaire,2009,NORD-PAS-DE-CALAIS,DUNKERQUE,24543,21642,46185,
Musée Communautaire Opale-Sud,2009,NORD-PAS-DE-CALAIS,BERCK-SUR-MER,2757,7149,9906,
Musée d'Art et d'Histoire Roger Rodière,2009,NORD-PAS-DE-CALAIS,MONTREUIL-SUR-MER,2501,7044,9545,
Musée Baron Gérard,2009,BASSE-NORMANDIE,BAYEUX,3796,8314,12110,
Musée de la Meunerie - Moulin de Marcy,2009,BASSE-NORMANDIE,LE MOLAY-LITTRY,3544,3372,6916,
Château de Saint-Germain de Livet,2009,BASSE-NORMANDIE,SAINT-GERMAIN DE LIVET,9268,12025,21293,
Musée de la Bataille de Tilly-Sur-Seulles 1944,2009,BASSE-NORMANDIE,TILLY-SUR-SEULLES,1678,0,1678,
Musée de l'Abbaye,2009,BASSE-NORMANDIE,CERISY-LA-FORET,5750,1028,6778,
Musée de la Guerre et de la Libération,2009,BASSE-NORMANDIE,CHERBOURG-EN-COTENTIN,9799,5892,15691,
Musée Quesnel-Morinière,2009,BASSE-NORMANDIE,COUTANCES,310,10644,10954,
Musée Maritime de l'Ile de Tatihou,2009,BASSE-NORMANDIE,SAINT-VAAST-LA-HOUGUE,55919,5032,60951,
Musée du Château,2009,BASSE-NORMANDIE,TORIGNI-SUR-VIRE,800,1200,2000,
Musée Municipal - Musée du Jouet,2009,BASSE-NORMANDIE,LA FERTE-MACE,464,152,616,
Musée de l'Ancien Evêché,2009,HAUTE-NORMANDIE,EVREUX,0,19499,19499,
Musée Alphonse-Georges Poulain,2009,HAUTE-NORMANDIE,VERNON,4846,10748,15594,
Maison des Templiers,2009,HAUTE-NORMANDIE,CAUDEBEC-EN-CAUX,816,404,1220,
Musée du Prieuré,2009,HAUTE-NORMANDIE,HARFLEUR,287,3261,3548,
Musée d'Art Moderne André Malraux - MuMa,2009,HAUTE-NORMANDIE,LE HAVRE,39289,25406,64695,
Musée des Traditions et Arts Normands,2009,HAUTE-NORMANDIE,MARTAINVILLE-EPREVILLE,6011,7952,13963,
Association de l'Horlogerie Aliermontaise,2009,HAUTE-NORMANDIE,SAINT-NICOLAS-D'ALIERMONT,3626,1484,5110,
Musée Victor Hugo,2009,HAUTE-NORMANDIE,VILLEQUIER,5250,8713,13963,
Musée Municipal des Ivoires,2009,HAUTE-NORMANDIE,YVETOT,965,281,1246,
Musée des Marais Salant,2009,PAYS DE LA LOIRE,BATZ-SUR-MER,11844,1115,12959,
Musée  Départemental Dobrée,2009,PAYS DE LA LOIRE,NANTES,5143,32826,37969,
Maison de l'Eclusier /Parc Naturel Régional de Brière,2009,PAYS DE LA LOIRE,SAINT-MALO DE GUERSAC,3806,585,4391,
Ecomusée de Saint-Nazaire,2009,PAYS DE LA LOIRE,SAINT-NAZAIRE,7048,12525,19573,
Musée des Beaux-Arts,2009,PAYS DE LA LOIRE,ANGERS,19577,62408,81985,
Musée Joseph Denais,2009,PAYS DE LA LOIRE,BEAUFORT-EN-VALLEE,0,263,263,
Musée d'Art et d'Histoire,2009,PAYS DE LA LOIRE,CHOLET,1533,13450,14983,
Musée du Textile,2009,PAYS DE LA LOIRE,CHOLET,5440,9047,14487,
Musée de la Vigne et du Vin d'Anjou,2009,PAYS DE LA LOIRE,SAINT LAMBERT-DU-LATTAY - VAL-DU-LAYON,4371,1269,5640,
Musée de l'Ardoise,2009,PAYS DE LA LOIRE,TRELAZE,8951,3813,12764,
Centre Minier de Faymoreau,2009,PAYS DE LA LOIRE,FAYMOREAU,21520,7437,28957,
Musée des Traditions de l'Île,2009,PAYS DE LA LOIRE,LA GUERINIERE,5432,358,5790,
Musée Milcendeau Jean-Yole,2009,PAYS DE LA LOIRE,SOULLANS,1562,2086,3648,
Musée Jeanne d'Aboville,2009,PICARDIE,LA FERE,173,163,336,
Musée Antoine Vivenel,2009,PICARDIE,COMPIEGNE,1631,10065,11696,
Musée Gallé-Juillet,2009,PICARDIE,CREIL,2521,5392,7913,
Musée de l'Archerie et de l'Art Sacré,2009,PICARDIE,CREPY-EN-VALOIS,3134,2781,5915,
Musée de la Vénerie,2009,PICARDIE,SENLIS,9052,6771,15823,
Musée Boucher-de-Perthes,2009,PICARDIE,ABBEVILLE,12552,0,12552,
Musée de Picardie,2009,PICARDIE,AMIENS,908,12053,12961,
Atelier - Musée du Papier,2009,POITOU-CHARENTES,ANGOULEME,0,12132,12132,
Musée du Nouveau Monde,2009,POITOU-CHARENTES,LA ROCHELLE,4110,9653,13763,
Muséum d'Histoire Naturelle,2009,POITOU-CHARENTES,LA ROCHELLE,9389,30229,39618,
Musée d'Orbigny-Bernon,2009,POITOU-CHARENTES,LA ROCHELLE,2234,6543,8777,
Musée de la Maison de Pierre Loti,2009,POITOU-CHARENTES,ROCHEFORT,26354,3206,29560,
Musée de l'Echevinage,2009,POITOU-CHARENTES,SAINTES,914,3685,4599,
Musée Ernest Cognacq,2009,POITOU-CHARENTES,SAINT-MARTIN-DE-RE,8298,3461,11759,
Musée de l'Ile d'Oléron,2009,POITOU-CHARENTES,ST-PIERRE D'OLERON,10630,2930,13560,
Musée des Tumulus de Bougon,2009,POITOU-CHARENTES,BOUGON,12135,12025,24160,
Musée Henri Barré,2009,POITOU-CHARENTES,THOUARS,642,1923,2565,
Musée Municipal de l'Hôtel de Sully,2009,POITOU-CHARENTES,CHATELLERAULT,0,2741,2741,
Musée des Traditions Populaires et d'Archéologie,2009,POITOU-CHARENTES,CHAUVIGNY,7781,2891,10672,
Musée de la vallée,2009,PROVENCE-ALPES-CÔTE D'AZUR,BARCELONNETTE,11218,1526,12744,
Musée Gassendi,2009,PROVENCE-ALPES-CÔTE D'AZUR,DIGNE-LES-BAINS,2355,6563,8918,
Musée départemental de préhistoire,2009,PROVENCE-ALPES-CÔTE D'AZUR,QUINSON,61647,13475,75122,
Musée Archéologique,2009,PROVENCE-ALPES-CÔTE D'AZUR,RIEZ-LA-ROMAINE,476,467,943,
Musée du Vieux Sisteron,2009,PROVENCE-ALPES-CÔTE D'AZUR,SISTERON,0,385,385,
Musée de la Mer,2009,PROVENCE-ALPES-CÔTE D'AZUR,CANNES,48638,35821,84459,
Musée Départemental des Arts Asiatiques,2009,PROVENCE-ALPES-CÔTE D'AZUR,NICE,9028,77200,86228,
Musée des Beaux-Arts Jules Chéret,2009,PROVENCE-ALPES-CÔTE D'AZUR,NICE,0,66756,66756,
Musée Matisse,2009,PROVENCE-ALPES-CÔTE D'AZUR,NICE,0,134990,134990,
Musée Départemental des Merveilles,2009,PROVENCE-ALPES-CÔTE D'AZUR,TENDE,0,32987,32987,
Musée du Parlement de Provence et du Vieil Aix,2009,PROVENCE-ALPES-CÔTE D'AZUR,AIX-EN-PROVENCE,0,15482,15482,
Musée du Pavillon de Vendôme,2009,PROVENCE-ALPES-CÔTE D'AZUR,AIX-EN-PROVENCE,6018,11102,17120,
Musée Granet,2009,PROVENCE-ALPES-CÔTE D'AZUR,AIX-EN-PROVENCE,335023,114686,449709,
Musée Paul Arbaud,2009,PROVENCE-ALPES-CÔTE D'AZUR,AIX-EN-PROVENCE,568,1931,2499,
Musée d'Histoire et d'Archéologie des Baux-de-Provence,2009,PROVENCE-ALPES-CÔTE D'AZUR,LES BAUX DE PROVENCE,223838,36454,260292,
Musée Frédéric Mistral,2009,PROVENCE-ALPES-CÔTE D'AZUR,MAILLANE,2331,3298,5629,
Muséum d'Histoire Naturelle,2009,PROVENCE-ALPES-CÔTE D'AZUR,MARSEILLE,11169,43296,54465,
Musée Ziem,2009,PROVENCE-ALPES-CÔTE D'AZUR,MARTIGUES,0,16172,16172,
Musée des Alpilles,2009,PROVENCE-ALPES-CÔTE D'AZUR,SAINT-REMY-DE-PROVENCE,2967,6137,9104,
Musée Municipal,2009,PROVENCE-ALPES-CÔTE D'AZUR,DRAGUIGNAN,0,12002,12002,
Muséum d'Histoire Naturelle de Toulon,2009,PROVENCE-ALPES-CÔTE D'AZUR,TOULON,0,40794,40794,
Musée National de la Marine de Toulon,2009,PROVENCE-ALPES-CÔTE D'AZUR,TOULON,15757,35629,51386,
Musée d'Apt,2009,PROVENCE-ALPES-CÔTE D'AZUR,APT,2869,5706,8575,
Musée Municipal,2009,PROVENCE-ALPES-CÔTE D'AZUR,SAULT,57,1277,1334,
Musée du Brou,2009,RHONE-ALPES,BOURG-EN-BRESSE,47734,22081,69815,
Musée de la Résistance et de la Déportation de l'Ain,2009,RHONE-ALPES,NANTUA,5769,3891,9660,
Musée du Peigne et de la Plasturgie,2009,RHONE-ALPES,OYONNAX,2452,2878,5330,
Musée et Site Archéologiques,2009,RHONE-ALPES,SOYONS,10356,2138,12494,
Musée des Beaux-Arts,2009,RHONE-ALPES,VALENCE,589,9914,10503,
Musée Lapidaire Saint-Pierre,2009,RHONE-ALPES,VIENNE,2387,3959,6346,
Musée d'Allard,2009,RHONE-ALPES,MONTBRISON,2898,5923,8821,
Musée de la Diana,2009,RHONE-ALPES,MONTBRISON,1643,0,1643,
Musée des Beaux-Arts et d'Archéologie J. Dechelette,2009,RHONE-ALPES,ROANNE,2741,10701,13442,
Musée d'Art et d'Industrie,2009,RHONE-ALPES,SAINT-ETIENNE,19465,13744,33209,
Musées Gadagne,2009,RHONE-ALPES,LYON,32397,37190,69587,
Centre d'Histoire de la Résistance et de la Déportation,2009,RHONE-ALPES,LYON,15932,39939,55871,
Musée de la Poterie,2010,ALSACE,BETSCHDORF,2048,620,2668,
Musée des Beaux-Arts,2010,ALSACE,STRASBOURG,8491,37139,45630,
Musée Sundgauvien d'Altkirch,2010,ALSACE,ALTKIRCH,2529,1538,4067,
Musée Bartholdi,2010,ALSACE,COLMAR,7574,3673,11247,
Musée d'Histoire Naturelle et d'Ethnographie de Colmar,2010,ALSACE,COLMAR,7353,4635,11988,
Musée Historique et Militaire de Huningue,2010,ALSACE,HUNINGE,177,242,419,
Musée Historique,2010,ALSACE,MULHOUSE,0,34312,34312,
Musée EDF Electropolis,2010,ALSACE,MULHOUSE,24681,11186,35867,
Musée du Dolder,2010,ALSACE,RIQUEWIHR,2800,625,3425,
Musée des Amis de Thann,2010,ALSACE,THANN,635,1036,1671,
Musée Paul Reclus,2010,AQUITAINE,DOMME,324,11694,12018,
Musée d'Art et d'Archéologie du Périgord (MAAP),2010,AQUITAINE,PERIGUEUX,7210,14385,21595,
Musée du Site Médiéval,2010,AQUITAINE,SAINT-AVIT-SENIEUR,0,5000,5000,
Muséum d'Histoire Naturelle de Bordeaux,2010,AQUITAINE,BORDEAUX,1016,9830,10846,
Musée Archéologique,2010,AQUITAINE,HASTINGUES,3883,5955,9838,
Musée des Beaux-Arts,2010,AQUITAINE,AGEN,11144,19442,30586,
Musée Municipal Albert Marzelles,2010,AQUITAINE,MARMANDE,0,4798,4798,
Musée Municipal (Moulin de Gajac),2010,AQUITAINE,VILLENEUVE-SUR-LOT,4146,3899,8045,
Musée Municipal,2010,AQUITAINE,ARUDY,1264,360,1624,
Musée Municipal de Guéthary,2010,AQUITAINE,GUETHARY,702,1445,2147,
Musée National du Château,2010,AQUITAINE,PAU,70452,86458,156910,
Musée Municipal des Beaux-Arts,2010,AQUITAINE,PAU,32496,0,32496,
Musée Bernadotte,2010,AQUITAINE,PAU,6141,0,6141,
Musée Municipal de Gannat,2010,AUVERGNE,GANNAT,812,930,1742,
Musée d'Art et d'Archéologie,2010,AUVERGNE,AURILLAC,1874,14821,16695,
Ecomusée de Margeride-Haute-Auvergne,2010,AUVERGNE,RUYNES-EN-MARGERIDE,9904,2965,12869,
Musée des Peintres de l'Ecole de Murols,2010,AUVERGNE,MUROL,3847,372,4219,
Musée Francisque Mandet,2010,AUVERGNE,RIOM,624,2947,3571,
Musée du Vin de Bourgogne,2010,BOURGOGNE,BEAUNE,20526,3316,23842,
Musée du Pays Châtillonnais - Trésor de Vix,2010,BOURGOGNE,CHATILLON-SUR-SEINE,21283,6427,27710,
Musée Archéologique,2010,BOURGOGNE,DIJON,0,20312,20312,
Musée des Beaux-Arts,2010,BOURGOGNE,DIJON,0,154127,154127,
Musée Auguste Grasset,2010,BOURGOGNE,VARZY,1646,1056,2702,
Musée Rolin,2010,BOURGOGNE,AUTUN,12453,7550,20003,
Musée d'Art et d'Archéologie,2010,BOURGOGNE,CLUNY,111190,41990,153180,
Ecomusée de la Bresse Bourguignonne,2010,BOURGOGNE,PIERRE-DE-BRESSE,25079,13216,38295,
Musée Départemental de Préhistoire de Solutré,2010,BOURGOGNE,SOLUTRE-POUILLY,15363,11515,26878,
Musée de l'Aventure du Son,2010,BOURGOGNE,SAINT-FARGEAU,4589,234,4823,
Musée d'Art et d'Histoire,2010,BRETAGNE,SAINT-BRIEUC,0,39422,39422,
Ecomusée d'Ouessant - Vivre sur une Ile,2010,BRETAGNE,OUESSANT,5838,4313,10151,
Musée de Pont-Aven,2010,BRETAGNE,PONT-AVEN,31415,11858,43273,
Musée Bigouden,2010,BRETAGNE,PONT-L'ABBE,12420,1983,14403,
Musée Départemental Breton,2010,BRETAGNE,QUIMPER,28231,11944,40175,
Musée de la Faucillonnaie,2010,BRETAGNE,MONTREUIL-SOUS-PEROUSE,15,181,196,
Ecomusée du Pays de Rennes,2010,BRETAGNE,RENNES,12747,32438,45185,
Musée des Meilleurs Ouvriers de France,2010,CENTRE,BOURGES,0,19756,19756,
Musée de l'Hospice Saint-Roch,2010,CENTRE,ISSOUDUN,143,19017,19160,
Musée de Préhistoire du Grand Pressigny,2010,CENTRE,LE GRAND PRESSIGNY,10398,8413,18811,
Musée des Beaux-Arts,2010,CENTRE,TOURS,18794,34303,53097,
Musée de Minerve,2010,CENTRE,YZEURES-SUR-CREUSE,0,700,700,
Muséum d'Histoire Naturelle,2010,CENTRE,BLOIS,4890,8893,13783,
Maison de la Magie,2010,CENTRE,BLOIS,60678,18867,79545,
Musée de Vendôme,2010,CENTRE,VENDOME,1372,7764,9136,
Musée Municipal Théâtre Forain et Archéologique,2010,CENTRE,ARTENAY,6275,3779,10054,
Château-Musée de Gien,2010,CENTRE,GIEN,15842,3042,18884,
Musée du Gatinais,2010,CENTRE,MONTARGIS,0,97,97,
Musée Historique et Archéologique,2010,CENTRE,ORLEANS,761,2888,3649,
Musée des Beaux-Arts,2010,CENTRE,ORLEANS,8711,44845,53556,
Pharmacie Musée de l'Hôtel-Dieu,2010,CHAMPAGNE-ARDENNES,TROYES,2778,2778,5556,
Musée d'Art et d'Histoire,2010,CHAMPAGNE-ARDENNES,LANGRES,4386,3201,7587,
Musée Hôtel le Vergeur,2010,CHAMPAGNE-ARDENNES,REIMS,7574,5990,13564,
Musée de la Maison Bonaparte,2010,CORSE,AJACCIO,48960,20334,69294,
Musée de l'Alta Rocca,2010,CORSE,LEVIE,6592,6437,13029,
Musée d'Histoire de Bastia,2010,CORSE,BASTIA,10139,5630,15769,
Muséum de Besançon,2010,FRANCHE-COMTE,BESANCON,189664,43489,233153,
Musée du Jouet,2010,FRANCHE-COMTE,MOIRANS-EN-MONTAGNE,16565,1567,18132,
Musée des Cultures Guyanaises,2010,GUYANE,CAYENNE,1405,7875,9280,
Musée du Château,2010,ILE-DE-FRANCE,DOURDAN,9814,7149,16963,
Musée Intercommunal d'Etampes,2010,ILE-DE-FRANCE,ETAMPES,1563,12630,14193,
Musée Départemental Albert-Kahn,2010,ILE-DE-FRANCE,BOULOGNE-BILLANCOURT,78417,35149,113566,
Musée Municipal d'Art et d'Histoire,2010,ILE-DE-FRANCE,COLOMBES,0,6628,6628,
Musée - Atelier Rodin (Annexe du musée de Paris),2010,ILE-DE-FRANCE,MEUDON,3560,3718,7278,
Musée des Automates,2010,ILE-DE-FRANCE,NEUILLY-SUR-SEINE,0,1382,1382,
Musée Municipal de Saint-Cloud,2010,ILE-DE-FRANCE,SAINT-CLOUD,1240,18675,19915,
Etablissement public du musée d'Orsay et de l'Orangerie - Musée d'Orsay,2010,ILE-DE-FRANCE,PARIS,1637995,1347515,2985510,
Musée de la Franc-Maçonnerie,2010,ILE-DE-FRANCE,PARIS,12451,3307,15758,
Musée de Montmartre,2010,ILE-DE-FRANCE,PARIS,34928,2928,37856,
Musée Zadkine,2010,ILE-DE-FRANCE,PARIS,15712,10984,26696,
Mémorial du Maréchal Leclerc de Hauteclocque et de la Libération de Paris-musée Jean Moulin,2010,ILE-DE-FRANCE,PARIS,3379,12073,15452,
Musée National Auguste Rodin,2010,ILE-DE-FRANCE,PARIS,438217,276051,714268,
Musée du Louvre,2010,ILE-DE-FRANCE,PARIS,5162394,3184027,8346421,
Musée de la Chasse et de la Nature,2010,ILE-DE-FRANCE,PARIS,19954,19381,39335,
Musée d'Art et d'Histoire du Judaïsme,2010,ILE-DE-FRANCE,PARIS,85361,41860,127221,
Musée National des Techniques,2010,ILE-DE-FRANCE,PARIS,83588,126460,210048,
Musée du Service de Santé des Armées du Val-de-Grâce,2010,ILE-DE-FRANCE,PARIS,7464,6393,13857,
Musée de la Poste,2010,ILE-DE-FRANCE,PARIS,25977,59712,85689,
Musée du Château de Fontainebleau,2010,ILE-DE-FRANCE,FONTAINEBLEAU,212716,168109,380825,
Ecomusée,2010,ILE-DE-FRANCE,SAVIGNY-LE-TEMPLE,0,9055,9055,
Musée de l'Air et de l'Espace,2010,ILE-DE-FRANCE,LE BOURGET,164034,88973,253007,
Musée Emile Jean,2010,ILE-DE-FRANCE,VILLIERS-SUR-MARNE,0,1500,1500,
Musée de la Renaissance - Château d'Ecouen,2010,ILE-DE-FRANCE,ECOUEN,16658,42393,59051,
Musée Archéologique du Val d'Oise,2010,ILE-DE-FRANCE,GUIRY-EN-VEXIN,0,9164,9164,
Musée Camille Pissarro,2010,ILE-DE-FRANCE,PONTOISE,0,3799,3799,
Musée du Jouet Pierre Pinel,2010,ILE-DE-FRANCE,POISSY,12239,4524,16763,
Musée Départemental Maurice Denis,2010,ILE-DE-FRANCE,SAINT-GERMAIN-EN-LAYE,10799,16614,27413,
Muséum Agricole et Industriel Stella Matutina,2010,LA REUNION,PITON-SAINT-LEU,40790,11371,52161,
Musée Archéologique,2010,LANGUEDOC-ROUSSILLON,SALLELES D'AUDE,6850,0,6850,
Musée Albert André,2010,LANGUEDOC-ROUSSILLON,BAGNOLS-SUR-CEZE,343,4204,4547,
Musée Cévenol,2010,LANGUEDOC-ROUSSILLON,LE VIGAN,2711,1781,4492,
Musée d'Histoire Naturelle et de Préhistoire,2010,LANGUEDOC-ROUSSILLON,NIMES,0,65417,65417,
Musée Paul Raymond,2010,LANGUEDOC-ROUSSILLON,PONT-SAINT-ESPRIT,0,1182,1182,
Musée Municipal Georges Borias,2010,LANGUEDOC-ROUSSILLON,UZES,1212,1409,2621,
Musée des Beaux-Arts de Béziers,2010,LANGUEDOC-ROUSSILLON,BEZIERS,4335,11223,15558,
Musée de l'Etang de Thau,2010,LANGUEDOC-ROUSSILLON,BOUZIGUES,15693,258,15951,
Musée Municipal,2010,LANGUEDOC-ROUSSILLON,FRONTIGNAN-LA-PEYRADE,0,5113,5113,
Musée Archéologique,2010,LANGUEDOC-ROUSSILLON,MINERVE,6272,0,6272,
Musée Paul Valéry,2010,LANGUEDOC-ROUSSILLON,SETE,47250,6361,53611,
Musée du Président Jacques Chirac,2010,LIMOUSIN,SARRAN,50165,9126,59291,
Musée du Pays d'Ussel,2010,LIMOUSIN,USSEL,0,4542,4542,
Musée Départemental d'Art Contemporain,2010,LIMOUSIN,ROCHECHOUART,6994,5532,12526,
Musée Municipal des Emaux et Faïences,2010,LORRAINE,LONGWY,4023,2031,6054,
Musée des Beaux-Arts de Nancy,2010,LORRAINE,NANCY,41273,56755,98028,
Musée Jeanne d'Arc,2010,LORRAINE,VAUCOULEURS,572,1113,1685,
Musée de la Princerie,2010,LORRAINE,VERDUN,1990,2400,4390,
Maison du Verre et du Cristal,2010,LORRAINE,MEISENTHAL,14494,3249,17743,
Musées de la Cour d'Or,2010,LORRAINE,METZ,17091,29667,46758,
Musée de la Lutherie et de l'Archèterie Française,2010,LORRAINE,MIRECOURT,6289,4177,10466,
Musée Charles Friry,2010,LORRAINE,REMIREMONT,369,1701,2070,
Musée Pierre Noël - Musée de la Vie dans les Hautes-Vosges,2010,LORRAINE,SAINT-DIE-DES-VOSGES,4326,9769,14095,
Musée Régional d'Histoire et d'Ethnologie,2010,MARTINIQUE,FORT-DE-FRANCE,2408,2661,5069,
Musée Départemental de l'Ariège,2010,MIDI-PYRENEES,FOIX,80492,6677,87169,
Musée du Textile et du Peigne en Corne,2010,MIDI-PYRENEES,LAVELANET,1050,170,1220,
Musée Fenaille,2010,MIDI-PYRENEES,RODEZ,5726,14469,20195,
Musée du Charroi Rural et de l'Artisanat Traditionnel,2010,MIDI-PYRENEES,SALMIECH,500,1510,2010,
Musée de l'Armagnac,2010,MIDI-PYRENEES,CONDOM,3434,377,3811,
Musée Archéologique,2010,MIDI-PYRENEES,EAUZE,3840,1749,5589,
Musée des Beaux-Arts et des Arts Décoratifs,2010,MIDI-PYRENEES,MIRANDE,600,505,1105,
Musée Municipal,2010,MIDI-PYRENEES,MARTRES-TOLOSANE,940,5088,6028,
Musée Paul Dupuy,2010,MIDI-PYRENEES,TOULOUSE,3419,7689,11108,
Musée Pyrénéen,2010,MIDI-PYRENEES,LOURDES,68591,3909,72500,
Musée-château Gaston Phébus,2010,MIDI-PYRENEES,MAUVEZIN,33636,0,33636,
Musée Municipal,2010,MIDI-PYRENEES,VAYRAC,187,0,187,
Musée Toulouse Lautrec,2010,MIDI-PYRENEES,ALB,125775,35647,161422,
Musée des Beaux-Arts,2010,MIDI-PYRENEES,GAILLAC,1733,2721,4454,
Musée Raymond Lafage,2010,MIDI-PYRENEES,LISLE-SUR-TARN,1198,2997,4195,
Musée du Vieil Auvillar,2010,MIDI-PYRENEES,AUVILLAR,2276,808,3084,
Musée d'Histoire Naturelle Victor Brun,2010,MIDI-PYRENEES,MONTAUBAN,1130,6261,7391,
Musée Ingres,2010,MIDI-PYRENEES,MONTAUBAN,17019,25333,42352,
Musée de l'Ostrevant,2010,NORD-PAS-DE-CALAIS,BOUCHAIN,293,519,812,
Lieu d'Art et Action Contemporaine de Dunkerque - LAAC,2010,NORD-PAS-DE-CALAIS,DUNKERQUE,23408,0,23408,
Musée des Beaux-Arts,2010,NORD-PAS-DE-CALAIS,DUNKERQUE,8716,0,8716,
Ecomusée de la Région,2010,NORD-PAS-DE-CALAIS,FOURMIES,32258,16555,48813,
Musée Municipal d'Hazebrouck,2010,NORD-PAS-DE-CALAIS,HAZEBROUCK,772,3690,4462,
Musée de l'Hospice Comtesse,2010,NORD-PAS-DE-CALAIS,LILLE,66312,0,66312,
Palais des Beaux-Arts de Lille,2010,NORD-PAS-DE-CALAIS,LILLE,90674,115938,206612,
Musée d'Art et d'Industrie,2010,NORD-PAS-DE-CALAIS,TOURCOING,8058,16117,24175,
Musée d'Art Moderne de Lille Métropole,2010,NORD-PAS-DE-CALAIS,VILLENEUVE-D'ASCQ,48843,39919,88762,
Musée d'Histoire et d'Archéologie,2010,NORD-PAS-DE-CALAIS,HARNES,0,1106,1106,
Musée Municipal,2010,NORD-PAS-DE-CALAIS,LE TOUQUET-PARIS-PLAGE,3223,2124,5347,
Musée d'Initiation à la Nature,2010,BASSE-NORMANDIE,CAEN,0,3043,3043,
Musée d'Ethnographie et d'Arts Populaires et Musée de la Marine,2010,BASSE-NORMANDIE,HONFLEUR,16485,988,17473,
Musée de la Mine,2010,BASSE-NORMANDIE,LE MOLAY-LITTRY,5537,56,5593,
Musée de la Meunerie - Moulin de Marcy,2010,BASSE-NORMANDIE,LE MOLAY-LITTRY,4455,3146,7601,
Château de Saint-Germain de Livet,2010,BASSE-NORMANDIE,SAINT-GERMAIN DE LIVET,8249,11516,19765,
Musée de la Bataille de Tilly-Sur-Seulles 1944,2010,BASSE-NORMANDIE,TILLY-SUR-SEULLES,539,691,1230,
Musée de la Pomme et de la Poire,2010,BASSE-NORMANDIE,BARENTON,525,2664,3189,
Musée Thomas Henry,2010,BASSE-NORMANDIE,CHERBOURG-EN-COTENTIN,0,28130,28130,
Musée de la Guerre et de la Libération,2010,BASSE-NORMANDIE,CHERBOURG-EN-COTENTIN,5240,7731,12971,
Musée Christian Dior,2010,BASSE-NORMANDIE,GRANVILLE,37643,8980,46623,
Musée des Beaux-Arts,2010,BASSE-NORMANDIE,SAINT-LO,2181,6432,8613,
Musée du Granit,2010,BASSE-NORMANDIE,SAINT-MICHEL-DE-MONTJOIE,1250,496,1746,
Musée du Château,2010,BASSE-NORMANDIE,TORIGNI-SUR-VIRE,100,700,800,
Musée des Beaux-Arts et de la Dentelle,2010,BASSE-NORMANDIE,ALENCON,8801,7413,16214,
Musée du Percheron,2010,BASSE-NORMANDIE,MORTAGNE-AU-PERCHE,0,864,864,
Musée Municipal,2010,HAUTE-NORMANDIE,BERNAY,3578,12708,16286,
Musée de l'Ancien Evêché,2010,HAUTE-NORMANDIE,EVREUX,0,18051,18051,
Musée Alfred Canel,2010,HAUTE-NORMANDIE,PONT-AUDEMER,1221,3417,4638,
Musée Alphonse-Georges Poulain,2010,HAUTE-NORMANDIE,VERNON,7152,12493,19645,
Pavillon Flaubert,2010,HAUTE-NORMANDIE,CANTELEU,0,785,785,
Muséum d'Histoire Naturelle,2010,HAUTE-NORMANDIE,LE HAVRE,0,38065,38065,
Musée des Traditions et Arts Normands,2010,HAUTE-NORMANDIE,MARTAINVILLE-EPREVILLE,8773,9324,18097,
Musée-Maison Natale Pierre Corneille,2010,HAUTE-NORMANDIE,ROUEN,0,3985,3985,
Musée Flaubert et d'Histoire de la Médecine,2010,HAUTE-NORMANDIE,ROUEN,4327,5250,9577,
Musée d'Art de Nantes,2010,PAYS DE LA LOIRE,NANTES,48299,79674,127973,
Musée du Château des Ducs de Bretagne,2010,PAYS DE LA LOIRE,NANTES,93303,95376,188679,
Musée du Chaume/Kerhinet - PNR Brière,2010,PAYS DE LA LOIRE,SAINT-LYPHARD,0,50349,50349,
Musée d'Art et d'Histoire,2010,PAYS DE LA LOIRE,CHOLET,1572,14419,15991,
Musée du Vieux Château,2010,PAYS DE LA LOIRE,LAVAL,6609,12188,18797,
Ecomusée du Marais Breton Vendéen,2010,PAYS DE LA LOIRE,LA BARRE-DE-MONTS,21994,9202,31196,
Musée Clemenceau et de Lattre-de-Tassigny,2010,PAYS DE LA LOIRE,MOUILLERON-EN-PAREDS,1571,4605,6176,
Musée Municipal de Soissons,2010,PICARDIE,SOISSONS,0,25603,25603,
Musée de la Résistance et de la Déportation,2010,PICARDIE,TERGNIER,19013,0,19013,
Musée du Château de Compiègne,2010,PICARDIE,COMPIEGNE,36512,51498,88010,
Musée de Picardie,2010,PICARDIE,AMIENS,8620,31702,40322,
Musée des Arts du Cognac (Annexe musée municipal),2010,POITOU-CHARENTES,COGNAC,6716,5316,12032,
Musée Régional de Fouras,2010,POITOU-CHARENTES,FOURAS,4993,1468,6461,
Musée Napoléonien et Africain,2010,POITOU-CHARENTES,ILE D'AIX,12778,10606,23384,
Muséum d'Histoire Naturelle,2010,POITOU-CHARENTES,LA ROCHELLE,9254,32422,41676,
Musée Archéologique,2010,POITOU-CHARENTES,SAINTES,1118,41690,42808,
Musée de Bressuire,2010,POITOU-CHARENTES,BRESSUIRE,0,4722,4722,
Musée Bernard d’Agesci,2010,POITOU-CHARENTES,NIORT,3048,9055,12103,
Musée Charbonneau-Lassay,2010,POITOU-CHARENTES,LOUDUN,0,538,538,
Musée Archéologique,2010,PROVENCE-ALPES-CÔTE D'AZUR,RIEZ-LA-ROMAINE,618,706,1324,
Musée National Marc Chagall,2010,PROVENCE-ALPES-CÔTE D'AZUR,NICE,100268,50708,150976,
Musée Archéologique - Site de Terra Amata,2010,PROVENCE-ALPES-CÔTE D'AZUR,NICE,0,16897,16897,
Musée du Parlement de Provence et du Vieil Aix,2010,PROVENCE-ALPES-CÔTE D'AZUR,AIX-EN-PROVENCE,0,28335,28335,
Musée des Tapisseries,2010,PROVENCE-ALPES-CÔTE D'AZUR,AIX-EN-PROVENCE,4267,18729,22996,
Musée Réattu,2010,PROVENCE-ALPES-CÔTE D'AZUR,ARLES,9898,26393,36291,
Musée Départemental de l'Arles Antique,2010,PROVENCE-ALPES-CÔTE D'AZUR,ARLES,170029,153108,323137,
Musée Municipal Méditerranéen de Cassis A.T.P.,2010,PROVENCE-ALPES-CÔTE D'AZUR,CASSIS,64,4324,4388,
Musée Ciotaden,2010,PROVENCE-ALPES-CÔTE D'AZUR,LA CIOTAT,2968,3148,6116,
Fondation Louis Jou,2010,PROVENCE-ALPES-CÔTE D'AZUR,LES-BAUX-DE-PROVENCE,800,1600,2400,
Musée d'Histoire de Marseille,2010,PROVENCE-ALPES-CÔTE D'AZUR,MARSEILLE,10325,29557,39882,
Musée d'Archéologie Méditerranéenne,2010,PROVENCE-ALPES-CÔTE D'AZUR,MARSEILLE,5736,22957,28693,
Musée Cantini,2010,PROVENCE-ALPES-CÔTE D'AZUR,MARSEILLE,7878,16475,24353,
Musée de Salon et de la Crau,2010,PROVENCE-ALPES-CÔTE D'AZUR,SALON-DE-PROVENCE,0,17221,17221,
Musée des Troupes de Marine,2010,PROVENCE-ALPES-CÔTE D'AZUR,FREJUS,0,16027,16027,
Musée de l'Hôtel Dieu,2010,PROVENCE-ALPES-CÔTE D'AZUR,CAVAILLON,2273,0,2273,
Musée Marc Deydier,2010,PROVENCE-ALPES-CÔTE D'AZUR,CUCURON,0,7323,7323,
Musée-Bibliothèque François Pétrarque,2010,PROVENCE-ALPES-CÔTE D'AZUR,FONTAINE-DE-VAUCLUSE,2773,1757,4530,
Musée Archéologique,2010,RHONE-ALPES,IZERNORE,295,430,725,
Musée du Bugey-Valmorey,2010,RHONE-ALPES,LOCHIEU,2017,2068,4085,
Musée Chintreuil,2010,RHONE-ALPES,PONT-DE-VAUX,4745,1238,5983,
Musée de la Bresse - Domaine des Planons,2010,RHONE-ALPES,SAINT-CYR-SUR-MENTHON,13156,7963,21119,
Musée et Site Archéologiques,2010,RHONE-ALPES,SOYONS,11095,2190,13285,
Musée du Rhône,2010,RHONE-ALPES,TOURNON-SUR-RHÔNE,6738,6621,13359,
Musée International de la Chaussure,2010,RHONE-ALPES,ROMANS,19094,16756,35850,
Musée Géo-Charles,2010,RHONE-ALPES,ECHIROLLES,0,6190,6190,
Musée de Grenoble,2010,RHONE-ALPES,GRENOBLE,55992,112440,168432,
Musée Dauphinois,2010,RHONE-ALPES,GRENOBLE,0,57205,57205,
Maison du Patrimoine de Hières-sur-Amby,2010,RHONE-ALPES,HIERES SUR AMBY,4550,1622,6172,
Musée Hébert,2010,RHONE-ALPES,LA TRONCHE,0,27852,27852,
Musée Alice Taverne,2010,RHONE-ALPES,AMBIERLE,4078,641,4719,
Musée Hospitalier,2010,RHONE-ALPES,CHARLIEU,2777,1386,4163,
Atelier - Musée du Chapeau,2010,RHONE-ALPES,CHAZELLES-SUR-LYON,10486,3638,14124,
Musée d'Art et d'Industrie,2010,RHONE-ALPES,SAINT-ETIENNE,20486,19628,40114,
Musée d'Art Moderne et Contemporain,2010,RHONE-ALPES,SAINT-ETIENNE,27348,23231,50579,
Musée des Civilisations : Daniel Pouget,2010,RHONE-ALPES,SAINT-JUST-SAINT-RAMBERT,3123,7751,10874,
Musée Folklorique et Traditions Populaires Marius Audin,2010,RHONE-ALPES,BEAUJEU,1895,728,2623,
Musée Historique des Tissus,2010,RHONE-ALPES,LYON,51937,29766,81703,
Musée des Hospices Civils de Lyon,2010,RHONE-ALPES,LYON,4775,6254,11029,
Musée Municipal,2010,ST PIERRE ET MIQUELON,SAINT-PIERRE ET MIQUELON,1621,1306,2927,
Musée de la Folie Marco,2011,ALSACE,BARR,2461,2771,5232,
Musée de Bouxwiller et du pays de hanau,2011,ALSACE,BOUXWILLER,884,110,994,
Musée Archéologique,2011,ALSACE,STRASBOURG,9441,31445,40886,
Musée Zoologique de Strasbourg,2011,ALSACE,STRASBOURG,9057,23312,32369,
Musée de l'Œuvre Notre-Dame,2011,ALSACE,STRASBOURG,9858,23662,33520,
Musée J.F. Oberlin,2011,ALSACE,WALDERSBACH,20092,7266,27358,
Musée Gallo-Romain,2011,ALSACE,BIESHEIM,693,1844,2537,
Musée d'Unterlinden,2011,ALSACE,COLMAR,151000,26100,177100,
Musée Théodore Deck et des Pays du Florival,2011,ALSACE,GUEBWILLER,1388,4189,5577,
Musée Historique et Militaire de Huningue,2011,ALSACE,HUNINGE,172,233,405,
Musée du Vignoble et des Vins d'Alsace,2011,ALSACE,KAYSERSBERG VIGNOBLE,3586,0,3586,
Maison du Sundgau - Musée Paysan,2011,ALSACE,OLTINGUE,1169,183,1352,
Ecomusée d'Alsace,2011,ALSACE,UNGERSHEIM,180774,0,180774,
Musée Gallo-Romain de Vesunna,2011,AQUITAINE,PERIGUEUX,18665,11695,30360,
CAPC Musée d'Art Contemporain de Bordeaux,2011,AQUITAINE,BORDEAUX,38405,108598,147003,
Musée de Borda,2011,AQUITAINE,DAX,2671,6757,9428,
Musée du Château Henri IV,2011,AQUITAINE,NERAC,19628,8086,27714,
Muséum d'Histoire Naturelle,2011,AQUITAINE,BAYONNE,0,23514,23514,
Musée Municipal de Guéthary,2011,AQUITAINE,GUETHARY,836,1795,2631,
Musée Charles-Louis Philippe,2011,AUVERGNE,CERILLY,209,76,285,
Musée Anne de Beaujeu,2011,AUVERGNE,MOULINS,27441,0,27441,
Musée Rieckotter,2011,AUVERGNE,NERIS-LES-BAINS,900,620,1520,
Musée des Sciences,2011,AUVERGNE,AURILLAC,4630,8600,13230,
Musée de la Haute Auvergne,2011,AUVERGNE,SAINT-FLOUR,2801,2171,4972,
Muséum d'Histoire Naturelle Henri-Lecoq,2011,AUVERGNE,CLERMONT-FERRAND,2348,15165,17513,
Musée des Pénitents Blancs,2011,AUVERGNE,MARSAC-EN-LIVRADOIS,172,22,194,
Musée Régional d'Auvergne,2011,AUVERGNE,RIOM,837,3429,4266,
Musée Municipal Marcel Sahut,2011,AUVERGNE,VOLVIC,0,1586,1586,
Musée des Beaux-Arts,2011,BOURGOGNE,BEAUNE,3097,2047,5144,
Musée du Pays Châtillonnais - Trésor de Vix,2011,BOURGOGNE,CHATILLON-SUR-SEINE,18131,6271,24402,
Musée François Rude,2011,BOURGOGNE,DIJON,0,42373,42373,
Musée Magnin,2011,BOURGOGNE,DIJON,6016,9275,15291,
Musée Archéologique,2011,BOURGOGNE,DIJON,0,26872,26872,
Musée des Beaux-Arts,2011,BOURGOGNE,DIJON,2146,141285,143431,
Musée des Beaux-Arts,2011,BOURGOGNE,MONTBARD,0,723,723,
Musée du Septennat,2011,BOURGOGNE,CHATEAU-CHINON,12113,4189,16302,
Musée du Costume,2011,BOURGOGNE,CHATEAU-CHINON,5115,1823,6938,
Museum d'Histoire Naturelle Jacques de La Comble,2011,BOURGOGNE,AUTUN,2383,2599,4982,
Musée d'Art et d'Archéologie,2011,BOURGOGNE,CLUNY,7136,16141,23277,
Musée de l'Homme et de l'Industrie - Ecomusée de la Communauté Le Creusot-Monceau-Les-Mines,2011,BOURGOGNE,LE CREUSOT,9809,3461,13270,
Musée Eucharistique du Hiéron,2011,BOURGOGNE,PARAY-LE-MONIAL,4125,5316,9441,
Musée du Terroir,2011,BOURGOGNE,ROMENAY,2269,1182,3451,
Maison du Blé et du Pain,2011,BOURGOGNE,VERDUN-SUR-LE-DOUBS,2554,1860,4414,
Musée Muncipal,2011,BOURGOGNE,SENS,4673,36248,40921,
Musée Zervos - Maison Romain Rolland,2011,BOURGOGNE,VEZELAY,8696,2726,11422,
Musée Mathurin Meheut,2011,BRETAGNE,LAMBALLE,4845,1319,6164,
Musée des Beaux-Arts,2011,BRETAGNE,QUIMPER,80161,39210,119371,
Ecomusée du Pays de Montfort,2011,BRETAGNE,MONTFORT-SUR-MEU,4735,0,4735,
Ecomusée du Pays de Rennes,2011,BRETAGNE,RENNES,13434,30400,43834,
Musée Estève,2011,CENTRE,BOURGES,0,14735,14735,
Musée George Sand et de la Vallée Noire,2011,CENTRE,LA CHATRE,3156,872,4028,
"""Maison Musée"" René Descartes",2011,CENTRE,DESCARTES,1607,473,2080,
Ecomusée du Véron,2011,CENTRE,SAVIGNY-EN-VERON,5764,2341,8105,
Maison de la Magie,2011,CENTRE,BLOIS,70223,18586,88809,
Château Musées de Blois,2011,CENTRE,BLOIS,257326,30397,287723,
Musée Gaston Couté,2011,CENTRE,MEUNG-SUR-LOIRE,0,2171,2171,
Musée de l'Ardenne,2011,CHAMPAGNE-ARDENNES,CHARLEVILLE-MEZIERES,5370,45820,51190,
Musée du Château-Fort,2011,CHAMPAGNE-ARDENNES,SEDAN,53840,0,53840,
Maison de l'Outil  et de la Pensée Ouvrière,2011,CHAMPAGNE-ARDENNES,TROYES,11651,2559,14210,
Musée d'Art Moderne,2011,CHAMPAGNE-ARDENNES,TROYES,18326,16993,35319,
Musée d'Art et d'Histoire,2011,CHAMPAGNE-ARDENNES,LANGRES,1908,6153,8061,
Musée Palais Fesch,2011,CORSE,AJACCIO,25926,13857,39783,
Musée des Beaux-Arts et d'Archéologie,2011,FRANCHE-COMTE,BESANCON,6101,48110,54211,
Musée du Château des Ducs de Wurtemberg,2011,FRANCHE-COMTE,MONTBELIARD,8050,16261,24311,
Musée Municipal d'Archéologie,2011,FRANCHE-COMTE,CHAMPAGNOLE,290,448,738,
Musée de l'Abbaye/Donations Guy Bardone - René Genis,2011,FRANCHE-COMTE,SAINT-CLAUDE,5517,5590,11107,
Musée d'Art et d'Histoire,2011,FRANCHE-COMTE,BELFORT,10889,3956,14845,
Musée Départemental Albert-Kahn,2011,ILE-DE-FRANCE,BOULOGNE-BILLANCOURT,103264,40210,143474,
Musée d'Histoire Locale - Mémoire de la Ville (et musée Franco-Suisse),2011,ILE-DE-FRANCE,RUEIL-MALMAISON,0,1700,1700,
Etablissement public Sèvres - Cité de la céramique,2011,ILE-DE-FRANCE,SEVRES,20476,18804,39280,
Grande Galerie de l'Evolution (Muséum National d'Histoire Naturelle),2011,ILE-DE-FRANCE,PARIS,398316,339307,737623,
Etablissement public du musée d'Orsay et de l'Orangerie - Musée d'Orsay,2011,ILE-DE-FRANCE,PARIS,1848726,1295723,3144449,
Musée Bourdelle,2011,ILE-DE-FRANCE,PARIS,81804,40720,122524,
Musée de la Musique,2011,ILE-DE-FRANCE,PARIS,189123,57295,246418,
Musée du Louvre,2011,ILE-DE-FRANCE,PARIS,5451295,3212697,8663992,
Maison Natale de Louis Braille,2011,ILE-DE-FRANCE,COUPVRAY,3905,1473,5378,
Musée de la Grande Guerre du Pays de Meaux,2011,ILE-DE-FRANCE,MEAUX,16691,11629,28320,
Musée Municipal,2011,ILE-DE-FRANCE,MORET-SUR-LOING,0,2532,2532,
Musée des Pays de Seine-et-Marne,2011,ILE-DE-FRANCE,SAINT-CYR-SUR-MORIN,3689,4433,8122,
Musée de l'Histoire Vivante,2011,ILE-DE-FRANCE,MONTREUIL-SOUS-BOIS,1836,2001,3837,
Ecomusée du Val de Bièvre,2011,ILE-DE-FRANCE,FRESNES,0,11960,11960,
Musée Camille Pissarro,2011,ILE-DE-FRANCE,PONTOISE,0,4903,4903,
Musée Intercommunal d'Histoire et d'Archéologie de Louvres,2011,ILE-DE-FRANCE,ROISSY-EN-FRANCE,6865,4432,11297,
Musée National de Port Royal des Champs,2011,ILE-DE-FRANCE,MAGNY-LES-HAMEAUX,6055,14164,20219,
Musée Zola-Dreyfus,2011,ILE-DE-FRANCE,MEDAN,6574,507,7081,
Musée Rambolitrain,2011,ILE-DE-FRANCE,RAMBOUILLET,14493,2550,17043,
Etablissement Public du Musée et du Domaine National de Versailles,2011,ILE-DE-FRANCE,VERSAILLES,4991002,1755196,6746198,
Musée Historique de Villèle,2011,LA REUNION,SAINT-GILLES-LES-HAUTS,18762,24897,43659,
Musée des Beaux-Arts,2011,LANGUEDOC-ROUSSILLON,CARCASSONNE,0,45739,45739,
Musée Archéologique du Lauragais,2011,LANGUEDOC-ROUSSILLON,CASTELNAUDARY,987,884,1871,
Musée des Corbières,2011,LANGUEDOC-ROUSSILLON,SIGEAN,362,563,925,
Musée du Colombier,2011,LANGUEDOC-ROUSSILLON,ALES,0,12709,12709,
Musée Cévenol,2011,LANGUEDOC-ROUSSILLON,LE VIGAN,2317,2043,4360,
Musée Archéologique,2011,LANGUEDOC-ROUSSILLON,NIMES,0,36768,36768,
Site Archéologique Lattara - Musée Henri Prades de Montpellier Agglomération,2011,LANGUEDOC-ROUSSILLON,LATTES,12936,12820,25756,
Musée de l'Ephèbe,2011,LANGUEDOC-ROUSSILLON,LE CAP D'AGDE,9432,3822,13254,
Musée Archéologique,2011,LANGUEDOC-ROUSSILLON,MINERVE,4890,0,4890,
Musée Archéologique Paul Soyris,2011,LANGUEDOC-ROUSSILLON,MURVIEL-LES-MONTPELLIER,0,655,655,
Musée de Vulliod Saint-Germain,2011,LANGUEDOC-ROUSSILLON,PEZENAS,1907,4603,6510,
Musée de Préhistoire Régionale et du Mégalithisme,2011,LANGUEDOC-ROUSSILLON,SAINT-PONS-DE-THOMIERES,1957,660,2617,
Musée du Castillet Casa Pairal,2011,LANGUEDOC-ROUSSILLON,PERPIGNAN,1988,11804,13792,
Musée Labenche d'Art et d'Histoire,2011,LIMOUSIN,BRIVE-LA-GAILLARDE,4428,8818,13246,
Musée du Cloître de Tulle André Mazeyrie,2011,LIMOUSIN,TULLE,0,11349,11349,
Musée Départemental de la Tapisserie,2011,LIMOUSIN,AUBUSSON,15385,4225,19610,
Musée Municipal des Beaux-Arts de Limoges - Palais de l'Evêché,2011,LIMOUSIN,LIMOGES,7053,60876,67929,
Les Sources d'Hercule,2011,LORRAINE,DENEUVRE,3529,573,4102,
Musée de la Céramique et de l'Ivoire,2011,LORRAINE,COMMERCY,1285,1134,2419,
Musée d'Art Sacré de la Meuse,2011,LORRAINE,SAINT-MIHIEL,782,666,1448,
Musée Départemental du Sel,2011,LORRAINE,MARSAL,4582,5443,10025,
Musée Régional d'Histoire et d'Ethnologie,2011,MARTINIQUE,FORT-DE-FRANCE,2763,2835,5598,
Musée de La Canne,2011,MARTINIQUE,LES TROIS ILETS,8430,3930,12360,
Musée de la Forge,2011,MIDI-PYRENEES,MONTGAILHARD,28569,2257,30826,
Musée Gallo-Romain d'Uxellodunum,2011,MIDI-PYRENEES,MARTEL,648,93,741,
Musée de l'Automate,2011,MIDI-PYRENEES,SOUILLAC,19157,4066,23223,
Musée des Beaux-Arts,2011,MIDI-PYRENEES,GAILLAC,2018,2908,4926,
Musée Raymond Lafage,2011,MIDI-PYRENEES,LISLE-SUR-TARN,1456,4244,5700,
Musée du Pays Rabastinois,2011,MIDI-PYRENEES,RABASTENS,1000,5216,6216,
Musée Benoît de Puydt,2011,NORD-PAS-DE-CALAIS,BAILLEUL,1290,2637,3927,
"Forum Antique de Bavay, Musée Archéologique du Département du Nord",2011,NORD-PAS-DE-CALAIS,BAVAY,21565,11589,33154,
Musée du Mont-de-Piété,2011,NORD-PAS-DE-CALAIS,BERGUES,1345,1809,3154,
Musée Municipal de Cambrai,2011,NORD-PAS-DE-CALAIS,CAMBRAI,6361,12699,19060,
Musée Portuaire,2011,NORD-PAS-DE-CALAIS,DUNKERQUE,27933,23719,51652,
Musée Municipal d'Escaudain,2011,NORD-PAS-DE-CALAIS,ESCAUDAIN,0,406,406,
Musée du Dessin et de l'Estampe Originale,2011,NORD-PAS-DE-CALAIS,GRAVELINES,6763,10965,17728,
Musée Départemental Matisse,2011,NORD-PAS-DE-CALAIS,LE CATEAU-CAMBRESIS,19558,46812,66370,
Palais des Beaux-Arts de Lille,2011,NORD-PAS-DE-CALAIS,LILLE,108178,107526,215704,
Musée d'Art et d'Industrie,2011,NORD-PAS-DE-CALAIS,TOURCOING,10883,17107,27990,
Musée des Beaux-Arts,2011,NORD-PAS-DE-CALAIS,VALENCIENNES,38983,0,38983,
Musée d'Art Moderne de Lille Métropole,2011,NORD-PAS-DE-CALAIS,VILLENEUVE-D'ASCQ,122749,64025,186774,
Musée Régional d'Ethnologie,2011,NORD-PAS-DE-CALAIS,BETHUNE,0,23500,23500,
Musée Jean-Charles Cazin,2011,NORD-PAS-DE-CALAIS,SAMER,0,670,670,
Musée des Beaux-Arts,2011,BASSE-NORMANDIE,CAEN,39896,48045,87941,
Musée d'Initiation à la Nature,2011,BASSE-NORMANDIE,CAEN,0,5540,5540,
Musée Eugène Boudin,2011,BASSE-NORMANDIE,HONFLEUR,29078,2555,31633,
Musée de la Mine,2011,BASSE-NORMANDIE,LE MOLAY-LITTRY,4140,784,4924,
Paléospace / Musée Paléontologique,2011,BASSE-NORMANDIE,VILLERS-SUR-MER,36773,4713,41486,
Musée Municipal,2011,BASSE-NORMANDIE,VIRE NORMANDIE,1076,3439,4515,
Musée Thomas Henry,2011,BASSE-NORMANDIE,CHERBOURG-EN-COTENTIN,0,23987,23987,
Musée de la Poeslerie,2011,BASSE-NORMANDIE,VILLEDIEU-LES-POELES-ROUFFIGNY,10136,1636,11772,
Musée du Prieuré,2011,HAUTE-NORMANDIE,HARFLEUR,141,2709,2850,
Musée d'Art Moderne André Malraux - MuMa,2011,HAUTE-NORMANDIE,LE HAVRE,36215,22095,58310,
MUNAE - Musée National de l'Education,2011,HAUTE-NORMANDIE,ROUEN,3532,6448,9980,
Musée de la Céramique,2011,HAUTE-NORMANDIE,ROUEN,3301,5166,8467,
Muséum d'Histoire Naturelle,2011,HAUTE-NORMANDIE,ROUEN,22715,16107,38822,
Musée d'Art de Nantes,2011,PAYS DE LA LOIRE,NANTES,52264,64005,116269,
Musées du Parc Naturel Régional de Brière,2011,PAYS DE LA LOIRE,SAINT-JOACHIM,1818,333,2151,
Musée d'Art et d'Histoire,2011,PAYS DE LA LOIRE,BAUGE,0,6786,6786,
Musée Jules-Desbois,2011,PAYS DE LA LOIRE,PARCAY-LES-PINS,3975,5371,9346,
Château-Musée,2011,PAYS DE LA LOIRE,SAUMUR,49038,10424,59462,
Musée des Tisserands Mayennais,2011,PAYS DE LA LOIRE,AMBRIERES-LES-VALLEES,760,67,827,
Musée d'Art et d'Archéologie Hôtel Fouquet,2011,PAYS DE LA LOIRE,CHATEAU-GONTIER,283,240,523,
Musée Communal Robert Tatin,2011,PAYS DE LA LOIRE,COSSE-LE-VIVIEN,16124,4291,20415,
Musée Archéologique Départemental de Jublains,2011,PAYS DE LA LOIRE,JUBLAINS,10614,22638,33252,
Musée de Tessé,2011,PAYS DE LA LOIRE,LE MANS,15964,14043,30007,
Musée de la Reine Bérengère,2011,PAYS DE LA LOIRE,LE MANS,2804,5706,8510,
Bibliothèque-musée,2011,PAYS DE LA LOIRE,SAINT-CALAIS,60,1045,1105,
Musée Municipal,2011,PAYS DE LA LOIRE,LA ROCHE-SUR-YON,0,8612,8612,
Musée Clemenceau et de Lattre-de-Tassigny,2011,PAYS DE LA LOIRE,MOUILLERON-EN-PAREDS,1444,2619,4063,
Familistère de Guise,2011,PICARDIE,GUISE,46591,4764,51355,
Musée Alexandre Dumas,2011,PICARDIE,VILLERS COTTERETS,1640,351,1991,
Musée du Château de Compiègne,2011,PICARDIE,COMPIEGNE,36878,49857,86735,
Musée Jean Calvin,2011,PICARDIE,NOYON,2016,1260,3276,
Musée de la Vénerie,2011,PICARDIE,SENLIS,7629,4395,12024,
Musée Boucher-de-Perthes,2011,PICARDIE,ABBEVILLE,2439,7383,9822,
Musée de Picardie,2011,PICARDIE,AMIENS,5944,25860,31804,
Atelier - Musée du Papier,2011,POITOU-CHARENTES,ANGOULEME,0,14943,14943,
Musée des Beaux-Arts,2011,POITOU-CHARENTES,LA ROCHELLE,3511,7816,11327,
Musée Municipal des Cordeliers,2011,POITOU-CHARENTES,SAINT-JEAN-D'ANGELY,155,5477,5632,
Musée des Tumulus de Bougon,2011,POITOU-CHARENTES,BOUGON,11072,9110,20182,
Musée Gassendi,2011,PROVENCE-ALPES-CÔTE D'AZUR,DIGNE-LES-BAINS,2573,6034,8607,
Musée Picasso,2011,PROVENCE-ALPES-CÔTE D'AZUR,ANTIBES,79518,46662,126180,
Musée Renoir,2011,PROVENCE-ALPES-CÔTE D'AZUR,CAGNES-SUR-MER,31209,11119,42328,
Musée Archéologique - Site de  Cimiez,2011,PROVENCE-ALPES-CÔTE D'AZUR,NICE,0,36055,36055,
Musée du Pavillon de Vendôme,2011,PROVENCE-ALPES-CÔTE D'AZUR,AIX-EN-PROVENCE,4367,7588,11955,
Musée des Tapisseries,2011,PROVENCE-ALPES-CÔTE D'AZUR,AIX-EN-PROVENCE,4396,16427,20823,
Musée de l'Uniforme - Musée de la Légion Etrangère,2011,PROVENCE-ALPES-CÔTE D'AZUR,PUYLOUBIER,0,7644,7644,
Musée Municipal Méditerranéen de Cassis A.T.P.,2011,PROVENCE-ALPES-CÔTE D'AZUR,CASSIS,33,7925,7958,
Musée Ciotaden,2011,PROVENCE-ALPES-CÔTE D'AZUR,LA CIOTAT,4510,3808,8318,
Fondation Louis Jou,2011,PROVENCE-ALPES-CÔTE D'AZUR,LES-BAUX-DE-PROVENCE,69,363,432,
Musée Municipal Paul Lafran,2011,PROVENCE-ALPES-CÔTE D'AZUR,SAINT-CHAMAS,0,4031,4031,
Musée de l'Empéri de Salon et de la Crau,2011,PROVENCE-ALPES-CÔTE D'AZUR,SALON-DE-PROVENCE,6117,11536,17653,
Musée des A.T.P. de Moyenne Provence,2011,PROVENCE-ALPES-CÔTE D'AZUR,DRAGUIGNAN,2549,7965,10514,
Musée Municipal,2011,PROVENCE-ALPES-CÔTE D'AZUR,HYERES,0,44566,44566,
Musée du Vêtement Provençal (Jean Aicard),2011,PROVENCE-ALPES-CÔTE D'AZUR,SOLLIES-VILLE,0,4059,4059,
Muséum d'Histoire Naturelle Esprit Requien,2011,PROVENCE-ALPES-CÔTE D'AZUR,AVIGNON,0,15875,15875,
Cité de Préhistoire,2011,RHONE-ALPES,ORGNAC-L'AVEN,103917,3825,107742,
Musée d'Art Sacré,2011,RHONE-ALPES,MOURS SAINT-EUSEBE,230,1050,1280,
Musée d'Archéologie Tricastine,2011,RHONE-ALPES,SAINT-PAUL-TROIS-CHATEAUX,1039,3546,4585,
Musée Léon Marès,2011,RHONE-ALPES,LOVAGNY,15123,4934,20057,
Musée des Vallées de Thônes,2011,RHONE-ALPES,THONES,790,809,1599,
Musée - Parc Archéologique du Lac de Paladru,2011,RHONE-ALPES,CHARAVINES,9703,4767,14470,
Musée Géo-Charles,2011,RHONE-ALPES,ECHIROLLES,0,5809,5809,
Musée Hector Berlioz,2011,RHONE-ALPES,LA-COTE-SAINT-ANDRE,0,13145,13145,
Musée de la Grande Chartreuse,2011,RHONE-ALPES,SAINT-PIERRE-DE-CHARTREUSE,39062,2733,41795,
Musée Alice Taverne,2011,RHONE-ALPES,AMBIERLE,3359,585,3944,
Musée d'Histoire du  20ème Siècle - Résistance et Déportation,2011,RHONE-ALPES,ESTIVAREILLES,1950,853,2803,
Musée d'Archéologie,2011,RHONE-ALPES,FEURS,1882,4391,6273,
Musées Gadagne,2011,RHONE-ALPES,LYON,36302,58989,95291,
Lugdunum - Musée et Théâtres Romains,2011,RHONE-ALPES,LYON,27160,67304,94464,
Musée de l'Imprimerie et de la Communication Graphique,2011,RHONE-ALPES,LYON,16429,15171,31600,
Musée Henri Malartre,2011,RHONE-ALPES,ROCHETAILLEE-SUR-SAONE,17351,19905,37256,
Musée de la Poterie,2012,ALSACE,BETSCHDORF,1728,396,2124,
Musée de Bouxwiller et du pays de hanau,2012,ALSACE,BOUXWILLER,554,315,869,
Musée de l'Image Populaire de Pfaffenhoffen,2012,ALSACE,PFAFFENHOFFEN,3451,0,3451,
Musée Zoologique de Strasbourg,2012,ALSACE,STRASBOURG,11602,22319,33921,
Musée Tomi Ungerer,2012,ALSACE,STRASBOURG,19720,29481,49201,
Musée d'Histoire Naturelle et d'Ethnographie de Colmar,2012,ALSACE,COLMAR,7888,6938,14826,
Château de Bourdeilles,2012,AQUITAINE,BOURDEILLES,25047,0,25047,
Musée Gallo-Romain de Vesunna,2012,AQUITAINE,PERIGUEUX,17847,11193,29040,
Ecomusée de la Grande Lande,2012,AQUITAINE,SABRES,55253,11362,66615,
Musée d'Art et d'Histoire du Cap de Gascogne,2012,AQUITAINE,SAINT-SEVER,0,793,793,
Musée des Beaux-Arts,2012,AQUITAINE,AGEN,7079,11897,18976,
Musée Basque et de l'Histoire de Bayonne,2012,AQUITAINE,BAYONNE,16615,19370,35985,
Musée Municipal de Guéthary,2012,AQUITAINE,GUETHARY,582,1573,2155,
Musée Municipal de Souvigny,2012,AUVERGNE,SOUVIGNY,6820,1832,8652,
Musée Départemental de la Céramique Gallo-Romaine,2012,AUVERGNE,LEZOUX,6464,5007,11471,
Musée Paléontologique,2012,AUVERGNE,MENAT,643,66,709,
Musée des Peintres de l'Ecole de Murols,2012,AUVERGNE,MUROL,3317,412,3729,
Musée François Rude,2012,BOURGOGNE,DIJON,0,27490,27490,
Musée d'Art et d'Histoire Romain Rolland,2012,BOURGOGNE,CLAMECY,2077,2366,4443,
Musée de la Loire,2012,BOURGOGNE,COSNE-SUR-LOIRE,1089,2937,4026,
Musée de la Mine,2012,BOURGOGNE,LA MACHINE,6414,1123,7537,
Musée Auguste Grasset,2012,BOURGOGNE,VARZY,1600,0,1600,
Musée Saint-Nazaire,2012,BOURGOGNE,BOURBON-LANCY,0,1723,1723,
Musée Nicéphore Niepce,2012,BOURGOGNE,CHALON-SUR-SAONE,0,28627,28627,
Musée Eucharistique du Hiéron,2012,BOURGOGNE,PARAY-LE-MONIAL,3441,4562,8003,
Musée Départemental du Compagnonnage,2012,BOURGOGNE,ROMANECHE-THORINS,2141,1454,3595,
Musée du Terroir,2012,BOURGOGNE,ROMENAY,2427,892,3319,
Musée Zervos - Maison Romain Rolland,2012,BOURGOGNE,VEZELAY,9431,0,9431,
Musée National de la Marine,2012,BRETAGNE,BREST,28501,25532,54033,
Le Port-Musée,2012,BRETAGNE,DOUARNENEZ,29900,13330,43230,
Musée de Pont-Aven,2012,BRETAGNE,PONT-AVEN,23193,7205,30398,
Musée de Bretagne,2012,BRETAGNE,RENNES,30350,24126,54476,
Musée des Rochers-Sévigné,2012,BRETAGNE,VITRE,4798,2154,6952,
Musée du Château de Vitré,2012,BRETAGNE,VITRE,11370,5360,16730,
"La Cohue, Musée des Beaux-Arts de vannes",2012,BRETAGNE,VANNES,5589,6076,11665,
Musée des Arts Décoratifs,2012,CENTRE,BOURGES,0,25602,25602,
Conservatoire du Machinisme et des Pratiques Agricoles,2012,CENTRE,CHARTRES-MAINVILLIERS,4996,44340,49336,
Musées de Châteauroux - Hôtel Bertrand,2012,CENTRE,CHATEAUROUX,266,15659,15925,
Musée George Sand et de la Vallée Noire,2012,CENTRE,LA CHATRE,1785,960,2745,
Musée Ornithologique (Ecomusée de la Brenne),2012,CENTRE,LE BLANC,2311,1248,3559,
Musée du Vieux Chinon,2012,CENTRE,CHINON,952,1438,2390,
Musée de Minerve,2012,CENTRE,YZEURES-SUR-CREUSE,0,699,699,
Muséum d'Histoire Naturelle,2012,CENTRE,BLOIS,3248,7992,11240,
Maison de la Magie,2012,CENTRE,BLOIS,71789,20905,92694,
Château Musées de Blois,2012,CENTRE,BLOIS,248978,33940,282918,
Château-Musée de Gien,2012,CENTRE,GIEN,8157,535,8692,
Musée Historique et Archéologique,2012,CENTRE,ORLEANS,1428,4278,5706,
Musée d'Art Moderne,2012,CHAMPAGNE-ARDENNES,TROYES,12824,22336,35160,
Musée Municipal,2012,CHAMPAGNE-ARDENNES,BOURBONNE-LES-BAINS,0,2288,2288,
Musée des Beaux-Arts et d'Archéologie,2012,CHAMPAGNE-ARDENNES,CHAUMONT,1188,1444,2632,
Musée de la Coutellerie,2012,CHAMPAGNE-ARDENNES,NOGENT,4377,1399,5776,
Musée Municipal,2012,CHAMPAGNE-ARDENNES,SAINT-DIZIER,0,242,242,
Musée de l'Alta Rocca,2012,CORSE,LEVIE,6671,9350,16021,
Musée-Maison Natale Gustave Courbet,2012,FRANCHE-COMTE,ORNANS,37035,21544,58579,
Musée des Beaux-Arts,2012,FRANCHE-COMTE,LONS-LE-SAUNIER,937,4231,5168,
Musée de l'Artisanat Jurassien,2012,FRANCHE-COMTE,VOITEUR,0,19609,19609,
Musée Frédéric Japy,2012,FRANCHE-COMTE,BEAUCOURT,54,436,490,
Musée Français de la Photographie,2012,ILE-DE-FRANCE,BIEVRES,3081,6362,9443,
Musée Belmondo et de la Sculpture Figurative du XXè siècle,2012,ILE-DE-FRANCE,BOULOGNE-BILLANCOURT,5670,5338,11008,
MUS - Musée d'Histoire Urbaine et Sociale,2012,ILE-DE-FRANCE,SURESNES,0,3260,3260,
Grande Galerie de l'Evolution (Muséum National d'Histoire Naturelle),2012,ILE-DE-FRANCE,PARIS,473485,304740,778225,
Galerie d'Anatomie Comparée et de Paléontologie (Muséum d'Histoire Naturelle),2012,ILE-DE-FRANCE,PARIS,119036,193684,312720,
Musée Carnavalet-Histoire de Paris,2012,ILE-DE-FRANCE,PARIS,78720,537925,616645,
Musée National de la Légion d'Honneur et des Ordres de Chevalerie,2012,ILE-DE-FRANCE,PARIS,0,74196,74196,
Musée des Monuments Français,2012,ILE-DE-FRANCE,PARIS,161989,135627,297616,
"Musée Cognacq-Jay, Musée du XVIIIe siècle de la ville de Paris",2012,ILE-DE-FRANCE,PARIS,17440,39953,57393,
Etablissement public de la Porte Dorée - Aquarium Tropical,2012,ILE-DE-FRANCE,PARIS,123983,103144,227127,
Musée du Louvre,2012,ILE-DE-FRANCE,PARIS,5702729,3735014,9437743,
Musée d'Art et d'Histoire du Judaïsme,2012,ILE-DE-FRANCE,PARIS,64525,36506,101031,
Musée National des Techniques,2012,ILE-DE-FRANCE,PARIS,93570,145630,239200,
Musée du Quai Branly - Jacques Chirac,2012,ILE-DE-FRANCE,PARIS,607313,673309,1280622,
L'Adresse Musée de la Poste,2012,ILE-DE-FRANCE,PARIS,56049,69620,125669,
Musée Départemental de l'Ecole de Barbizon - Auberge Ganne,2012,ILE-DE-FRANCE,BARBIZON,12689,6959,19648,
Maison Natale de Louis Braille,2012,ILE-DE-FRANCE,COUPVRAY,4108,0,4108,
Musée Gatien Bonnet,2012,ILE-DE-FRANCE,LAGNY-SUR-MARNE,0,4412,4412,
Musée Henri Chapu,2012,ILE-DE-FRANCE,LE MEE-SUR-SEINE,0,815,815,
Musée d'Art et d'Histoire de Melun,2012,ILE-DE-FRANCE,MELUN,671,4907,5578,
Musée Départemental de Préhistoire d'Île de France,2012,ILE-DE-FRANCE,NEMOURS,5722,25183,30905,
Musée départemental Stéphane Mallarmé,2012,ILE-DE-FRANCE,VULAINES-SUR-SEINE,4251,1495,5746,
Musée de Saint-Maur - Villa Médicis,2012,ILE-DE-FRANCE,LA VARENNE-SAINT-HILAIRE,61,9062,9123,
Musée de la Toile de Jouy,2012,ILE-DE-FRANCE,JOUY-EN-JOSAS,7878,1582,9460,
Musée Petiet,2012,LANGUEDOC-ROUSSILLON,LIMOUX,711,3663,4374,
Musée du Colombier,2012,LANGUEDOC-ROUSSILLON,ALES,0,11605,11605,
Musée Albert André,2012,LANGUEDOC-ROUSSILLON,BAGNOLS-SUR-CEZE,86,4223,4309,
Musée Pierre de Luxembourg,2012,LANGUEDOC-ROUSSILLON,VILLENEUVE-LES-AVIGNON,2954,1919,4873,
Musée Archéologique,2012,LANGUEDOC-ROUSSILLON,MINERVE,3918,0,3918,
Musée Fabre,2012,LANGUEDOC-ROUSSILLON,MONTPELLIER,262078,119028,381106,
Musée de la Mémoire et des Industries Tullistes,2012,LIMOUSIN,TULLE,0,3687,3687,
Musée Départemental de la Tapisserie,2012,LIMOUSIN,AUBUSSON,18174,0,18174,
Cité de la céramique - Sèvres & Limoges - Musée National Adrien Dubouché,2012,LIMOUSIN,LIMOGES,8818,9843,18661,
Musée Municipal des Emaux et Faïences,2012,LORRAINE,LONGWY,2727,1738,4465,
Musée de la Céramique et de l'Ivoire,2012,LORRAINE,COMMERCY,984,848,1832,
Musée Départemental Raymond Poincaré,2012,LORRAINE,SAMPIGNY,0,2434,2434,
Musée d'Argonne,2012,LORRAINE,VARENNES-EN-ARGONNE,1804,0,1804,
Musées de la Cour d'Or,2012,LORRAINE,METZ,15834,27370,43204,
La Tour aux Puces - Musée du Pays Thionvillois,2012,LORRAINE,THIONVILLE,2585,9765,12350,
Musée Départemental Georges de la Tour,2012,LORRAINE,VIC-SUR-SEILLE,5167,7822,12989,
Musée de l'Image,2012,LORRAINE,EPINAL,20955,3999,24954,
Musée Départemental d'Archéologie Précolombienne et de Préhistoire de la Martinique,2012,MARTINIQUE,FORT-DE-FRANCE,5907,2705,8612,
Musée Volcanologique Franck Arnold Perret,2012,MARTINIQUE,SAINT-PIERRE,23969,457,24426,
Musée du Textile et du Peigne en Corne,2012,MIDI-PYRENEES,LAVELANET,1240,413,1653,
Musée de la Forge,2012,MIDI-PYRENEES,MONTGAILHARD,26652,1911,28563,
Musée d'Archéologie,2012,MIDI-PYRENEES,MONTSEGUR,0,24565,24565,
"Musée des Mœurs et Coutumes, Musée du Rouergue",2012,MIDI-PYRENEES,ESPALION,1428,436,1864,
Musée des Beaux-Arts Denys Puech,2012,MIDI-PYRENEES,RODEZ,2117,11399,13516,
Musée Archéologique,2012,MIDI-PYRENEES,EAUZE,4513,1953,6466,
Musée Joseph Abeilhé,2012,MIDI-PYRENEES,MARCIAC,85,65,150,
Musée des Transports et des Communications,2012,MIDI-PYRENEES,TOULOUSE,0,751,751,
Musée Murat,2012,MIDI-PYRENEES,CŒUR DE CAUSSE,672,208,880,
Musée Champollion - Les Ecriture du Monde,2012,MIDI-PYRENEES,FIGEAC,33204,10309,43513,
Musée de l'Automate,2012,MIDI-PYRENEES,SOUILLAC,17414,3330,20744,
Musée Toulouse Lautrec,2012,MIDI-PYRENEES,ALBI,182640,29598,212238,
Musée du Pays Vaurais,2012,MIDI-PYRENEES,LAVAUR,1188,1781,2969,
Musée du Vieil Auvillar,2012,MIDI-PYRENEES,AUVILLAR,2518,985,3503,
Musée Ingres,2012,MIDI-PYRENEES,MONTAUBAN,15783,21306,37089,
Musée de Préhistoire,2012,MIDI-PYRENEES,SAINT-ANTONIN-NOBLE-VAL,318,97,415,
Musée d'Art et d'Industrie,2012,NORD-PAS-DE-CALAIS,TOURCOING,28270,0,28270,
Musée Régional d'Ethnologie,2012,NORD-PAS-DE-CALAIS,BETHUNE,0,5806,5806,
Musée de la Céramique,2012,NORD-PAS-DE-CALAIS,DESVRES,2256,171,2427,
Musée de l'Hôtel Sandelin,2012,NORD-PAS-DE-CALAIS,SAINT-OMER,3003,6028,9031,
Musée d'Initiation à la Nature,2012,BASSE-NORMANDIE,CAEN,0,4794,4794,
Musée Municipal,2012,BASSE-NORMANDIE,ORBEC,169,1775,1944,
Musée Municipal d'Avranches,2012,BASSE-NORMANDIE,AVRANCHES,1327,920,2247,
Musée du Granit,2012,BASSE-NORMANDIE,SAINT-MICHEL-DE-MONTJOIE,132,1601,1733,
Musée Barbey d'Aurevilly,2012,BASSE-NORMANDIE,SAINT-SAUVEUR-LE-VICOMTE,838,313,1151,
Musée Maritime de l'Ile de Tatihou,2012,BASSE-NORMANDIE,SAINT-VAAST-LA-HOUGUE,59728,3558,63286,
Musée du Château,2012,BASSE-NORMANDIE,TORIGNI-SUR-VIRE,103,687,790,
Musée Départemental des Arts et Traditions Populaires du Perche,2012,BASSE-NORMANDIE,SAINT-CYR LA ROSIERE,11761,10728,22489,
Musée de l'Ancien Evêché,2012,HAUTE-NORMANDIE,EVREUX,0,21870,21870,
Musée Municipal Nicolas Poussin,2012,HAUTE-NORMANDIE,LES ANDELYS,1904,2057,3961,
Musée Alphonse-Georges Poulain,2012,HAUTE-NORMANDIE,VERNON,3035,10945,13980,
Musée Louis-Philippe du Château d'Eu,2012,HAUTE-NORMANDIE,EU,13270,4739,18009,
Abbaye de Graville - Musée du Prieuré de Graville,2012,HAUTE-NORMANDIE,LE HAVRE,1588,4450,6038,
MUNAE - Musée National de l'Education,2012,HAUTE-NORMANDIE,ROUEN,5539,8080,13619,
Association de l'Horlogerie Aliermontaise,2012,HAUTE-NORMANDIE,SAINT-NICOLAS-D'ALIERMONT,5213,2097,7310,
Musée du Pays de Retz,2012,PAYS DE LA LOIRE,BOURGNEUF-EN-RETZ,3763,1125,4888,
Musée d'Art de Nantes,2012,PAYS DE LA LOIRE,NANTES,22341,170770,193111,
Musée d'Art et d'Histoire,2012,PAYS DE LA LOIRE,BAUGE,0,7500,7500,
Musée de la Vigne et du Vin d'Anjou,2012,PAYS DE LA LOIRE,SAINT LAMBERT-DU-LATTAY - VAL-DU-LAYON,5052,1712,6764,
Musée d'Art et d'Archéologie Hôtel Fouquet,2012,PAYS DE LA LOIRE,CHATEAU-GONTIER,331,429,760,
Musée Communal Robert Tatin,2012,PAYS DE LA LOIRE,COSSE-LE-VIVIEN,16552,4229,20781,
Musée des Sciences - CCSTI,2012,PAYS DE LA LOIRE,LAVAL,5060,55459,60519,
Musée du Château de Mayenne,2012,PAYS DE LA LOIRE,MAYENNE,12419,9511,21930,
Musée de Tessé,2012,PAYS DE LA LOIRE,LE MANS,20094,14948,35042,
Historial de la Vendée,2012,PAYS DE LA LOIRE,LES LUCS-SUR-BOULOGNE,37021,21121,58142,
Musée Jean de la Fontaine,2012,PICARDIE,CHATEAU-THIERRY,9981,4064,14045,
Musée - Centre de Documentation Alfred Desmasures,2012,PICARDIE,HIRSON,0,1296,1296,
Musée de la Résistance et de la Déportation,2012,PICARDIE,TERGNIER,23558,0,23558,
Musée de la Nacre et de la Tabletterie,2012,PICARDIE,MERU,15056,6128,21184,
Musée du Noyonnais,2012,PICARDIE,NOYON,729,1735,2464,
Musée de la Vénerie,2012,PICARDIE,SENLIS,3813,3979,7792,
Musée Départemental de l'Abbaye de Saint-Riquier,2012,PICARDIE,ABBEVILLE,0,32832,32832,
Musée de Picardie,2012,PICARDIE,AMIENS,4531,31443,35974,
Musée Alfred Danicourt,2012,PICARDIE,PERONNE,0,2329,2329,
Atelier - Musée du Papier,2012,POITOU-CHARENTES,ANGOULEME,0,36275,36275,
Musée Régional de Fouras,2012,POITOU-CHARENTES,FOURAS,5832,1147,6979,
Musée des Beaux-Arts,2012,POITOU-CHARENTES,LA ROCHELLE,1341,5713,7054,
Musée d'Orbigny-Bernon,2012,POITOU-CHARENTES,LA ROCHELLE,1809,5545,7354,
Musée de la Maison de Pierre Loti,2012,POITOU-CHARENTES,ROCHEFORT,13746,1964,15710,
Hôtel Hèbre de Saint-Clément - Musée d'Art et d'Histoire,2012,POITOU-CHARENTES,ROCHEFORT,3798,19476,23274,
Collection d'Histoire Naturelle,2012,POITOU-CHARENTES,POITIERS,19900,28600,48500,
Musée de la vallée,2012,PROVENCE-ALPES-CÔTE D'AZUR,BARCELONNETTE,11484,1874,13358,
Musée Municipal,2012,PROVENCE-ALPES-CÔTE D'AZUR,FORCALQUIER,0,1100,1100,
Musée Picasso,2012,PROVENCE-ALPES-CÔTE D'AZUR,ANTIBES,79517,43523,123040,
Musée Bonnard,2012,PROVENCE-ALPES-CÔTE D'AZUR,LE CANNET,40193,12546,52739,
Musée des Beaux-Arts,2012,PROVENCE-ALPES-CÔTE D'AZUR,MENTON,0,16132,16132,
Musée Départemental des Arts Asiatiques,2012,PROVENCE-ALPES-CÔTE D'AZUR,NICE,0,69027,69027,
Musée Archéologique - Site de  Cimiez,2012,PROVENCE-ALPES-CÔTE D'AZUR,NICE,0,36828,36828,
Muséum d'Histoire Naturelle,2012,PROVENCE-ALPES-CÔTE D'AZUR,NICE,0,54652,54652,
Musée d'Art et d'Histoire,2012,PROVENCE-ALPES-CÔTE D'AZUR,NICE,520,71548,72068,
Musée Départemental des Merveilles,2012,PROVENCE-ALPES-CÔTE D'AZUR,TENDE,0,33460,33460,
Musée du Pavillon de Vendôme,2012,PROVENCE-ALPES-CÔTE D'AZUR,AIX-EN-PROVENCE,4867,12338,17205,
Musée Granet,2012,PROVENCE-ALPES-CÔTE D'AZUR,AIX-EN-PROVENCE,86965,63600,150565,
Musée de l'Empéri de Salon et de la Crau,2012,PROVENCE-ALPES-CÔTE D'AZUR,SALON-DE-PROVENCE,4094,18713,22807,
Musée Municipal,2012,PROVENCE-ALPES-CÔTE D'AZUR,HYERES,6921,1282,8203,
Musée d'Apt,2012,PROVENCE-ALPES-CÔTE D'AZUR,APT,3007,7296,10303,
Musée Calvet (et musée Lapidaire),2012,PROVENCE-ALPES-CÔTE D'AZUR,AVIGNON,23746,6489,30235,
Musée du Petit Palais,2012,PROVENCE-ALPES-CÔTE D'AZUR,AVIGNON,18561,14478,33039,
Musée Comtadin-Duplessis,2012,PROVENCE-ALPES-CÔTE D'AZUR,CARPENTRAS,566,831,1397,
Musée Archéologique Théo Desplans,2012,PROVENCE-ALPES-CÔTE D'AZUR,VAISON-LA-ROMAINE,61983,15029,77012,
Musée Vivarois César Filhol,2012,RHONE-ALPES,ANNONAY,745,2096,2841,
Musée de la Batellerie du Rhône,2012,RHONE-ALPES,SERRIERES,905,5,910,
Musée et Site Archéologiques,2012,RHONE-ALPES,SOYONS,11481,1586,13067,
Musée de la Résistance de la Déportation de l'Isère,2012,RHONE-ALPES,GRENOBLE,0,28424,28424,
Atelier - Musée du Chapeau,2012,RHONE-ALPES,CHAZELLES-SUR-LYON,8598,2631,11229,
Musée de la Diana,2012,RHONE-ALPES,MONTBRISON,830,581,1411,
Musée des Beaux-Arts et d'Archéologie J. Dechelette,2012,RHONE-ALPES,ROANNE,1333,11138,12471,
Musée de la Mine / Site Couriot,2012,RHONE-ALPES,SAINT-ETIENNE,31075,24650,55725,
Musée d'Art et d'Industrie,2012,RHONE-ALPES,SAINT-ETIENNE,34287,8980,43267,
Musée Historique des Tissus,2012,RHONE-ALPES,LYON,36365,21973,58338,
Musées Gadagne,2012,RHONE-ALPES,LYON,40182,68416,108598,
Musée de la Folie Marco,2013,ALSACE,BARR,2959,3108,6067,
Musée du Château des Rohan,2013,ALSACE,SAVERNE,4130,3574,7704,
Musée Historique,2013,ALSACE,STRASBOURG,17194,18690,35884,
Musée d'Art Moderne et Contemporain de Strasbourg,2013,ALSACE,STRASBOURG,43813,83075,126888,
Musée Archéologique,2013,ALSACE,STRASBOURG,17100,26879,43979,
Musée Zoologique de Strasbourg,2013,ALSACE,STRASBOURG,32706,0,32706,
Musée de l'Œuvre Notre-Dame,2013,ALSACE,STRASBOURG,15657,22897,38554,
Musée des Arts Décoratifs,2013,ALSACE,STRASBOURG,27328,26714,54042,
Cabinet des Estampes et des Dessins,2013,ALSACE,STRASBOURG,2666,4112,6778,
Musée Tomi Ungerer,2013,ALSACE,STRASBOURG,19511,29410,48921,
Musée J.F. Oberlin,2013,ALSACE,WALDERSBACH,22134,7908,30042,
Musée Lalique,2013,ALSACE,WINGEN-SUR-MODER,48870,9955,58825,
Musée Gallo-Romain,2013,ALSACE,BIESHEIM,608,1294,1902,
Musée Bartholdi,2013,ALSACE,COLMAR,11458,4817,16275,
Musée d'Histoire Naturelle et d'Ethnographie de Colmar,2013,ALSACE,COLMAR,8747,7155,15902,
Musée du Vignoble et des Vins d'Alsace,2013,ALSACE,KAYSERSBERG VIGNOBLE,3241,0,3241,
Musée Historique,2013,ALSACE,MULHOUSE,0,33469,33469,
Musée de l'Impression sur Etoffes,2013,ALSACE,MULHOUSE,32340,0,32340,
Musée Vauban,2013,ALSACE,NEUF-BRISACH,2151,0,2151,
Musée du Tabac,2013,AQUITAINE,BERGERAC,4270,1542,5812,
Musée des Arts et Traditions Populaires du Périgord,2013,AQUITAINE,MUSSIDAN,1001,1389,2390,
CAPC Musée d'Art Contemporain de Bordeaux,2013,AQUITAINE,BORDEAUX,34840,104471,139311,
Centre National du Costume de Scène et de la Scénographie,2013,AUVERGNE,MOULINS,60657,19997,80654,
Musée de la Haute Auvergne,2013,AUVERGNE,SAINT-FLOUR,2104,3264,5368,
Musée des Arts et Traditions Populaires de Haute Loire,2013,AUVERGNE,LAVAUDIEU,9418,703,10121,
Musée Crozatier,2013,AUVERGNE,LE PUY-EN-VELAY,3003,0,3003,
Musée de la Dentelle,2013,AUVERGNE,ARLANC,838,11,849,
Musée d'Archéologie Bargoin,2013,AUVERGNE,CLERMONT-FERRAND,4304,12172,16476,
Muséum d'Histoire Naturelle Henri-Lecoq,2013,AUVERGNE,CLERMONT-FERRAND,3177,19645,22822,
Musée des Pénitents Blancs,2013,AUVERGNE,MARSAC-EN-LIVRADOIS,181,0,181,
Musée des Beaux-Arts,2013,BOURGOGNE,BEAUNE,5834,2306,8140,
Musée François Rude,2013,BOURGOGNE,DIJON,0,53752,53752,
Musée Magnin,2013,BOURGOGNE,DIJON,5165,7768,12933,
Musée Buffon,2013,BOURGOGNE,MONTBARD,0,9623,9623,
Musée Municipal François Pompon,2013,BOURGOGNE,SAULIEU,2868,5544,8412,
Musée de la Faïence et des Beaux-Arts,2013,BOURGOGNE,NEVERS,3151,7900,11051,
Musée Rolin,2013,BOURGOGNE,AUTUN,10763,7463,18226,
Musée Lamartine,2013,BOURGOGNE,MACON,1286,4092,5378,
Musée Départemental du Compagnonnage,2013,BOURGOGNE,ROMANECHE-THORINS,2137,1635,3772,
Musée de l'Avallonnais Jean Després,2013,BOURGOGNE,AVALLON,1144,3045,4189,
Musée Zervos - Maison Romain Rolland,2013,BOURGOGNE,VEZELAY,2110,6766,8876,
Musée d'Art et d'Histoire du Puisaye,2013,BOURGOGNE,VILLIERS-SAINT-BENOIT,848,1232,2080,
Musée de la Pêche,2013,BRETAGNE,CONCARNEAU,20283,14570,34853,
Musée Bigouden,2013,BRETAGNE,PONT-L'ABBE,11796,4848,16644,
Musée Départemental Breton,2013,BRETAGNE,QUIMPER,16709,24030,40739,
Musée des Rochers-Sévigné,2013,BRETAGNE,VITRE,5914,0,5914,
Musée du Château de Vitré,2013,BRETAGNE,VITRE,16010,7336,23346,
Ecomusée de Saint-Dégan,2013,BRETAGNE,BREC'H,7653,2801,10454,
Musée National de la Marine,2013,BRETAGNE,PORT-LOUIS,33877,26931,60808,
Musée Estève,2013,CENTRE,BOURGES,0,13742,13742,
Musée d'Art et d'Histoire de Dreux,2013,CENTRE,DREUX,1537,6272,7809,
Musée Marcel Proust,2013,CENTRE,ILLIERS-COMBRAY,4958,574,5532,
Musée de la Chemiserie et de l'Elégance Masculine,2013,CENTRE,ARGENTON-SUR-CREUSE,3080,4227,7307,
Musée Ornithologique (Ecomusée de la Brenne),2013,CENTRE,LE BLANC,1529,708,2237,
Musée du Vieux Chinon,2013,CENTRE,CHINON,754,742,1496,
Musée Lansyer,2013,CENTRE,LOCHES,0,24076,24076,
Ecomusée du Véron,2013,CENTRE,SAVIGNY-EN-VERON,8472,0,8472,
Muséum d'Histoire Naturelle,2013,CENTRE,TOURS,8303,18367,26670,
Musée de Minerve,2013,CENTRE,YZEURES-SUR-CREUSE,0,759,759,
Château Musées de Blois,2013,CENTRE,BLOIS,233630,36932,270562,
Musée de l'Ardenne,2013,CHAMPAGNE-ARDENNES,CHARLEVILLE-MEZIERES,5091,41976,47067,
Musée d'Art Moderne,2013,CHAMPAGNE-ARDENNES,TROYES,6317,21377,27694,
Musée de la Coutellerie,2013,CHAMPAGNE-ARDENNES,NOGENT,4161,2088,6249,
Musée de la Corse,2013,CORSE,CORTE,60033,11492,71525,
Muséum de Besançon,2013,FRANCHE-COMTE,BESANCON,240320,28107,268427,
Musée-Maison Natale Gustave Courbet,2013,FRANCHE-COMTE,ORNANS,49772,34093,83865,
Ecomusée du Pays de la Cerise,2013,FRANCHE-COMTE,FOUGEROLLES,7378,2672,10050,
Musée Municipal d'Archéologie,2013,FRANCHE-COMTE,CHAMPAGNOLE,658,0,658,
Musée des Cultures Guyanaises,2013,GUYANE,CAYENNE,1103,8823,9926,
Musée Municipal Robert Dubois-Corneau,2013,ILE-DE-FRANCE,BRUNOY,69,3132,3201,
Fondation Arp,2013,ILE-DE-FRANCE,CLAMART,1579,423,2002,
Musée Français de la Carte à Jouer,2013,ILE-DE-FRANCE,ISSY-LES-MOULINEAUX,4483,18900,23383,
Musée d'Histoire Locale - Mémoire de la Ville,2013,ILE-DE-FRANCE,RUEIL-MALMAISON,0,3812,3812,
Musée National des Châteaux de Malmaison et de Bois-Préau,2013,ILE-DE-FRANCE,RUEIL-MALMAISON,38842,32180,71022,
Musée des Avelines - Musée d'Art et d'Histoire,2013,ILE-DE-FRANCE,SAINT-CLOUD,736,17272,18008,
Etablissement Public du Musée des Arts Asiatiques Guimet,2013,ILE-DE-FRANCE,PARIS,219929,168693,388622,
Musée Carnavalet-Histoire de Paris,2013,ILE-DE-FRANCE,PARIS,33724,395028,428752,
Les Catacombes,2013,ILE-DE-FRANCE,PARIS,265907,45050,310957,
Musée Bourdelle,2013,ILE-DE-FRANCE,PARIS,12433,54170,66603,
Musée de la Musique,2013,ILE-DE-FRANCE,PARIS,148660,50561,199221,
"Musée Cognacq-Jay, Musée du XVIIIe siècle de la ville de Paris",2013,ILE-DE-FRANCE,PARIS,4835,46549,51384,
Etablissement public de la Porte Dorée - Aquarium Tropical,2013,ILE-DE-FRANCE,PARIS,137305,75192,212497,
"Musée Cernuschi, Musée des Arts de l'Asie de la ville de Paris",2013,ILE-DE-FRANCE,PARIS,25254,50683,75937,
Musée National d'Art Moderne (Centre National d'Art et de Culture Georges Pompidou),2013,ILE-DE-FRANCE,PARIS,2745810,1086601,3832411,
Musée Municipal des Capucins,2013,ILE-DE-FRANCE,COULOMMIERS,1253,2266,3519,
Musée Gatien Bonnet,2013,ILE-DE-FRANCE,LAGNY-SUR-MARNE,409,4782,5191,
Musée d'Art et d'Histoire de Melun,2013,ILE-DE-FRANCE,MELUN,791,5880,6671,
Château-musée de Nemours,2013,ILE-DE-FRANCE,NEMOURS,4629,3492,8121,
Musée des Pays de Seine-et-Marne,2013,ILE-DE-FRANCE,SAINT-CYR-SUR-MORIN,3089,3949,7038,
Musée de Saint-Maur - Villa Médicis,2013,ILE-DE-FRANCE,LA VARENNE-SAINT-HILAIRE,104,9044,9148,
"MAC VAL, Musée d'Art Contemporain du Val-de-Marne",2013,ILE-DE-FRANCE,VITRY SUR SEINE,8384,58854,67238,
Musée jean-Jacques Rousseau,2013,ILE-DE-FRANCE,MONTMORENCY,1530,1656,3186,
Musée Tavet Delacour,2013,ILE-DE-FRANCE,PONTOISE,2841,3495,6336,
Musée Rambolitrain,2013,ILE-DE-FRANCE,RAMBOUILLET,15220,2736,17956,
Musée des Arts Décoratifs de l’Océan indien (MADOI),2013,LA REUNION,SAINT-LOUIS,9879,1412,11291,
Eburomagus Musée Archéologique,2013,LANGUEDOC-ROUSSILLON,BRAM,1747,1366,3113,
Musée des Corbières,2013,LANGUEDOC-ROUSSILLON,SIGEAN,265,667,932,
Musée du Vieux Nîmes,2013,LANGUEDOC-ROUSSILLON,NIMES,2103,17501,19604,
Musée de la Maison Romane,2013,LANGUEDOC-ROUSSILLON,SAINT-GILLES-DU-GARD,1360,1335,2695,
Musée Pierre de Luxembourg,2013,LANGUEDOC-ROUSSILLON,VILLENEUVE-LES-AVIGNON,2699,2523,5222,
Site Archéologique Lattara - Musée Henri Prades de Montpellier Agglomération,2013,LANGUEDOC-ROUSSILLON,LATTES,15792,10758,26550,
Musée du Vieux Montpellier,2013,LANGUEDOC-ROUSSILLON,MONTPELLIER,1203,3023,4226,
Musée de Préhistoire Régionale et du Mégalithisme,2013,LANGUEDOC-ROUSSILLON,SAINT-PONS-DE-THOMIERES,923,658,1581,
Musée départemental d'Art Moderne,2013,LANGUEDOC-ROUSSILLON,CERET,52179,25814,77993,
Musée du Castillet Casa Pairal,2013,LANGUEDOC-ROUSSILLON,PERPIGNAN,8497,10941,19438,
Musée de l'Histoire du Fer,2013,LORRAINE,JARVILLE-LA-MALGRANGE,8401,14007,22408,
Musée des Beaux-Arts de Nancy,2013,LORRAINE,NANCY,41902,72114,114016,
Musée Départemental Raymond Poincaré,2013,LORRAINE,SAMPIGNY,0,2338,2338,
Musée de la Princerie,2013,LORRAINE,VERDUN,1619,3732,5351,
Musée Militaire et Erckmann-Chatrian,2013,LORRAINE,PHALSBOURG,849,133,982,
Moulin de la Blies - Musée des Techniques Faïencières,2013,LORRAINE,SARREGUEMINES,10581,13666,24247,
La Tour aux Puces - Musée du Pays Thionvillois,2013,LORRAINE,THIONVILLE,2256,10056,12312,
Musée de l'Image,2013,LORRAINE,EPINAL,21067,6940,28007,
Musée Départemental d'Art Ancien et Contemporain,2013,LORRAINE,EPINAL,2376,10749,13125,
Musée Régional d'Histoire et d'Ethnologie,2013,MARTINIQUE,FORT-DE-FRANCE,2233,3674,5907,
Musée de la Préhistoire,2013,MIDI-PYRENEES,LE MAS D'AZIL,13381,1044,14425,
Musée Régional de Géologie Pierre Vetter,2013,MIDI-PYRENEES,DECAZEVILLE,2457,2208,4665,
Musée du Charroi Rural et de l'Artisanat Traditionnel,2013,MIDI-PYRENEES,SALMIECH,192,678,870,
Musée Campanaire,2013,MIDI-PYRENEES,L'ISLE JOURDAIN,6420,0,6420,
Musée Municipal,2013,MIDI-PYRENEES,MARTRES-TOLOSANE,1956,4817,6773,
Musée des Augustins,2013,MIDI-PYRENEES,TOULOUSE,47259,74857,122116,
Musée Pyrénéen,2013,MIDI-PYRENEES,LOURDES,60813,8179,68992,
Musée Gallo-Romain d'Uxellodunum,2013,MIDI-PYRENEES,MARTEL,450,59,509,
Musée du Protestantisme en Haut-Languedoc,2013,MIDI-PYRENEES,FERRIERES,2831,1190,4021,
Muséum d'histoire naturelle Philadelphe Thomas,2013,MIDI-PYRENEES,GAILLAC,1383,3275,4658,
Musée du Vieil Auvillar,2013,MIDI-PYRENEES,AUVILLAR,2101,645,2746,
Musée des arts et traditions populaires,2013,MIDI-PYRENEES,MOISSAC,0,112,112,
Musée d'Histoire Naturelle Victor Brun,2013,MIDI-PYRENEES,MONTAUBAN,1461,7312,8773,
"Forum Antique de Bavay, Musée Archéologique du Département du Nord",2013,NORD-PAS-DE-CALAIS,BAVAY,22752,9309,32061,
Musée du Mont-de-Piété,2013,NORD-PAS-DE-CALAIS,BERGUES,1464,2582,4046,
Musée Municipal de Cambrai,2013,NORD-PAS-DE-CALAIS,CAMBRAI,1883,13749,15632,
Musée des Beaux-Arts,2013,NORD-PAS-DE-CALAIS,DUNKERQUE,8255,716,8971,
"Musée de la Mine, Centre Historique Minier",2013,NORD-PAS-DE-CALAIS,LEWARDE,144177,15296,159473,
Musée des Beaux-Arts,2013,NORD-PAS-DE-CALAIS,ROUBAIX,88501,104042,192543,
Musée Municipal,2013,NORD-PAS-DE-CALAIS,SAINT-AMAND-LES-EAUX,0,14550,14550,
Musée d'Art et d'Industrie,2013,NORD-PAS-DE-CALAIS,TOURCOING,21708,0,21708,
Musée des Beaux-Arts,2013,NORD-PAS-DE-CALAIS,VALENCIENNES,38880,0,38880,
Musée Communautaire Opale-Sud,2013,NORD-PAS-DE-CALAIS,BERCK-SUR-MER,2992,6434,9426,
Musée des Beaux-Arts et de la Dentelle,2013,NORD-PAS-DE-CALAIS,CALAIS,7896,13838,21734,
Musée de la Céramique,2013,NORD-PAS-DE-CALAIS,DESVRES,7001,710,7711,
Musée Municipal,2013,BASSE-NORMANDIE,ORBEC,416,435,851,
Musée du Château,2013,BASSE-NORMANDIE,PONTECOULANT,3061,1337,4398,
Musée de la Pomme et de la Poire,2013,BASSE-NORMANDIE,BARENTON,791,3228,4019,
Musée de l'Abbaye,2013,BASSE-NORMANDIE,CERISY-LA-FORET,5589,430,6019,
Muséum Emmanuel Liais,2013,BASSE-NORMANDIE,CHERBOURG-EN-COTENTIN,0,13443,13443,
Musée Quesnel-Morinière,2013,BASSE-NORMANDIE,COUTANCES,208,5265,5473,
Musée Municipal,2013,BASSE-NORMANDIE,EQUEURDREVILLLE-HAINNEVILLE,0,2600,2600,
Musée de la Poeslerie,2013,BASSE-NORMANDIE,VILLEDIEU-LES-POELES-ROUFFIGNY,5931,0,5931,
Musée des Beaux-Arts et de la Dentelle,2013,BASSE-NORMANDIE,ALENCON,8066,5973,14039,
Musée Artisanal et Industriel d'Instruments à Vent,2013,HAUTE-NORMANDIE,LA COUTURE-BOUSSEY,2988,924,3912,
Pavillon Flaubert,2013,HAUTE-NORMANDIE,CANTELEU,0,732,732,
Musée Louis-Philippe du Château d'Eu,2013,HAUTE-NORMANDIE,EU,14086,4319,18405,
La Maison de l'Armateur,2013,HAUTE-NORMANDIE,LE HAVRE,4857,8163,13020,
Musée des Sapeurs-Pompiers de France,2013,HAUTE-NORMANDIE,MONTVILLE,4717,5847,10564,
"Musée de la Fève, Crèches et Traditions Populaires",2013,PAYS DE LA LOIRE,BLAIN,1314,177,1491,
Musée du Vignoble Nantais,2013,PAYS DE LA LOIRE,LE PALLET,4410,4628,9038,
Musées du Parc Naturel Régional de Brière,2013,PAYS DE LA LOIRE,SAINT-JOACHIM,1378,250,1628,
Musée de l'Ardoise,2013,PAYS DE LA LOIRE,TRELAZE,10276,1700,11976,
Musée d'Art et d'Archéologie Hôtel Fouquet,2013,PAYS DE LA LOIRE,CHATEAU-GONTIER,645,569,1214,
Musée du Vieux Château,2013,PAYS DE LA LOIRE,LAVAL,17163,0,17163,
Musée du Château de Mayenne,2013,PAYS DE LA LOIRE,MAYENNE,10700,12332,23032,
Bibliothèque-musée,2013,PAYS DE LA LOIRE,SAINT-CALAIS,0,2792,2792,
Musée des Traditions de l'Île,2013,PAYS DE LA LOIRE,LA GUERINIERE,3426,754,4180,
Musée La Bourrine du Bois-Juquaud,2013,PAYS DE LA LOIRE,SAINT-HILAIRE-DE-RIEZ,10107,6278,16385,
Musée Milcendeau Jean-Yole,2013,PAYS DE LA LOIRE,SOULLANS,3380,2621,6001,
Musée de La Thiérache,2013,PICARDIE,VERVINS,0,3908,3908,
Musée Alexandre Dumas,2013,PICARDIE,VILLERS COTTERETS,744,1199,1943,
Musée Pillon,2013,PICARDIE,CHAUMONT-EN-VEXIN,0,803,803,
Musée Antoine Vivenel,2013,PICARDIE,COMPIEGNE,1345,4005,5350,
Musée de la Figurine Historique,2013,PICARDIE,COMPIEGNE,4720,4254,8974,
Musée de la Nacre et de la Tabletterie,2013,PICARDIE,MERU,14631,5790,20421,
Musée Jean Calvin,2013,PICARDIE,NOYON,2156,963,3119,
Cité International de la Bande Dessinée et de l'Image - Musée de la Bande Dessinée,2013,POITOU-CHARENTES,ANGOULEME,15334,43696,59030,
Musée Municipal de Cognac,2013,POITOU-CHARENTES,COGNAC,1825,8786,10611,
Musée du Nouveau Monde,2013,POITOU-CHARENTES,LA ROCHELLE,4737,10681,15418,
Muséum d'Histoire Naturelle,2013,POITOU-CHARENTES,LA ROCHELLE,9262,29578,38840,
Musée Cappon,2013,POITOU-CHARENTES,MARANS,18,0,18,
Musée Dupuy-Mestreau,2013,POITOU-CHARENTES,SAINTES,0,3117,3117,
Musée des Tumulus de Bougon,2013,POITOU-CHARENTES,BOUGON,10876,6511,17387,
Musée d'Art et d'Histoire Georges Turpin,2013,POITOU-CHARENTES,PARTHENAY,0,8849,8849,
"Musée de la Moto, de l'Automobile et du Vélo",2013,POITOU-CHARENTES,CHATELLERAULT,5132,8075,13207,
Musée des Traditions Populaires et d'Archéologie,2013,POITOU-CHARENTES,CHAUVIGNY,6335,2229,8564,
Musée de Préhistoire Raymond Touchard,2013,POITOU-CHARENTES,LUSSAC-LES-CHATEAUX,1790,2883,4673,
Musée Municipal de la Maison-Dieu,2013,POITOU-CHARENTES,MONTMORILLON,0,6892,6892,
Musée Sainte-Croix,2013,POITOU-CHARENTES,POITIERS,4731,20998,25729,
Musée Municipal,2013,PROVENCE-ALPES-CÔTE D'AZUR,FORCALQUIER,0,700,700,
Musée d'Histoire et d'Archéologie,2013,PROVENCE-ALPES-CÔTE D'AZUR,ANTIBES,4173,4444,8617,
Musée Jean Cocteau Collection Séverin Wunderman,2013,PROVENCE-ALPES-CÔTE D'AZUR,MENTON,44987,18097,63084,
Musée de Préhistoire Régionale,2013,PROVENCE-ALPES-CÔTE D'AZUR,MENTON,0,13378,13378,
Musée des Beaux-Arts Jules Chéret,2013,PROVENCE-ALPES-CÔTE D'AZUR,NICE,12229,40515,52744,
Ecomusée du Pays de la Roudoule,2013,PROVENCE-ALPES-CÔTE D'AZUR,PUGET-ROSTANG,1176,677,1853,
Musée Départemental de l'Arles Antique,2013,PROVENCE-ALPES-CÔTE D'AZUR,ARLES,97975,116642,214617,
Musée Alphonse Daudet,2013,PROVENCE-ALPES-CÔTE D'AZUR,FONTVIEILLE,3713,0,3713,
Musée d'Histoire et d'Archéologie des Baux-de-Provence,2013,PROVENCE-ALPES-CÔTE D'AZUR,LES BAUX DE PROVENCE,240000,20000,260000,
Fondation Louis Jou,2013,PROVENCE-ALPES-CÔTE D'AZUR,LES-BAUX-DE-PROVENCE,2300,600,2900,
Musée Frédéric Mistral,2013,PROVENCE-ALPES-CÔTE D'AZUR,MAILLANE,1595,4145,5740,
Musée des Docks Romains,2013,PROVENCE-ALPES-CÔTE D'AZUR,MARSEILLE,0,9420,9420,
Musée des Beaux-Arts de Marseille,2013,PROVENCE-ALPES-CÔTE D'AZUR,MARSEILLE,183207,36793,220000,
Musée d'Histoire de Marseille,2013,PROVENCE-ALPES-CÔTE D'AZUR,MARSEILLE,17550,62729,80279,
Musée des Civilisations de l'Europe et de la Méditerranée - MuCem,2013,PROVENCE-ALPES-CÔTE D'AZUR,MARSEILLE,433949,158800,592749,
Musée des Troupes de Marine,2013,PROVENCE-ALPES-CÔTE D'AZUR,FREJUS,0,14600,14600,
Musée Jean Aicard,2013,PROVENCE-ALPES-CÔTE D'AZUR,LE POUVEREL LA GARDE,0,1784,1784,
Musée Archéologique,2013,PROVENCE-ALPES-CÔTE D'AZUR,SAINT-RAPHAËL,0,28237,28237,
Musée d'Apt,2013,PROVENCE-ALPES-CÔTE D'AZUR,APT,2666,5688,8354,
Musée de la Résistance et de la Déportation de l'Ain,2013,RHONE-ALPES,NANTUA,7206,3373,10579,
Musée du Vieux Pérouges,2013,RHONE-ALPES,PEROUGES,24150,1810,25960,
Musée de la Bresse - Domaine des Planons,2013,RHONE-ALPES,SAINT-CYR-SUR-MENTHON,13191,7639,20830,
Musée Départemental du Revermont,2013,RHONE-ALPES,VAL-REVERMONT,4090,6779,10869,
Musée Vivarois César Filhol,2013,RHONE-ALPES,ANNONAY,582,2462,3044,
Musée du site Préhistorique,2013,RHONE-ALPES,VASSIEUX-EN-VERCORS,12644,0,12644,
Musée des Vallées de Thônes,2013,RHONE-ALPES,THONES,571,632,1203,
Musée Jadis Allevard,2013,RHONE-ALPES,ALLEVARD-LES-BAINS,5569,0,5569,
Musée Géo-Charles,2013,RHONE-ALPES,ECHIROLLES,0,7892,7892,
Musée Stendhal,2013,RHONE-ALPES,GRENOBLE,3857,1946,5803,
Muséum d'Histoire Naturelle de Grenoble,2013,RHONE-ALPES,GRENOBLE,12696,56321,69017,
Musée Matheysin,2013,RHONE-ALPES,LA MURE,663,1283,1946,
Musée Départemental de la Révolution Française,2013,RHONE-ALPES,VIZILLE,4364,56352,60716,
Musée Hospitalier,2013,RHONE-ALPES,CHARLIEU,2633,1431,4064,
Musée d'Allard,2013,RHONE-ALPES,MONTBRISON,1926,9011,10937,
Musée de la Diana,2013,RHONE-ALPES,MONTBRISON,921,0,921,
Musée Folklorique du Vieux Saint-Etienne,2013,RHONE-ALPES,SAINT-ETIENNE,1366,2346,3712,
Musée Rural,2013,RHONE-ALPES,USSON-EN-FOREZ,3818,1065,4883,
Lugdunum - Musée et Théâtres Romains,2013,RHONE-ALPES,LYON,22089,54336,76425,
Musée du docteur Faure,2013,RHONE-ALPES,AIX-LES-BAINS,5894,5453,11347,
Musée de Bouxwiller et du pays de hanau,2014,ALSACE,BOUXWILLER,4940,0,4940,
Musée du Fer,2014,ALSACE,REICHSHOFFEN,1200,459,1659,
Musée des Arts Décoratifs,2014,ALSACE,STRASBOURG,25853,31526,57379,
Musée J.F. Oberlin,2014,ALSACE,WALDERSBACH,22005,7548,29553,
Musée de la Porte de Thann,2014,ALSACE,CERNAY,400,148,548,
Musée Théodore Deck et des Pays du Florival,2014,ALSACE,GUEBWILLER,1206,5122,6328,
Cité du Train,2014,ALSACE,MULHOUSE,62268,28804,91072,
Maison du Sundgau - Musée Paysan,2014,ALSACE,OLTINGUE,1036,330,1366,
Ecomusée d'Alsace,2014,ALSACE,UNGERSHEIM,138857,57412,196269,
Musée du Sapeur Pompier d'Alsace (Anciennement à Mulhouse),2014,ALSACE,VIEUX FERRETTE,6400,0,6400,
Musée Gallo-Romain de Vesunna,2014,AQUITAINE,PERIGUEUX,17275,13360,30635,
Centre National Jean Moulin,2014,AQUITAINE,BORDEAUX,0,27625,27625,
Musée des Beaux-Arts,2014,AQUITAINE,BORDEAUX,117492,0,117492,
Musée Historique de l'Hydravion,2014,AQUITAINE,BISCARROSSE,14421,1800,16221,
Ecomusée de la Grande Lande,2014,AQUITAINE,SABRES,68470,14321,82791,
Musée Municipal,2014,AQUITAINE,ARUDY,905,770,1675,
Musée Edmond Rostand,2014,AQUITAINE,CAMBO-LES-BAINS,62931,11178,74109,
Musée Rieckotter,2014,AUVERGNE,NERIS-LES-BAINS,355,335,690,
Musée des Arts D'Afrique et D'Asie,2014,AUVERGNE,VICHY,2684,1925,4609,
Ecomusée de Margeride-Haute-Auvergne,2014,AUVERGNE,RUYNES-EN-MARGERIDE,6958,635,7593,
Musée Crozatier,2014,AUVERGNE,LE PUY-EN-VELAY,3082,0,3082,
Musée des Peintres de l'Ecole de Murols,2014,AUVERGNE,MUROL,4693,222,4915,
Musée Régional d'Auvergne,2014,AUVERGNE,RIOM,261,1069,1330,
Musée Municipal de la Coutellerie,2014,AUVERGNE,THIERS,21026,3486,24512,
Muséum - Jardin des Sciences,2014,BOURGOGNE,DIJON,6390,105318,111708,
Musée Magnin,2014,BOURGOGNE,DIJON,4816,9294,14110,
Musée Municipal,2014,BOURGOGNE,NUITS-SAINT-GEORGES,104,2975,3079,
Musée du Septennat,2014,BOURGOGNE,CHATEAU-CHINON,8538,2282,10820,
Musée de la Mine,2014,BOURGOGNE,LA MACHINE,6229,1081,7310,
Musée Rolin,2014,BOURGOGNE,AUTUN,14709,6659,21368,
Musée de la Mine,2014,BOURGOGNE,BLANZY,9468,1106,10574,
Musée Denon,2014,BOURGOGNE,CHALON-SUR-SAONE,0,12705,12705,
Musée Nicéphore Niepce,2014,BOURGOGNE,CHALON-SUR-SAONE,0,27180,27180,
Musée Départemental du Compagnonnage,2014,BOURGOGNE,ROMANECHE-THORINS,2200,2204,4404,
Musée du Terroir,2014,BOURGOGNE,ROMENAY,2613,1344,3957,
Musée du Château de Dinan,2014,BRETAGNE,DINAN,18022,7333,25355,
Musée de Morlaix,2014,BRETAGNE,MORLAIX,17784,8351,26135,
Musée d'Histoire de la Ville de Saint-Malo,2014,BRETAGNE,SAINT-MALO,27903,18927,46830,
Musée International du Long-Cours Cap-Hornier,2014,BRETAGNE,SAINT-MALO,6620,5065,11685,
Musée National de la Marine,2014,BRETAGNE,PORT-LOUIS,37898,29049,66947,
Musée des Beaux-Arts,2014,CENTRE,CHARTRES,3025,6590,9615,
Musée Marcel Proust,2014,CENTRE,ILLIERS-COMBRAY,4363,326,4689,
Musée de la Chemiserie et de l'Elégance Masculine,2014,CENTRE,ARGENTON-SUR-CREUSE,3199,4358,7557,
Musée Lansyer,2014,CENTRE,LOCHES,0,29711,29711,
Musée de l'Hôtel de Ville,2014,CENTRE,RICHELIEU,1818,429,2247,
Musée de la Corbillière,2014,CENTRE,MER,0,900,900,
Musée Archéologique,2014,CENTRE,THESEE,428,84,512,
Musée de la Marine de Loire,2014,CENTRE,CHATEAUNEUF-SUR-LOIRE,8480,3331,11811,
Musée de la Maison de la Dernière Cartouche,2014,CHAMPAGNE-ARDENNES,BAZEILLES,1043,960,2003,
Musée du Château-Fort,2014,CHAMPAGNE-ARDENNES,SEDAN,56704,1482,58186,
Musée Camille Claudel,2014,CHAMPAGNE-ARDENNES,NOGENT-SUR-SEINE,1635,4168,5803,
Musée d'Art Moderne,2014,CHAMPAGNE-ARDENNES,TROYES,9668,32751,42419,
Pharmacie Musée de l'Hôtel-Dieu,2014,CHAMPAGNE-ARDENNES,TROYES,2603,6966,9569,
Musée Napoléonien,2014,CORSE,AJACCIO,5158,2118,7276,
Musée de la Maison Bonaparte,2014,CORSE,AJACCIO,42905,24666,67571,
Musée du Château des Ducs de Wurtemberg,2014,FRANCHE-COMTE,MONTBELIARD,5654,10883,16537,
Musée-Maison Natale Gustave Courbet,2014,FRANCHE-COMTE,ORNANS,45373,21469,66842,
Musée Précolombien Edgar Clerc,2014,GUADELOUPE,LE MOULE,0,11377,11377,
Musée Français de la Carte à Jouer,2014,ILE-DE-FRANCE,ISSY-LES-MOULINEAUX,5861,16683,22544,
Musée - Atelier Rodin (Annexe du musée de Paris),2014,ILE-DE-FRANCE,MEUDON,7193,9742,16935,
Musée National des Châteaux de Malmaison et de Bois-Préau,2014,ILE-DE-FRANCE,RUEIL-MALMAISON,58704,42730,101434,
Musée National de la Légion d'Honneur et des Ordres de Chevalerie,2014,ILE-DE-FRANCE,PARIS,0,58195,58195,
Maison de Balzac,2014,ILE-DE-FRANCE,PARIS,5712,34324,40036,
Musée de la Franc-Maçonnerie,2014,ILE-DE-FRANCE,PARIS,13963,3530,17493,
Musée d'Art et d'Histoire du Judaïsme,2014,ILE-DE-FRANCE,PARIS,78506,44362,122868,
Musée des Monnaies et des Médailles,2014,ILE-DE-FRANCE,PARIS,30000,20000,50000,
Musée Municipal de Chelles Alfred Bonno,2014,ILE-DE-FRANCE,CHELLES,0,2429,2429,
Musée Gatien Bonnet,2014,ILE-DE-FRANCE,LAGNY-SUR-MARNE,0,3905,3905,
Musée d'Art et d'Histoire,2014,ILE-DE-FRANCE,SAINT-DENIS,2847,17374,20221,
Musée Promenade Marly/Louveciennes,2014,ILE-DE-FRANCE,LOUVECIENNES,6448,3263,9711,
Musée Rambolitrain,2014,ILE-DE-FRANCE,RAMBOUILLET,15094,3348,18442,
Musée Lambinet,2014,ILE-DE-FRANCE,VERSAILLES,5241,5818,11059,
Muséum Agricole et Industriel Stella Matutina,2014,LA REUNION,PITON-SAINT-LEU,0,16789,16789,
Musée-Bibliothèque Pierre-André Benoît,2014,LANGUEDOC-ROUSSILLON,ALES,2239,11110,13349,
Musée Cévenol,2014,LANGUEDOC-ROUSSILLON,LE VIGAN,2069,1464,3533,
Carré d'Art Musée d'Art Contemporain de Nîmes,2014,LANGUEDOC-ROUSSILLON,NIMES,16726,24081,40807,
Musée d'Histoire Naturelle et de Préhistoire,2014,LANGUEDOC-ROUSSILLON,NIMES,1423,35871,37294,
Musée Agathois,2014,LANGUEDOC-ROUSSILLON,AGDE,1535,1627,3162,
Musée du Biterrois,2014,LANGUEDOC-ROUSSILLON,BEZIERS,1451,8614,10065,
Musée Fleury,2014,LANGUEDOC-ROUSSILLON,LODEVE,34395,10842,45237,
Musée du Vieux Montpellier,2014,LANGUEDOC-ROUSSILLON,MONTPELLIER,611,4788,5399,
Musée Paul Valéry,2014,LANGUEDOC-ROUSSILLON,SETE,93926,6756,100682,
Musée départemental d'Art Moderne,2014,LANGUEDOC-ROUSSILLON,CERET,47304,16148,63452,
Musée du Castillet Casa Pairal,2014,LANGUEDOC-ROUSSILLON,PERPIGNAN Cedex,8381,10005,18386,
Musée de l'Histoire du Fer,2014,LORRAINE,JARVILLE-LA-MALGRANGE,4007,7900,11907,
Palais des ducs de Lorraine - Musée Historique Lorrain,2014,LORRAINE,NANCY,27287,40223,67510,
Musée Départemental Raymond Poincaré,2014,LORRAINE,SAMPIGNY,0,5410,5410,
Musée de la Princerie,2014,LORRAINE,VERDUN,1873,2368,4241,
Musée Militaire et Erckmann-Chatrian,2014,LORRAINE,PHALSBOURG,776,869,1645,
Musée de la Lutherie et de l'Archèterie Française,2014,LORRAINE,MIRECOURT,6674,5045,11719,
Musée Charles Friry,2014,LORRAINE,REMIREMONT,583,1262,1845,
Musée Pierre Noël - Musée de la Vie dans les Hautes-Vosges,2014,LORRAINE,SAINT-DIE-DES-VOSGES,5175,12895,18070,
Musée Régional d'Histoire et d'Ethnologie,2014,MARTINIQUE,FORT-DE-FRANCE,1879,2316,4195,
Musée Volcanologique Franck Arnold Perret,2014,MARTINIQUE,SAINT-PIERRE,24705,450,25155,
Musée Départemental de l'Ariège,2014,MIDI-PYRENEES,FOIX,80152,7638,87790,
Musée d'Archéologie,2014,MIDI-PYRENEES,MONTSEGUR,0,18518,18518,
Musée du Palais des Evêques,2014,MIDI-PYRENEES,SAINT-LIZIER,9426,1391,10817,
Musée des Arts et Métiers Traditionnels,2014,MIDI-PYRENEES,SALLES-LA-SOURCE,4948,2458,7406,
"Les Abattoirs, Musée d'Art Moderne et Contemporain",2014,MIDI-PYRENEES,TOULOUSE,32325,80118,112443,
Musée Georges Labit,2014,MIDI-PYRENEES,TOULOUSE,5800,11940,17740,
Musée Saint-Raymond,2014,MIDI-PYRENEES,TOULOUSE,22014,35577,57591,
"Musée Archéologique ""Armand-Viré""",2014,MIDI-PYRENEES,LUZECH,245,596,841,
Musée Toulouse Lautrec,2014,MIDI-PYRENEES,ALBI,134230,33787,168017,
Musée d'Histoire Naturelle Victor Brun,2014,MIDI-PYRENEES,MONTAUBAN,1421,5853,7274,
Musée Ingres,2014,MIDI-PYRENEES,MONTAUBAN,15168,22491,37659,
Musée Départemental de Flandre,2014,NORD-PAS-DE-CALAIS,CASSEL,36921,7766,44687,
Musée Départemental Matisse,2014,NORD-PAS-DE-CALAIS,LE CATEAU-CAMBRESIS,43046,12118,55164,
MUba - Musée des Beaux-Arts Eugène Leroy de Tourcoing,2014,NORD-PAS-DE-CALAIS,TOURCOING,14319,12101,26420,
Musée de Boulogne-sur-Mer,2014,NORD-PAS-DE-CALAIS,BOULOGNE-SUR-MER,16257,13827,30084,
Musée de l'Hôtel Sandelin,2014,NORD-PAS-DE-CALAIS,SAINT-OMER,4393,10642,15035,
Musée des Beaux-Arts,2014,BASSE-NORMANDIE,CAEN,20352,34056,54408,
Musée d'Initiation à la Nature,2014,BASSE-NORMANDIE,CAEN,0,6014,6014,
Paléospace / Musée Paléontologique,2014,BASSE-NORMANDIE,VILLERS-SUR-MER,47514,372,47886,
Muséum Emmanuel Liais,2014,BASSE-NORMANDIE,CHERBOURG-EN-COTENTIN,0,12759,12759,
Musée Christian Dior,2014,BASSE-NORMANDIE,GRANVILLE,35509,4801,40310,
Musée Régional du Cidre et du Calvados,2014,BASSE-NORMANDIE,VALOGNES,2262,2489,4751,
Musée des Beaux-Arts et de la Dentelle,2014,BASSE-NORMANDIE,ALENCON,9969,8211,18180,
Musée de l'Ancien Evêché,2014,HAUTE-NORMANDIE,EVREUX,0,25615,25615,
Musée Alfred Canel,2014,HAUTE-NORMANDIE,PONT-AUDEMER,501,4948,5449,
Musée d'Elbeuf,2014,HAUTE-NORMANDIE,ELBEUF,0,37816,37816,
Musée Départemental Pierre Corneille,2014,HAUTE-NORMANDIE,LE PETIT-COURONNE,705,3516,4221,
Ecomusée de la Basse-Seine,2014,HAUTE-NORMANDIE,NOTRE-DAME-DE-BLIQUETUIT,23060,4387,27447,
Musée des Antiquités de la Seine-Maritime,2014,HAUTE-NORMANDIE,ROUEN,1716,28460,30176,
Musée Le Secq des Tournelles,2014,HAUTE-NORMANDIE,ROUEN,4182,7385,11567,
Musée Municipal des Ivoires,2014,HAUTE-NORMANDIE,YVETOT,684,361,1045,
"Musée de la Fève, Crèches et Traditions Populaires",2014,PAYS DE LA LOIRE,BLAIN,970,226,1196,
Muséum d'Histoire Naturelle de Nantes,2014,PAYS DE LA LOIRE,NANTES,26000,69420,95420,
Musée du Château des Ducs de Bretagne,2014,PAYS DE LA LOIRE,NANTES,127097,138367,265464,
Musée du Chaume/Kerhinet - PNR Brière,2014,PAYS DE LA LOIRE,SAINT-LYPHARD,2502,84358,86860,
Muséum des Sciences Naturelles,2014,PAYS DE LA LOIRE,ANGERS,3843,20589,24432,
Galerie David d'Angers,2014,PAYS DE LA LOIRE,ANGERS,7210,18581,25791,
Château-Musée,2014,PAYS DE LA LOIRE,SAUMUR,68782,13548,82330,
Musée du Vieux Château,2014,PAYS DE LA LOIRE,LAVAL,6850,18765,25615,
Musée Espace Faïence de Malicorne,2014,PAYS DE LA LOIRE,MALICORNE-SUR-SARTHE,7149,2619,9768,
Bibliothèque-musée,2014,PAYS DE LA LOIRE,SAINT-CALAIS,0,3053,3053,
Musée des Traditions de l'Île,2014,PAYS DE LA LOIRE,LA GUERINIERE,3722,821,4543,
Musée Municipal,2014,PAYS DE LA LOIRE,LA ROCHE-SUR-YON,0,14684,14684,
Musée ornithologique Charles-Payraudeau,2014,PAYS DE LA LOIRE,LA-CHAIZE-LE-VICOMTE,75,238,313,
Musée de l'Abbaye de Sainte-Croix,2014,PAYS DE LA LOIRE,LES SABLES D'OLONNE,4066,9701,13767,
Familistère de Guise,2014,PICARDIE,GUISE,54299,8494,62793,
Musée Municipal de Soissons,2014,PICARDIE,SOISSONS,0,31482,31482,
Musée de la Résistance et de la Déportation,2014,PICARDIE,TERGNIER,20951,0,20951,
Musée de La Thiérache,2014,PICARDIE,VERVINS,0,5119,5119,
Musée du Château de Compiègne,2014,PICARDIE,COMPIEGNE,36823,45449,82272,
Musée de la Figurine Historique,2014,PICARDIE,COMPIEGNE,2930,6838,9768,
Musée Jean Calvin,2014,PICARDIE,NOYON,2215,791,3006,
Musée de la Vénerie,2014,PICARDIE,SENLIS,2573,3830,6403,
Musée Alfred Danicourt,2014,PICARDIE,PERONNE,0,3127,3127,
Musée Archéologique et Historique,2014,POITOU-CHARENTES,ANGOULEME,156,462,618,
Musée des Beaux-Arts,2014,POITOU-CHARENTES,ANGOULEME,3754,41641,45395,
Musée Régional de Fouras,2014,POITOU-CHARENTES,FOURAS,6857,3707,10564,
Musée Ernest Cognacq,2014,POITOU-CHARENTES,SAINT-MARTIN-DE-RE,7062,5066,12128,
"Musée de la Moto, de l'Automobile et du Vélo",2014,POITOU-CHARENTES,CHATELLERAULT,4266,6207,10473,
Musée Charbonneau-Lassay,2014,POITOU-CHARENTES,LOUDUN,0,1123,1123,
Musée du baptistère Saint-Jean,2014,POITOU-CHARENTES,POITIERS,11137,1124,12261,
Musée Gassendi,2014,PROVENCE-ALPES-CÔTE D'AZUR,DIGNE-LES-BAINS,1631,10784,12415,
Musée Municipal,2014,PROVENCE-ALPES-CÔTE D'AZUR,FORCALQUIER,0,972,972,
Musée Fernand Léger,2014,PROVENCE-ALPES-CÔTE D'AZUR,BIOT,14851,13744,28595,
Musée-Château de Cagnes,2014,PROVENCE-ALPES-CÔTE D'AZUR,CAGNES-SUR-MER,16960,8705,25665,
Musée de la Mer,2014,PROVENCE-ALPES-CÔTE D'AZUR,CANNES,47990,38898,86888,
Musée d'Art et d'Histoire de Provence,2014,PROVENCE-ALPES-CÔTE D'AZUR,GRASSE,0,18334,18334,
Musée National du Sport (Anciennement à Paris),2014,PROVENCE-ALPES-CÔTE D'AZUR,NICE,5028,15760,20788,
Musée Réattu,2014,PROVENCE-ALPES-CÔTE D'AZUR,ARLES,17289,41284,58573,
Musée de la Légion Etrangère,2014,PROVENCE-ALPES-CÔTE D'AZUR,AUBAGNE/PUYLOUBIER,0,9292,9292,
Musée des Civilisations de l'Europe et de la Méditerranée - MuCem,2014,PROVENCE-ALPES-CÔTE D'AZUR,MARSEILLE,416008,258043,674051,
Musée des A.T.P. de Moyenne Provence,2014,PROVENCE-ALPES-CÔTE D'AZUR,DRAGUIGNAN,2284,6248,8532,
Musée de l'Artillerie,2014,PROVENCE-ALPES-CÔTE D'AZUR,DRAGUIGNAN,0,21421,21421,
Muséum d'Histoire Naturelle Esprit Requien,2014,PROVENCE-ALPES-CÔTE D'AZUR,AVIGNON,0,15394,15394,
Musée Calvet (et musée Lapidaire),2014,PROVENCE-ALPES-CÔTE D'AZUR,AVIGNON,13431,21035,34466,
Musée du Petit Palais,2014,PROVENCE-ALPES-CÔTE D'AZUR,AVIGNON,15257,12873,28130,
Musée Départemental du Revermont,2014,RHONE-ALPES,VAL-REVERMONT,3894,7468,11362,
Musée d'Archéologie Tricastine,2014,RHONE-ALPES,SAINT-PAUL-TROIS-CHATEAUX,3625,3152,6777,
Musée du site Préhistorique,2014,RHONE-ALPES,VASSIEUX-EN-VERCORS,11952,0,11952,
Musée Léon Marès,2014,RHONE-ALPES,LOVAGNY,18481,0,18481,
"Notre histoire, Musée de Rumilly",2014,RHONE-ALPES,RUMILLY,1130,920,2050,
Musée d'Huez et de l'Oisans,2014,RHONE-ALPES,ALPE D'HUEZ,0,4046,4046,
Musée Gallo-Romain,2014,RHONE-ALPES,AOSTE,4574,1365,5939,
Musée Archéologique Grenoble Saint-Laurent,2014,RHONE-ALPES,GRENOBLE,0,43004,43004,
Musée Dauphinois,2014,RHONE-ALPES,GRENOBLE,0,61002,61002,
Musée de la Grande Chartreuse,2014,RHONE-ALPES,SAINT-PIERRE-DE-CHARTREUSE,52755,2269,55024,
Musée Lapidaire Saint-Pierre,2014,RHONE-ALPES,VIENNE,6276,10998,17274,
Musée-Cloître Saint-André-Le-Bas,2014,RHONE-ALPES,VIENNE,4364,7140,11504,
Musée d'Histoire du  20ème Siècle - Résistance et Déportation,2014,RHONE-ALPES,ESTIVAREILLES,2465,1639,4104,
Musée d'Archéologie,2014,RHONE-ALPES,FEURS,2591,3711,6302,
Musée d'Allard,2014,RHONE-ALPES,MONTBRISON,1811,10994,12805,
Musée d'Art Moderne et Contemporain de Saint-Etienne Métropole,2014,RHONE-ALPES,SAINT-PRIEST-EN-JAREZ,28487,26178,54665,
Musée Folklorique et Traditions Populaires Marius Audin,2014,RHONE-ALPES,BEAUJEU,790,528,1318,
Musée Historique des Tissus,2014,RHONE-ALPES,LYON,45135,23251,68386,
Musées Gadagne,2014,RHONE-ALPES,LYON,45069,55230,100299,
Centre d'Histoire de la Résistance et de la Déportation,2014,RHONE-ALPES,LYON,42825,39992,82817,
Musée des Beaux-Arts,2014,RHONE-ALPES,CHAMBERY,4881,21869,26750,
Musée de l'Arche,2014,ST PIERRE ET MIQUELON,SAINT-PIERRE ET MIQUELON,2141,1735,3876,
Musée de la Poterie,2015,ALSACE,BETSCHDORF,2200,749,2949,
Musée de Bouxwiller et du Pays de Hanau,2015,ALSACE,BOUXWILLER,3062,1246,4308,
Musée Historique,2015,ALSACE,HAGUENAU,2475,4730,7205,
Maison de l'Archéologie des Vosges du Nord,2015,ALSACE,NIEDERBRONN-LES-BAINS,1945,1101,3046,
Musée du Château des Rohan,2015,ALSACE,SAVERNE,3535,3870,7405,
Musée d'Art Moderne et Contemporain de Strasbourg,2015,ALSACE,STRASBOURG,50528,82825,133353,
Musée Archéologique,2015,ALSACE,STRASBOURG,19154,28662,47816,
Cité du Train,2015,ALSACE,MULHOUSE,66480,27123,93603,
Musée National de l'Automobile - Collection Schlumpf,2015,ALSACE,MULHOUSE,162727,26891,189618,
Musée de l'Impression sur Etoffes,2015,ALSACE,MULHOUSE,17663,14789,32452,
Musée Vauban,2015,ALSACE,NEUF-BRISACH,2621,0,2621,
Ecomusée d'Alsace,2015,ALSACE,UNGERSHEIM,201929,0,201929,
Musée National de la Préhistoire,2015,AQUITAINE,LES EYZIES-DE-TAYAC,39750,33781,73531,
Musée Militaire - Souvenir du Périgord,2015,AQUITAINE,PERIGUEUX,2064,637,2701,
Musée des Arts Décoratifs et du Design,2015,AQUITAINE,BORDEAUX,16027,27052,43079,
Musée des Beaux-Arts,2015,AQUITAINE,BORDEAUX,111625,0,111625,
Musée Despiau-Wlérick,2015,AQUITAINE,MONT-DE-MARSAN,0,12377,12377,
Musée de la Chalosse,2015,AQUITAINE,MONTFORT-EN-CHALOSSE,5277,3249,8526,
Musée Municipal,2015,AQUITAINE,ARUDY,1359,544,1903,
Centre National du Costume de Scène et de la Scénographie,2015,AUVERGNE,MOULINS,44846,15642,60488,
Musée Rieckotter,2015,AUVERGNE,NERIS-LES-BAINS,607,805,1412,
Musée des Sciences,2015,AUVERGNE,AURILLAC,2901,6549,9450,
Ecomusée de Margeride-Haute-Auvergne,2015,AUVERGNE,RUYNES-EN-MARGERIDE,5488,3321,8809,
Musée Municipal de la Coutellerie,2015,AUVERGNE,THIERS,19344,4169,23513,
Musée du Vin de Bourgogne,2015,BOURGOGNE,BEAUNE,13167,3600,16767,
Musée des Beaux-Arts,2015,BOURGOGNE,BEAUNE,4664,2400,7064,
Musée Municipal François Pompon,2015,BOURGOGNE,SAULIEU,2903,5649,8552,
Musée Municipal,2015,BOURGOGNE,SEMUR-EN-AUXOIS,3782,3076,6858,
Musée du Septennat,2015,BOURGOGNE,CHATEAU-CHINON,7762,1778,9540,
Musée du Costume,2015,BOURGOGNE,CHATEAU-CHINON,3009,1131,4140,
Musée de la Mine,2015,BOURGOGNE,LA MACHINE,5332,892,6224,
Ecomusée de la Communauté Le Creusot-Monceau-Les-Mines,2015,BOURGOGNE,LE CREUSOT,8967,3322,12289,
Musée Eucharistique du Hiéron,2015,BOURGOGNE,PARAY-LE-MONIAL,4116,5079,9195,
Ecomusée de la Bresse Bourguignonne,2015,BOURGOGNE,PIERRE-DE-BRESSE,26262,15427,41689,
Muséum - Maison de l'Eau,2015,BOURGOGNE,AUXERRE,0,13787,13787,
Musée d'Art et d'Histoire,2015,BOURGOGNE,AUXERRE,0,37017,37017,
Musée de l'Aventure du Son,2015,BOURGOGNE,SAINT-FARGEAU,2910,443,3353,
Musée Zervos - Maison Romain Rolland,2015,BOURGOGNE,VEZELAY,7766,2405,10171,
Musée des Beaux-Arts de Brest,2015,BRETAGNE,BREST,7690,15762,23452,
Musée des Beaux-Arts,2015,BRETAGNE,QUIMPER,35572,6340,41912,
Musée de l'Ecole Rurale en Bretagne,2015,BRETAGNE,TREGARVAN,9189,2222,11411,
Musée de Bretagne,2015,BRETAGNE,RENNES,20258,45972,66230,
Musée National de la Marine,2015,BRETAGNE,PORT-LOUIS,39756,30292,70048,
Musée Municipal,2015,CENTRE,VIERZON,1573,6104,7677,
Musée du Château Saint-Jean,2015,CENTRE,NOGENT-LE-ROTROU,7957,11289,19246,
Musée de la Chemiserie et de l'Elégance Masculine,2015,CENTRE,ARGENTON-SUR-CREUSE,3026,4180,7206,
Musées de Châteauroux - Hôtel Bertrand,2015,CENTRE,CHATEAUROUX,0,13578,13578,
Musée George Sand et de la Vallée Noire,2015,CENTRE,LA CHATRE,3538,5717,9255,
"""Maison Musée"" René Descartes",2015,CENTRE,DESCARTES,1316,545,1861,
Musée Municipal,2015,CENTRE,SAINTE-MAURE-DE-TOURAINE,0,759,759,
Musée du Savignéen,2015,CENTRE,SAVIGNE-SUR-LATHAN,1904,315,2219,
Ecomusée du Véron,2015,CENTRE,SAVIGNY-EN-VERON,2479,2228,4707,
Musée François Rabelais,2015,CENTRE,SEUILLY,8963,2836,11799,
Muséum d'Histoire Naturelle,2015,CENTRE,TOURS,14083,29338,43421,
Musée du Compagnonnage,2015,CENTRE,TOURS,22641,13543,36184,
Château Musées de Blois,2015,CENTRE,BLOIS,234906,36822,271728,
Musée de Vendôme,2015,CENTRE,VENDOME,0,16940,16940,
Musée de la Marine de Loire,2015,CENTRE,CHATEAUNEUF-SUR-LOIRE,7068,6159,13227,
Musée Gaston Couté,2015,CENTRE,MEUNG-SUR-LOIRE,0,2052,2052,
Musée Historique et Archéologique,2015,CENTRE,ORLEANS,1185,10821,12006,
Musée du Château-Fort,2015,CHAMPAGNE-ARDENNES,SEDAN,55491,2013,57504,
Musée Municipal,2015,CHAMPAGNE-ARDENNES,BOURBONNE-LES-BAINS,0,1953,1953,
Musée des Beaux-Arts et d'Archéologie,2015,CHAMPAGNE-ARDENNES,CHAUMONT,760,2156,2916,
Musée de la Coutellerie,2015,CHAMPAGNE-ARDENNES,NOGENT,4321,1458,5779,
Musée Municipal,2015,CHAMPAGNE-ARDENNES,CHALONS-EN-CHAMPAGNE,1231,9661,10892,
Musée Napoléonien,2015,CORSE,AJACCIO,4518,2107,6625,
Musée de l'Alta Rocca,2015,CORSE,LEVIE,5825,9500,15325,
Musée d'archéologie d'Aleria - Jérôme Carcopino,2015,CORSE,ALERIA,29954,0,29954,
Musée du Temps,2015,FRANCHE-COMTE,BESANCON,7272,35433,42705,
Musée des Beaux-Arts et d'Archéologie,2015,FRANCHE-COMTE,BESANCON,30214,16255,46469,
Musée de Pontarlier,2015,FRANCHE-COMTE,PONTARLIER,723,5858,6581,
Ecomusée du Pays de la Cerise,2015,FRANCHE-COMTE,FOUGEROLLES,7124,2134,9258,
Musée de la Tour des Echevins,2015,FRANCHE-COMTE,LUXEUIL-LES-BAINS,3102,0,3102,
Musée de la Vigne et du Vin,2015,FRANCHE-COMTE,ARBOIS,2611,1748,4359,
Musée du Jouet,2015,FRANCHE-COMTE,MOIRANS-EN-MONTAGNE,37034,10169,47203,
Musée de l'Abbaye/Donations Guy Bardone - René Genis,2015,FRANCHE-COMTE,SAINT-CLAUDE,7904,3510,11414,
Musée de l'Artisanat Jurassien,2015,FRANCHE-COMTE,VOITEUR,0,22672,22672,
Musée du Château,2015,ILE-DE-FRANCE,DOURDAN,9539,8645,18184,
Musée Intercommunal d'Etampes,2015,ILE-DE-FRANCE,ETAMPES,684,5640,6324,
Musée - Atelier Rodin (Annexe du musée de Paris),2015,ILE-DE-FRANCE,MEUDON,5769,8622,14391,
Musée d'Histoire Locale - Mémoire de la Ville,2015,ILE-DE-FRANCE,RUEIL-MALMAISON,0,2774,2774,
Musée National des Châteaux de Malmaison et de Bois-Préau,2015,ILE-DE-FRANCE,RUEIL-MALMAISON,47974,36143,84117,
Musée des Avelines - Musée d'Art et d'Histoire,2015,ILE-DE-FRANCE,SAINT-CLOUD,1258,16074,17332,
Cité de la céramique - Sèvres & Limoges,2015,ILE-DE-FRANCE,SEVRES,35402,31923,67325,
MUS - Musée d'Histoire Urbaine et Sociale,2015,ILE-DE-FRANCE,SURESNES,1510,6495,8005,
Maison de Victor Hugo,2015,ILE-DE-FRANCE,PARIS,26980,100219,127199,
Musée National Gustave Moreau,2015,ILE-DE-FRANCE,PARIS,31538,26701,58239,
Musée de l'Armée,2015,ILE-DE-FRANCE,PARIS,828467,581724,1410191,
Musée National Auguste Rodin,2015,ILE-DE-FRANCE,PARIS,389619,162405,552024,
Musée d'Art Moderne de la ville de Paris,2015,ILE-DE-FRANCE,PARIS,436445,233596,670041,
Etablissement Public de la Porte Dorée - Palais,2015,ILE-DE-FRANCE,PARIS,10840,21310,32150,
Musée de la Chasse et de la Nature,2015,ILE-DE-FRANCE,PARIS,27254,30171,57425,
Musée d'Art et d'Histoire du Judaïsme,2015,ILE-DE-FRANCE,PARIS,55380,35848,91228,
Musée Départemental de l'Ecole de Barbizon - Auberge Ganne,2015,ILE-DE-FRANCE,BARBIZON,15683,8801,24484,
Musée Gatien Bonnet,2015,ILE-DE-FRANCE,LAGNY-SUR-MARNE,0,4533,4533,
Musée Bossuet,2015,ILE-DE-FRANCE,MEAUX,3252,8143,11395,
Musée Municipal,2015,ILE-DE-FRANCE,MORET-SUR-LOING,0,1964,1964,
Musée de Provins et du Provinois,2015,ILE-DE-FRANCE,PROVINS,18132,3732,21864,
"MAC VAL, Musée d'Art Contemporain du Val-de-Marne",2015,ILE-DE-FRANCE,VITRY SUR SEINE,9066,61240,70306,
Musée de l'Hôtel-Dieu,2015,ILE-DE-FRANCE,MANTES-LA-JOLIE,1453,2006,3459,
Musée-Maison Maurice Ravel,2015,ILE-DE-FRANCE,MONTFORT-L'AMAURY,1513,0,1513,
Musée Départemental Maurice Denis,2015,ILE-DE-FRANCE,SAINT-GERMAIN-EN-LAYE,20736,0,20736,
Musée-Bibliothèque Pierre-André Benoît,2015,LANGUEDOC-ROUSSILLON,ALES,9904,9001,18905,
Musée Municipal de la Vignasse,2015,LANGUEDOC-ROUSSILLON,BEAUCAIRE,1075,2015,3090,
Musée du Vieux Nîmes,2015,LANGUEDOC-ROUSSILLON,NIMES,570,16513,17083,
Musée de la Cloche et de la Sonnaille,2015,LANGUEDOC-ROUSSILLON,HEREPIAN,2547,1234,3781,
Musée de l'Ephèbe,2015,LANGUEDOC-ROUSSILLON,LE CAP D'AGDE,8982,4575,13557,
Musée de Tautavel,2015,LANGUEDOC-ROUSSILLON,TAUTAVEL,58945,11074,70019,
Musée du Président Jacques Chirac,2015,LIMOUSIN,SARRAN,15967,4184,20151,
Musée de la Mémoire et des Industries Tullistes,2015,LIMOUSIN,TULLE,0,3277,3277,
Musée du Pays d'Ussel,2015,LIMOUSIN,USSEL,451,1791,2242,
Musée Municipal des Beaux-Arts de Limoges - Palais de l'Evêché,2015,LIMOUSIN,LIMOGES,1750,39286,41036,
Musée de l'Histoire du Fer,2015,LORRAINE,JARVILLE-LA-MALGRANGE,3534,6564,10098,
Palais des ducs de Lorraine - Musée Historique Lorrain,2015,LORRAINE,NANCY,15650,56870,72520,
Musée d'Art et d'Histoire de Toul,2015,LORRAINE,TOUL,0,5197,5197,
Musée de la Bière et du Pays de Stenay,2015,LORRAINE,STENAY,7610,12261,19871,
Musée de la Mine - Carreau Wendel,2015,LORRAINE,PETITE-ROSSELLE,42949,26140,69089,
Musée Départemental Georges de la Tour,2015,LORRAINE,VIC-SUR-SEILLE,5451,4530,9981,
Musée de l'Image,2015,LORRAINE,EPINAL,21151,3541,24692,
Musée des Arts et Métiers Traditionnels,2015,MIDI-PYRENEES,SALLES-LA-SOURCE,4507,1819,6326,
Musée de l'Armagnac,2015,MIDI-PYRENEES,CONDOM,1107,243,1350,
Musée Campanaire,2015,MIDI-PYRENEES,L'ISLE JOURDAIN,3371,1260,4631,
Musée du Pays de Luchon,2015,MIDI-PYRENEES,BAGNERES-DE-LUCHON,1654,512,2166,
Musée Municipal,2015,MIDI-PYRENEES,MARTRES-TOLOSANE,929,2477,3406,
Le Musée - Arts et Figures des Pyrénées Centrales,2015,MIDI-PYRENEES,SAINT-GAUDENS,0,4116,4116,
"Les Abattoirs, Musée d'Art Moderne et Contemporain",2015,MIDI-PYRENEES,TOULOUSE,58508,95551,154059,
Musée des Augustins,2015,MIDI-PYRENEES,TOULOUSE,48755,80318,129073,
Musée du Pays de Retz,2015,MIDI-PYRENEES,BOURGNEUF-EN-RETZ,2025,959,2984,
Musée Goya,2015,MIDI-PYRENEES,CASTRES,12164,11056,23220,
Muséum d'histoire naturelle Philadelphe Thomas,2015,MIDI-PYRENEES,GAILLAC,1195,5680,6875,
Musée Raymond Lafage,2015,MIDI-PYRENEES,LISLE-SUR-TARN,1274,4026,5300,
Musée de l'Ostrevant,2015,NORD-PAS-DE-CALAIS,BOUCHAIN,141,699,840,
Musée d'Archéologie et d'Histoire Locale,2015,NORD-PAS-DE-CALAIS,DENAIN,0,3800,3800,
Lieu d'Art et Action Contemporaine de Dunkerque - LAAC,2015,NORD-PAS-DE-CALAIS,DUNKERQUE,13178,12072,25250,
Musée Portuaire,2015,NORD-PAS-DE-CALAIS,DUNKERQUE,32147,22864,55011,
Musée Municipal d'Escaudain,2015,NORD-PAS-DE-CALAIS,ESCAUDAIN,0,237,237,
"Musée de la Mine, Centre Historique Minier",2015,NORD-PAS-DE-CALAIS,LEWARDE,132378,13938,146316,
Musée d'Histoire Locale de Marchiennes,2015,NORD-PAS-DE-CALAIS,MARCHIENNES,151,408,559,
La Piscine - Musée d'Art et d'Industrie André Diligent de Roubaix,2015,NORD-PAS-DE-CALAIS,ROUBAIX,164578,78106,242684,
Musée du Verre,2015,NORD-PAS-DE-CALAIS,SARS-POTERIES,3406,2645,6051,
Musée Communautaire Opale-Sud,2015,NORD-PAS-DE-CALAIS,BERCK-SUR-MER,2351,5846,8197,
Musée Régional d'Ethnologie,2015,NORD-PAS-DE-CALAIS,BETHUNE,0,3890,3890,
Musée de la Céramique,2015,NORD-PAS-DE-CALAIS,DESVRES,7295,2371,9666,
Musée d'Art et d'Histoire Roger Rodière,2015,NORD-PAS-DE-CALAIS,MONTREUIL-SUR-MER,10974,15826,26800,
Musée de l'Hôtel Sandelin,2015,NORD-PAS-DE-CALAIS,SAINT-OMER,7123,8157,15280,
Muséum Emmanuel Liais,2015,BASSE-NORMANDIE,CHERBOURG-EN-COTENTIN,0,13669,13669,
Musée Christian Dior,2015,BASSE-NORMANDIE,GRANVILLE,32969,5580,38549,
"Musée du Bocage Normand, ferme du bois Jugan",2015,BASSE-NORMANDIE,SAINT-LO,2967,3749,6716,
Musée du Granit,2015,BASSE-NORMANDIE,SAINT-MICHEL-DE-MONTJOIE,74,2080,2154,
Musée du Verre et de la Pierre,2015,HAUTE-NORMANDIE,CONCHES-EN-OUCHE,1510,2542,4052,
Musée Artisanal et Industriel d'Instruments à Vent,2015,HAUTE-NORMANDIE,LA COUTURE-BOUSSEY,2482,1236,3718,
Musée Municipal,2015,HAUTE-NORMANDIE,LOUVIERS,0,5967,5967,
Château-Musée de Dieppe,2015,HAUTE-NORMANDIE,DIEPPE,17457,13365,30822,
Abbaye de Graville - Musée du Prieuré de Graville,2015,HAUTE-NORMANDIE,LE HAVRE,1998,5645,7643,
Musée Industriel de la Corderie Vallois,2015,HAUTE-NORMANDIE,NOTRE-DAME-DE-BONDEVILLE,2502,7461,9963,
MUNAE - Musée National de l'Education,2015,HAUTE-NORMANDIE,ROUEN,10744,6727,17471,
Musée des Beaux-Arts,2015,HAUTE-NORMANDIE,ROUEN,53856,66576,120432,
Association de l'Horlogerie Aliermontaise,2015,HAUTE-NORMANDIE,SAINT-NICOLAS-D'ALIERMONT,4048,2516,6564,
Musée Victor Hugo,2015,HAUTE-NORMANDIE,VILLEQUIER,5378,7352,12730,
Musée du Château des Ducs de Bretagne,2015,PAYS DE LA LOIRE,NANTES,91337,147117,238454,
Musée Municipal,2015,PAYS DE LA LOIRE,ERNEE,0,32,32,
Musée de l'Ardoise et de la Géologie,2015,PAYS DE LA LOIRE,RENAZE,598,501,1099,
Musée de l'Abbaye de Sainte-Croix,2015,PAYS DE LA LOIRE,LES SABLES D'OLONNE,5556,18422,23978,
Musée Clemenceau et de Lattre-de-Tassigny,2015,PAYS DE LA LOIRE,MOUILLERON-EN-PAREDS,1720,3322,5042,
Musée Jean de la Fontaine,2015,PICARDIE,CHATEAU-THIERRY,10481,2353,12834,
Musée d'Art et d'Archéologie,2015,PICARDIE,LAON,1180,4024,5204,
Musée Alexandre Dumas,2015,PICARDIE,VILLERS COTTERETS,730,1031,1761,
Musée Départemental de l'Oise,2015,PICARDIE,BEAUVAIS,0,69745,69745,
Musée de la Nacre et de la Tabletterie,2015,PICARDIE,MERU,14313,4678,18991,
Musée de la Vénerie,2015,PICARDIE,SENLIS,2411,3955,6366,
Musée Lombart,2015,PICARDIE,DOULLENS,156,4147,4303,
Musée des Beaux-Arts,2015,POITOU-CHARENTES,ANGOULEME,3279,40494,43773,
Cité International de la Bande Dessinée et de l'Image - Musée de la Bande Dessinée,2015,POITOU-CHARENTES,ANGOULEME,15096,39565,54661,
Musée des Arts du Cognac (Annexe musée municipal),2015,POITOU-CHARENTES,COGNAC,8795,5581,14376,
Musée du Nouveau Monde,2015,POITOU-CHARENTES,LA ROCHELLE,5723,12675,18398,
Musée Municipal des Cordeliers,2015,POITOU-CHARENTES,SAINT-JEAN-D'ANGELY,999,7542,8541,
Musée ethnographique et archéologique du Donjon,2015,POITOU-CHARENTES,NIORT,8500,9500,18000,
Musée des Traditions Populaires et d'Archéologie,2015,POITOU-CHARENTES,CHAUVIGNY,7282,2272,9554,
Musée de l'hypogée des Dunes,2015,POITOU-CHARENTES,POITIERS,0,425,425,
Musée Municipal,2015,PROVENCE-ALPES-CÔTE D'AZUR,FORCALQUIER,0,600,600,
Musée de Salagon,2015,PROVENCE-ALPES-CÔTE D'AZUR,MANE,26195,5371,31566,
Musée Fernand Léger,2015,PROVENCE-ALPES-CÔTE D'AZUR,BIOT,12799,13336,26135,
Musée de la Mer,2015,PROVENCE-ALPES-CÔTE D'AZUR,CANNES,45059,37823,82882,
Musée International de la Parfumerie,2015,PROVENCE-ALPES-CÔTE D'AZUR,GRASSE,63209,40008,103217,
Muséum d'Histoire Naturelle,2015,PROVENCE-ALPES-CÔTE D'AZUR,NICE,1642,3332,4974,
Musée Picasso la guerre et la paix à Vallauris,2015,PROVENCE-ALPES-CÔTE D'AZUR,VALLAURIS,19260,8531,27791,
Musée de l'Uniforme - Musée de la Légion Etrangère,2015,PROVENCE-ALPES-CÔTE D'AZUR,PUYLOUBIER,0,8302,8302,
Musée d'Histoire et d'Archéologie des Baux-de-Provence,2015,PROVENCE-ALPES-CÔTE D'AZUR,LES BAUX DE PROVENCE,270000,0,270000,
Musée d'Histoire de Marseille,2015,PROVENCE-ALPES-CÔTE D'AZUR,MARSEILLE,21890,51353,73243,
Musée d'Art Contemporain - Galeries Contemporaines,2015,PROVENCE-ALPES-CÔTE D'AZUR,MARSEILLE,21740,25397,47137,
Musée Ziem,2015,PROVENCE-ALPES-CÔTE D'AZUR,MARTIGUES,0,15149,15149,
Musée Suffren et du Vieux Saint-Cannat,2015,PROVENCE-ALPES-CÔTE D'AZUR,SAINT-CANNAT,0,1031,1031,
Musée Municipal Paul Lafran,2015,PROVENCE-ALPES-CÔTE D'AZUR,SAINT-CHAMAS,0,3567,3567,
Musée des Alpilles,2015,PROVENCE-ALPES-CÔTE D'AZUR,SAINT-REMY-DE-PROVENCE,2596,5087,7683,
Musée Estrine - Présence Van Gogh,2015,PROVENCE-ALPES-CÔTE D'AZUR,SAINT-REMY-DE-PROVENCE,7586,6212,13798,
Musée du Pays Brignolais,2015,PROVENCE-ALPES-CÔTE D'AZUR,BRIGNOLES,848,0,848,
Musée Municipal,2015,PROVENCE-ALPES-CÔTE D'AZUR,DRAGUIGNAN,0,12000,12000,
Musée des A.T.P. de Moyenne Provence,2015,PROVENCE-ALPES-CÔTE D'AZUR,DRAGUIGNAN,1681,7660,9341,
Musée Municipal,2015,PROVENCE-ALPES-CÔTE D'AZUR,HYERES,5866,6368,12234,
Musée d'Apt,2015,PROVENCE-ALPES-CÔTE D'AZUR,APT,2386,6943,9329,
Muséum d'Histoire Naturelle Esprit Requien,2015,PROVENCE-ALPES-CÔTE D'AZUR,AVIGNON,0,16351,16351,
Synagogue Musée Juif Comtadin,2015,PROVENCE-ALPES-CÔTE D'AZUR,CAVAILLON,2292,1719,4011,
Musée du Brou,2015,RHONE-ALPES,BOURG-EN-BRESSE,76918,35942,112860,
Musée Louis Jourdan,2015,RHONE-ALPES,SAINT-PAUL-DE-VARAX,169,137,306,
Musée du Rhône,2015,RHONE-ALPES,TOURNON-SUR-RHÔNE,12537,17268,29805,
Musée-château d'Annecy,2015,RHONE-ALPES,ANNECY,50406,63011,113417,
Musée de Bourgoin-Jallieu,2015,RHONE-ALPES,BOURGOIN-JALLIEU,498,10270,10768,
Musée de la Résistance de la Déportation de l'Isère,2015,RHONE-ALPES,GRENOBLE,0,25116,25116,
Muséum d'Histoire Naturelle de Grenoble,2015,RHONE-ALPES,GRENOBLE,30345,61450,91795,
Musée des Beaux-Arts et d'Archéologie,2015,RHONE-ALPES,VIENNE,1548,2243,3791,
Musée-Cloître Saint-André-Le-Bas,2015,RHONE-ALPES,VIENNE,3606,4103,7709,
Atelier - Musée du Chapeau,2015,RHONE-ALPES,CHAZELLES-SUR-LYON,19619,5030,24649,
Musée d'Archéologie,2015,RHONE-ALPES,FEURS,2185,4180,6365,
Musée d'Art et d'Industrie,2015,RHONE-ALPES,SAINT-ETIENNE,21269,25386,46655,
Château de la Bastie d'Urfé,2015,RHONE-ALPES,SAINT-ETIENNE-LE-MOLARD,7824,18519,26343,
Musées Gadagne,2015,RHONE-ALPES,LYON,27710,44006,71716,
Musée des Beaux-Arts,2015,RHONE-ALPES,LYON,107813,193445,301258,
Musée des Sapeurs-Pompiers de Lyon,2015,RHONE-ALPES,LYON,4063,4371,8434,
Musée Henri Malartre,2015,RHONE-ALPES,ROCHETAILLEE-SUR-SAONE,12786,15351,28137,
Ecomusée du Haut Beaujolais,2015,RHONE-ALPES,THIZY-LES-BOURGS,0,1579,1579,
Musée archéologique et minéralogique Pierre Borrione,2015,RHONE-ALPES,AIME-EN-TARENTAISE,449,194,643,
Musée du Brou,2016,AUVERGNE-RHONE-ALPES,BOURG-EN-BRESSE,74138,24813,98951,
Musée du Bugey-Valmorey,2016,AUVERGNE-RHONE-ALPES,LOCHIEU,2413,2377,4790,
Musée Municipal de Gannat,2016,AUVERGNE-RHONE-ALPES,GANNAT,610,2093,2703,
Musée Vivarois César Filhol,2016,AUVERGNE-RHONE-ALPES,ANNONAY,35,105,140,
Musée des Vans,2016,AUVERGNE-RHONE-ALPES,LES VANS,453,912,1365,
Musée et Site Archéologiques,2016,AUVERGNE-RHONE-ALPES,SOYONS,10591,1726,12317,
Musée d'Art et d'Archéologie,2016,AUVERGNE-RHONE-ALPES,AURILLAC,961,19394,20355,
Musée International de la Chaussure,2016,AUVERGNE-RHONE-ALPES,ROMANS,15977,13073,29050,
Musée-château d'Annecy,2016,AUVERGNE-RHONE-ALPES,ANNECY,65545,56704,122249,
Musée Archéologique Grenoble Saint-Laurent,2016,AUVERGNE-RHONE-ALPES,GRENOBLE,0,45005,45005,
Maison du Patrimoine de Hières-sur-Amby,2016,AUVERGNE-RHONE-ALPES,HIERES SUR AMBY,6907,2306,9213,
Musée Hébert,2016,AUVERGNE-RHONE-ALPES,LA TRONCHE,0,36092,36092,
Musée Départemental de la Révolution Française,2016,AUVERGNE-RHONE-ALPES,VIZILLE,4748,53268,58016,
Musée de la Soierie,2016,AUVERGNE-RHONE-ALPES,CHARLIEU,4287,1256,5543,
Musée de la Diana,2016,AUVERGNE-RHONE-ALPES,MONTBRISON,714,579,1293,
Musée des Beaux-Arts et d'Archéologie J. Dechelette,2016,AUVERGNE-RHONE-ALPES,ROANNE,3452,5706,9158,
Musée de la Mine / Site Couriot,2016,AUVERGNE-RHONE-ALPES,SAINT-ETIENNE,29629,43521,73150,
Musée de l'Imprimerie et de la Communication Graphique,2016,AUVERGNE-RHONE-ALPES,LYON,16384,10094,26478,
Musée Paul Dini,2016,AUVERGNE-RHONE-ALPES,VILLEFRANCHE-SUR-SAONE,6541,15157,21698,
Musée Municipal d'Albertville-Conflans,2016,AUVERGNE-RHONE-ALPES,ALBERTVILLE,4065,1889,5954,
Musée Alésia,2016,BOURGOGNE-FRANCHE-COMTE,ALISE-SAINTE-REINE,60993,11958,72951,
Musée Magnin,2016,BOURGOGNE-FRANCHE-COMTE,DIJON,7459,10629,18088,
Muséum - Jardin des Sciences,2016,BOURGOGNE-FRANCHE-COMTE,DIJON,13214,95944,109158,
Musée d'Art Sacré,2016,BOURGOGNE-FRANCHE-COMTE,DIJON,0,8323,8323,
Musée Municipal,2016,BOURGOGNE-FRANCHE-COMTE,SEMUR-EN-AUXOIS,2632,2635,5267,
Musée du Temps,2016,BOURGOGNE-FRANCHE-COMTE,BESANCON,8055,29993,38048,
Ecomusée du Pays de la Cerise,2016,BOURGOGNE-FRANCHE-COMTE,FOUGEROLLES,6116,2048,8164,
Musée de la Tour des Echevins,2016,BOURGOGNE-FRANCHE-COMTE,LUXEUIL-LES-BAINS,2238,935,3173,
Musée des Beaux-Arts,2016,BOURGOGNE-FRANCHE-COMTE,LONS-LE-SAUNIER,1233,9243,10476,
Musée Lapidaire Saint-Nicolas,2016,BOURGOGNE-FRANCHE-COMTE,AUTUN,0,400,400,
Museum d'Histoire Naturelle Jacques de La Comble,2016,BOURGOGNE-FRANCHE-COMTE,AUTUN,507,2584,3091,
Musée Denon,2016,BOURGOGNE-FRANCHE-COMTE,CHALON-SUR-SAONE,81,11336,11417,
Musée Nicéphore Niepce,2016,BOURGOGNE-FRANCHE-COMTE,CHALON-SUR-SAONE,0,24772,24772,
Ecomusée de la Communauté Le Creusot-Monceau-Les-Mines,2016,BOURGOGNE-FRANCHE-COMTE,LE CREUSOT,9821,3546,13367,
"L'Atelier d'un Journal"" de Louhans - Musée Municipal",2016,BOURGOGNE-FRANCHE-COMTE,LOUHANS,1521,2717,4238,
Musée Lamartine,2016,BOURGOGNE-FRANCHE-COMTE,MACON,633,2317,2950,
Hôtel Dieu - Musée Greuze,2016,BOURGOGNE-FRANCHE-COMTE,TOURNUS,7019,1735,8754,
Forge-Musée,2016,BOURGOGNE-FRANCHE-COMTE,ETUEFFONT,448,898,1346,
Musée d'Art et d'Histoire,2016,BOURGOGNE-FRANCHE-COMTE,AUXERRE,0,27043,27043,
Musée Leblanc-Duvernois,2016,BOURGOGNE-FRANCHE-COMTE,AUXERRE,0,1141,1141,
Musée Muncipal,2016,BOURGOGNE-FRANCHE-COMTE,SENS,7328,16229,23557,
Ecomusée des Monts d'Arrée - Maison Cornec,2016,BRETAGNE,RIVOAL,0,5701,5701,
Musée de Pont-Aven,2016,BRETAGNE,PONT-AVEN,90363,32181,122544,
Musée des Beaux-Arts,2016,BRETAGNE,QUIMPER,60916,6131,67047,
Musée Départemental Breton,2016,BRETAGNE,QUIMPER,13086,14561,27647,
Ecomusée du Pays de Rennes,2016,BRETAGNE,RENNES,17432,40082,57514,
Musée International du Long-Cours Cap-Hornier,2016,BRETAGNE,SAINT-MALO,6809,5114,11923,
Musée Saint-Vic,2016,CENTRE-VAL DE LOIRE,SAINT-AMAND-MONTROND,0,4347,4347,
Conservatoire du Machinisme et des Pratiques Agricoles,2016,CENTRE-VAL DE LOIRE,CHARTRES-MAINVILLIERS,7083,22877,29960,
Musée Marcel Proust,2016,CENTRE-VAL DE LOIRE,ILLIERS-COMBRAY,3915,286,4201,
Musée du Château Saint-Jean,2016,CENTRE-VAL DE LOIRE,NOGENT-LE-ROTROU,9202,10818,20020,
Atelier Musée Louis Leygue,2016,CENTRE-VAL DE LOIRE,NAVEIL,0,51,51,
Musée de Vendôme,2016,CENTRE-VAL DE LOIRE,VENDOME,0,14943,14943,
Musée Gaston Couté,2016,CENTRE-VAL DE LOIRE,MEUNG-SUR-LOIRE,0,2136,2136,
Musée Girodet,2016,CENTRE-VAL DE LOIRE,MONTARGIS,0,1500,1500,
Musée de l'Alta Rocca,2016,CORSE,LEVIE,6179,8449,14628,
Musée Archéologique de Mariana - Prince Rainier III de Monaco,2016,CORSE,LUCCIANA,0,7300,7300,
Musée Départemental Pascal Paoli,2016,CORSE,MOROSAGLIA,2383,3700,6083,
Musée Arthur Rimbaud,2016,GRAND EST,CHARLEVILLE-MEZIERES,7873,10951,18824,
Musée de l'Ardenne,2016,GRAND EST,CHARLEVILLE-MEZIERES,5527,30974,36501,
Musée Napoléon Ier,2016,GRAND EST,BRIENNE-LE-CHATEAU,992,335,1327,
Pharmacie Musée de l'Hôtel-Dieu,2016,GRAND EST,TROYES,3640,7847,11487,
Musée Alsacien,2016,GRAND EST,HAGUENAU,828,1260,2088,
Musée d'Art Moderne et Contemporain de Strasbourg,2016,GRAND EST,STRASBOURG,49095,77215,126310,
Musée Tomi Ungerer,2016,GRAND EST,STRASBOURG,21732,22655,44387,
Musée de la Coutellerie,2016,GRAND EST,NOGENT,3920,1402,5322,
Musée Sundgauvien d'Altkirch,2016,GRAND EST,ALTKIRCH,562,1615,2177,
Musée d'Unterlinden,2016,GRAND EST,COLMAR,222852,71148,294000,
Musée d'Histoire Naturelle et d'Ethnographie de Colmar,2016,GRAND EST,COLMAR,7789,5110,12899,
Musée Bartholdi,2016,GRAND EST,COLMAR,13737,9052,22789,
Musée Historique et Militaire de Huningue,2016,GRAND EST,HUNINGE,105,220,325,
Musée Historique,2016,GRAND EST,MULHOUSE,0,38899,38899,
Musée du Sapeur Pompier d'Alsace,2016,GRAND EST,VIEUX FERRETTE,4371,1127,5498,
Musée Garinet,2016,GRAND EST,CHALONS-EN-CHAMPAGNE,174,605,779,
Musée du Cloître de Notre-Dame-en-Vaux,2016,GRAND EST,CHALONS-EN-CHAMPAGNE,911,2098,3009,
Musée de l'Ancien Collège des Jésuites/Planétarium,2016,GRAND EST,REIMS,24639,18563,43202,
Les Sources d'Hercule,2016,GRAND EST,DENEUVRE,2897,1695,4592,
Musée du Château de Lunéville,2016,GRAND EST,LUNEVILLE,28610,146234,174844,
Palais des ducs de Lorraine - Musée Historique Lorrain,2016,GRAND EST,NANCY,16585,44507,61092,
Musée Jules Bastien-Lepage - Musée de la Fortification,2016,GRAND EST,MONTMEDY,10744,2937,13681,
Musée d'Art Sacré de la Meuse,2016,GRAND EST,SAINT-MIHIEL,1029,695,1724,
Musée de la Princerie,2016,GRAND EST,VERDUN,1845,3116,4961,
Maison du Verre et du Cristal,2016,GRAND EST,MEISENTHAL,15560,3630,19190,
Centre Pompidou de Metz (collections nationales decentralisées),2016,GRAND EST,METZ,148792,151797,300589,
Moulin de la Blies - Musée des Techniques Faïencières,2016,GRAND EST,SARREGUEMINES,11615,12090,23705,
Musée Territorial Alexandre Franconie,2016,GUYANE,CAYENNE,594,9284,9878,
Musée des Cultures Guyanaises,2016,GUYANE,CAYENNE,1440,6662,8102,
Ecomusée Municipal d'Approuague-Kaw,2016,GUYANE,REGINA,1068,3316,4384,
Familistère de Guise,2016,HAUTS-DE-FRANCE,GUISE,56799,8491,65290,
Musée d'Art et d'Archéologie,2016,HAUTS-DE-FRANCE,LAON,1285,3175,4460,
Musée Entomologique,2016,HAUTS-DE-FRANCE,SAINT-QUENTIN,0,22896,22896,
Musée Benoît de Puydt,2016,HAUTS-DE-FRANCE,BAILLEUL,1675,2736,4411,
Musée Départemental de Flandre,2016,HAUTS-DE-FRANCE,CASSEL,33581,16203,49784,
Musée de la Chartreuse,2016,HAUTS-DE-FRANCE,DOUAI,2203,30451,32654,
Musée Portuaire,2016,HAUTS-DE-FRANCE,DUNKERQUE,31712,23283,54995,
"Centre Historique Minier, Musée de la Mine, Centre d'Archives, Centre de Culture Scientifique de l'Energie",2016,HAUTS-DE-FRANCE,LEWARDE,131295,10978,142273,
Palais des Beaux-Arts de Lille,2016,HAUTS-DE-FRANCE,LILLE,109940,141750,251690,
Musée de l'Hospice Comtesse,2016,HAUTS-DE-FRANCE,LILLE,30806,20588,51394,
La Piscine - Musée d'Art et d'Industrie André Diligent de Roubaix,2016,HAUTS-DE-FRANCE,ROUBAIX,107625,109032,216657,
Musée de la Tour Abbatiale,2016,HAUTS-DE-FRANCE,SAINT-AMAND-LES-EAUX,0,17683,17683,
Musée des Beaux-Arts,2016,HAUTS-DE-FRANCE,VALENCIENNES,25149,15284,40433,
"LAM - Lille Métropole Musée d'Art Moderne, d'Art Contemporain et d'Art Brut",2016,HAUTS-DE-FRANCE,VILLENEUVE-D'ASCQ,218661,49994,268655,
Musée du Château de Compiègne,2016,HAUTS-DE-FRANCE,COMPIEGNE,37011,49340,86351,
Musée des Beaux-Arts et de la Dentelle,2016,HAUTS-DE-FRANCE,CALAIS,6920,15671,22591,
Musée d'Histoire et d'Archéologie,2016,HAUTS-DE-FRANCE,HARNES,0,824,824,
Musée de l'Hôtel Sandelin,2016,HAUTS-DE-FRANCE,SAINT-OMER,5107,11074,16181,
Musée Boucher-de-Perthes,2016,HAUTS-DE-FRANCE,ABBEVILLE,1578,10436,12014,
Musée des Années Trente,2016,ILE-DE-FRANCE,BOULOGNE-BILLANCOURT,19886,0,19886,
Fondation Arp,2016,ILE-DE-FRANCE,CLAMART,997,1070,2067,
Musée d'Art et d'Histoire,2016,ILE-DE-FRANCE,MEUDON,2536,8939,11475,
Musée d'Histoire Locale - Mémoire de la Ville (& musée Franco Suisse),2016,ILE-DE-FRANCE,RUEIL-MALMAISON,0,7255,7255,
Musée des Avelines - Musée d'Art et d'Histoire,2016,ILE-DE-FRANCE,SAINT-CLOUD,1225,19386,20611,
Musée des Arts Décoratifs (Union Centrale des Arts Décoratifs),2016,ILE-DE-FRANCE,PARIS,298727,254078,552805,
Etablissement public du musée d'Orsay et de l'Orangerie - Musée de l'Orangerie,2016,ILE-DE-FRANCE,PARIS,499102,282928,782030,
Maison de Victor Hugo,2016,ILE-DE-FRANCE,PARIS,42214,80974,123188,
Musée National Picasso,2016,ILE-DE-FRANCE,PARIS,449555,220445,670000,
Crypte Archéologique du Parvis Notre-Dame,2016,ILE-DE-FRANCE,PARIS,51296,127623,178919,
Galerie de Botanique (Muséum National National d'Histoire Naturelle),2016,ILE-DE-FRANCE,PARIS,4736,3027,7763,
Musée National Auguste Rodin,2016,ILE-DE-FRANCE,PARIS,414142,169865,584007,
Musée de la Musique,2016,ILE-DE-FRANCE,PARIS,182877,91282,274159,
Musée National Gustave Moreau,2016,ILE-DE-FRANCE,PARIS,28189,23767,51956,
Musée de la Franc-Maçonnerie,2016,ILE-DE-FRANCE,PARIS,15950,6160,22110,
Établissement Public de la Porte Dorée - Musée de National de l’Histoire de l’Immigration,2016,ILE-DE-FRANCE,PARIS,51678,55302,106980,
Etablissement Public de la Porte Dorée - Palais,2016,ILE-DE-FRANCE,PARIS,9401,13706,23107,
Musée Bourdelle,2016,ILE-DE-FRANCE,PARIS,2720,36657,39377,
Musée du Maréchal Leclerc de Hauteclocque et de la Libération de Paris - musée Jean Moulin,2016,ILE-DE-FRANCE,PARIS,811,12704,13515,
Musée d'Ennery,2016,ILE-DE-FRANCE,PARIS,0,777,777,
Institut du Monde Arabe,2016,ILE-DE-FRANCE,PARIS,59064,64596,123660,
L'Adresse Musée de la Poste,2016,ILE-DE-FRANCE,PARIS,12745,27182,39927,
Musée Bossuet,2016,ILE-DE-FRANCE,MEAUX,3685,8599,12284,
Musée de la Gendarmerie Nationale,2016,ILE-DE-FRANCE,MELUN,11055,11822,22877,
Musée Départemental de Préhistoire d'Île de France,2016,ILE-DE-FRANCE,NEMOURS,3931,22953,26884,
Musée de l'Air et de l'Espace,2016,ILE-DE-FRANCE,LE BOURGET,121826,70137,191963,
Musée de Saint-Maur - Villa Médicis,2016,ILE-DE-FRANCE,LA VARENNE-SAINT-HILAIRE,227,10970,11197,
Musée de Nogent-Sur-Marne,2016,ILE-DE-FRANCE,NOGENT-SUR-MARNE,498,6108,6606,
Musée Tavet Delacour,2016,ILE-DE-FRANCE,PONTOISE,3136,3669,6805,
Musée Camille Pissarro,2016,ILE-DE-FRANCE,PONTOISE,0,1943,1943,
Musée de la Ville,2016,ILE-DE-FRANCE,MONTIGNY LE BRETONNEUX,2298,2239,4537,
Musée du Jouet Pierre Pinel,2016,ILE-DE-FRANCE,POISSY,5860,3752,9612,
Musée Rambolitrain,2016,ILE-DE-FRANCE,RAMBOUILLET,16327,2265,18592,
Musée Municipal - Collections Paul et André Véra,2016,ILE-DE-FRANCE,SAINT-GERMAIN-EN-LAYE,0,2816,2816,
Etablissement Public du Musée et du Domaine National de Versailles,2016,ILE-DE-FRANCE,VERSAILLES,5177020,1524173,6701193,
Musée de Normandie,2016,NORMANDIE,CAEN,18390,32375,50765,
Musée de la Mine,2016,NORMANDIE,LE MOLAY-LITTRY,2014,731,2745,
Musée du Château,2016,NORMANDIE,PONTECOULANT,3125,1340,4465,
Château de Saint-Germain de Livet,2016,NORMANDIE,SAINT-GERMAIN DE LIVET,8638,7968,16606,
Paléospace / Musée Paléontologique,2016,NORMANDIE,VILLERS-SUR-MER,44452,6328,50780,
Musée du Verre et de la Pierre,2016,NORMANDIE,CONCHES-EN-OUCHE,1942,1947,3889,
Musée de l'Ancien Evêché,2016,NORMANDIE,EVREUX,0,23133,23133,
Musée Artisanal et Industriel d'Instruments à Vent,2016,NORMANDIE,LA COUTURE-BOUSSEY,1965,1303,3268,
Musée Municipal Nicolas Poussin,2016,NORMANDIE,LES ANDELYS,1667,1219,2886,
Musée Municipal d'Avranches,2016,NORMANDIE,AVRANCHES,0,5487,5487,
Musée de l'Abbaye,2016,NORMANDIE,CERISY-LA-FORET,4556,546,5102,
Muséum Emmanuel Liais,2016,NORMANDIE,CHERBOURG-EN-COTENTIN,1842,7607,9449,
Musée Quesnel-Morinière,2016,NORMANDIE,COUTANCES,392,7895,8287,
Musée Municipal,2016,NORMANDIE,EQUEURDREVILLLE-HAINNEVILLE,0,3000,3000,
Musée Richard Anacréon,2016,NORMANDIE,GRANVILLE,7375,6079,13454,
"Musée du Bocage Normand, ferme du bois Jugan",2016,NORMANDIE,SAINT-LO,1429,2493,3922,
Maison des Templiers,2016,NORMANDIE,CAUDEBEC-EN-CAUX,0,500,500,
Abbaye de Graville - Musée du Prieuré de Graville,2016,NORMANDIE,LE HAVRE,2230,4898,7128,
Musée Départemental Pierre Corneille,2016,NORMANDIE,LE PETIT-COURONNE,247,2841,3088,
Musée des Antiquités de la Seine-Maritime,2016,NORMANDIE,ROUEN,157,27607,27764,
Muséum d'Histoire Naturelle,2016,NORMANDIE,ROUEN,15083,31795,46878,
Musée des Arts du Cognac (Annexe musée municipal),2016,NOUVELLE-AQUITAINE,COGNAC,7224,2562,9786,
Musée Protestant,2016,NOUVELLE-AQUITAINE,LA ROCHELLE,1027,682,1709,
Musée du Président Jacques Chirac,2016,NOUVELLE-AQUITAINE,SARRAN,14801,4601,19402,
Musée ethnographique et archéologique du Donjon,2016,NOUVELLE-AQUITAINE,NIORT,7988,9018,17006,
Musée d'Art et d'Histoire Georges Turpin,2016,NOUVELLE-AQUITAINE,PARTHENAY,0,6533,6533,
Musée National de la Préhistoire,2016,NOUVELLE-AQUITAINE,LES EYZIES-DE-TAYAC,38470,32313,70783,
Musée des Arts et Traditions Populaires du Périgord,2016,NOUVELLE-AQUITAINE,MUSSIDAN,942,1212,2154,
Musée Militaire - Souvenir du Périgord,2016,NOUVELLE-AQUITAINE,PERIGUEUX,1858,984,2842,
Musée Départemental d'Art Contemporain,2016,NOUVELLE-AQUITAINE,ROCHECHOUART,7733,5711,13444,
Musée Historique de l'Hydravion,2016,NOUVELLE-AQUITAINE,BISCARROSSE,15455,2925,18380,
Musée Départemental d'Histoire et d'Archéologie,2016,NOUVELLE-AQUITAINE,HASTINGUES,5393,7034,12427,
Ecomusée de la Grande Lande,2016,NOUVELLE-AQUITAINE,SABRES,74725,16369,91094,
Musée Départemental de la Faïence et des Arts de la table,2016,NOUVELLE-AQUITAINE,SAMADET,2104,3542,5646,
Musée Municipal (Moulin de Gajac),2016,NOUVELLE-AQUITAINE,VILLENEUVE-SUR-LOT,3722,4613,8335,
Musée Basque et de l'Histoire de Bayonne,2016,NOUVELLE-AQUITAINE,BAYONNE,26348,34927,61275,
Musée Edmond Rostand,2016,NOUVELLE-AQUITAINE,CAMBO-LES-BAINS,82356,9417,91773,
Musée des Traditions Populaires et d'Archéologie,2016,NOUVELLE-AQUITAINE,CHAUVIGNY,7164,2028,9192,
Musée Charbonneau-Lassay,2016,NOUVELLE-AQUITAINE,LOUDUN,0,1020,1020,
Musée de la Préhistoire,2016,OCCITANIE,LE MAS D'AZIL,12666,546,13212,
Musée d'Archéologie,2016,OCCITANIE,MONTSEGUR,1397,13791,15188,
Eburomagus Musée Archéologique,2016,OCCITANIE,BRAM,866,2504,3370,
Musée d'Art et d'Histoire - Ensemble monumental de Narbonne,2016,OCCITANIE,NARBONNE,33432,555735,589167,
Musée des Corbières,2016,OCCITANIE,SIGEAN,189,1151,1340,
Musée Régional de Géologie Pierre Vetter,2016,OCCITANIE,DECAZEVILLE,1349,1652,3001,
Musée Municipal de Millau,2016,OCCITANIE,MILLAU,3303,13380,16683,
Musée Fenaille,2016,OCCITANIE,RODEZ,20247,16025,36272,
Musée Municipal Urbain Cabrol,2016,OCCITANIE,VILLEFRANCHE-DE-ROUERGUE,0,13126,13126,
Musée-Bibliothèque Pierre-André Benoît,2016,OCCITANIE,ALES,3600,9087,12687,
Musée du Vieux Nîmes,2016,OCCITANIE,NIMES,4463,10981,15444,
Carré d'Art Musée d'Art Contemporain de Nîmes,2016,OCCITANIE,NIMES,10267,36924,47191,
Musée des Beaux-Arts,2016,OCCITANIE,NIMES,146,14759,14905,
Musée Départemental d'Art Sacré du Gard,2016,OCCITANIE,PONT-SAINT-ESPRIT,192,9827,10019,
Musée Archéologique,2016,OCCITANIE,EAUZE,8143,2051,10194,
"Les Abattoirs, Musée d'Art Moderne et Contemporain",2016,OCCITANIE,TOULOUSE,52452,102641,155093,
Musée des Augustins,2016,OCCITANIE,TOULOUSE,57020,103149,160169,
Musée Agathois,2016,OCCITANIE,AGDE,1702,1643,3345,
Musée Fabre,2016,OCCITANIE,MONTPELLIER,210596,88625,299221,
Musée du Vieux Montpellier,2016,OCCITANIE,MONTPELLIER,521,4571,5092,
Musée de Préhistoire Régionale et du Mégalithisme,2016,OCCITANIE,SAINT-PONS-DE-THOMIERES,2333,0,2333,
Musée Paul Valéry,2016,OCCITANIE,SETE,39884,10520,50404,
Musée de Cerdagne,2016,OCCITANIE,SAINTE-LEOCADIE,2640,920,3560,
Musée Charles Portal - Histoire et Patrimoine,2016,OCCITANIE,CORDES-SUR-CIEL,688,425,1113,
Musée du Protestantisme de la Réforme à la Laïcité,2016,OCCITANIE,FERRIERES,2011,1287,3298,
Muséum d'histoire naturelle Philadelphe Thomas,2016,OCCITANIE,GAILLAC,968,3756,4724,
Musée Départemental du Textile,2016,OCCITANIE,LA-BASTIDE-ROUAIROUX,3152,3826,6978,
Musée Raymond Lafage,2016,OCCITANIE,LISLE-SUR-TARN,1320,5396,6716,
Musée Ingres,2016,OCCITANIE,MONTAUBAN,18887,24480,43367,
Musée du Chaume/Kerhinet - PNR Brière,2016,PAYS DE LA LOIRE,SAINT-LYPHARD,0,85829,85829,
Musée du Textile,2016,PAYS DE LA LOIRE,CHOLET,5180,6356,11536,
Musée Communal Robert Tatin,2016,PAYS DE LA LOIRE,COSSE-LE-VIVIEN,20709,4916,25625,
Musée des Sciences - CCSTI,2016,PAYS DE LA LOIRE,LAVAL,5380,27371,32751,
Musée de la Reine Bérengère,2016,PAYS DE LA LOIRE,LE MANS,1551,10322,11873,
Musée de l'Abbaye de Sainte-Croix,2016,PAYS DE LA LOIRE,LES SABLES D'OLONNE,3924,15434,19358,
Musée du Nord de la Vendée,2016,PAYS DE LA LOIRE,MONTAIGU,0,100,100,
Musée La Bourrine du Bois-Juquaud,2016,PAYS DE LA LOIRE,SAINT-HILAIRE-DE-RIEZ,14366,2327,16693,
Musée de la vallée,2016,PROVENCE-ALPES-CÔTE D'AZUR,BARCELONNETTE,8240,1344,9584,
Musée Municipal,2016,PROVENCE-ALPES-CÔTE D'AZUR,FORCALQUIER,0,1399,1399,
Musée de la Faïence,2016,PROVENCE-ALPES-CÔTE D'AZUR,MOUSTIERS-SAINTE-MARIE,7128,1769,8897,
Musée archéologique,2016,PROVENCE-ALPES-CÔTE D'AZUR,VACHERES,672,120,792,
Musée d'Histoire et d'Archéologie,2016,PROVENCE-ALPES-CÔTE D'AZUR,ANTIBES,4996,5571,10567,
Musée Fernand Léger,2016,PROVENCE-ALPES-CÔTE D'AZUR,BIOT,13238,15244,28482,
Musée de la Mer,2016,PROVENCE-ALPES-CÔTE D'AZUR,CANNES,41654,35794,77448,
Musée d'Art et d'Histoire,2016,PROVENCE-ALPES-CÔTE D'AZUR,NICE,18652,31758,50410,
Musée d'Art Naïf Anatole Jakovsky,2016,PROVENCE-ALPES-CÔTE D'AZUR,NICE,4284,4317,8601,
Ecomusée du Pays de la Roudoule,2016,PROVENCE-ALPES-CÔTE D'AZUR,PUGET-ROSTANG,642,9076,9718,
Musée- Atelier de Paul Cézanne,2016,PROVENCE-ALPES-CÔTE D'AZUR,AIX-EN-PROVENCE,54925,7754,62679,
Muséum d'Histoire Naturelle,2016,PROVENCE-ALPES-CÔTE D'AZUR,AIX-EN-PROVENCE,3779,15554,19333,
Musée d'Histoire et d'Archéologie des Baux-de-Provence,2016,PROVENCE-ALPES-CÔTE D'AZUR,LES BAUX DE PROVENCE,286086,0,286086,
Musée des Docks Romains,2016,PROVENCE-ALPES-CÔTE D'AZUR,MARSEILLE,0,18413,18413,
Musée d'Histoire de Marseille,2016,PROVENCE-ALPES-CÔTE D'AZUR,MARSEILLE,22100,65596,87696,
Musée Départemental des Hautes-Alpes,2016,PROVENCE-ALPES-CÔTE D'AZUR,GAP,0,17986,17986,
Musée Archéologique Gallo-Romaine du Var,2016,PROVENCE-ALPES-CÔTE D'AZUR,FREJUS,3771,3937,7708,
Musée Jean Aicard,2016,PROVENCE-ALPES-CÔTE D'AZUR,LE POUVEREL LA GARDE,0,924,924,
Musée Archéologique,2016,PROVENCE-ALPES-CÔTE D'AZUR,SAINT-RAPHAËL,595,18559,19154,
Musée d'Art et d'Archéologie,2016,PROVENCE-ALPES-CÔTE D'AZUR,TOULON,0,31411,31411,
Musée National de la Marine de Toulon,2016,PROVENCE-ALPES-CÔTE D'AZUR,TOULON,23389,34748,58137,
Musée Comtadin-Duplessis,2016,PROVENCE-ALPES-CÔTE D'AZUR,CARPENTRAS,639,1116,1755,
Synagogue Musée Juif Comtadin,2016,PROVENCE-ALPES-CÔTE D'AZUR,CAVAILLON,3163,1597,4760,
Musée Municipal,2016,PROVENCE-ALPES-CÔTE D'AZUR,SAULT,0,757,757,
Musée de l'Arche,2016,ST PIERRE ET MIQUELON,SAINT-PIERRE ET MIQUELON,2609,1629,4238,
Musée du Brou,2017,AUVERGNE-RHONE-ALPES,BOURG-EN-BRESSE,73396,23736,97132,
Musée du Bugey-Valmorey,2017,AUVERGNE-RHONE-ALPES,LOCHIEU,2356,2172,4528,
Musée Départemental du Revermont,2017,AUVERGNE-RHONE-ALPES,VAL-REVERMONT,2661,8032,10693,
Musée du Rhône,2017,AUVERGNE-RHONE-ALPES,TOURNON-SUR-RHÔNE,13248,16404,29652,
Musée des Sciences,2017,AUVERGNE-RHONE-ALPES,AURILLAC,3326,6441,9767,
Château de Grignan,2017,AUVERGNE-RHONE-ALPES,GRIGNAN,117440,30093,147533,
Musée d'Archéologie Tricastine,2017,AUVERGNE-RHONE-ALPES,SAINT-PAUL-TROIS-CHATEAUX,2150,6239,8389,
Musée Léon Marès,2017,AUVERGNE-RHONE-ALPES,LOVAGNY,22972,1053,24025,
Musée Archéologique Grenoble Saint-Laurent,2017,AUVERGNE-RHONE-ALPES,GRENOBLE,0,46520,46520,
Conservatoire - Musée des Industries Hydroélectriques,2017,AUVERGNE-RHONE-ALPES,VAUJANY,0,8397,8397,
Musée Départemental de la Révolution Française,2017,AUVERGNE-RHONE-ALPES,VIZILLE,4671,65331,70002,
Musée de la Soierie,2017,AUVERGNE-RHONE-ALPES,CHARLIEU,3326,1435,4761,
Musée Hospitalier,2017,AUVERGNE-RHONE-ALPES,CHARLIEU,2630,837,3467,
Musée d'Allard,2017,AUVERGNE-RHONE-ALPES,MONTBRISON,1720,9839,11559,
Musée du Vieux Pommiers,2017,AUVERGNE-RHONE-ALPES,POMMIERS-EN-FOREZ,0,70,70,
Musée de la Mine / Site Couriot,2017,AUVERGNE-RHONE-ALPES,SAINT-ETIENNE,33155,42865,76020,
Musée des Civilisations : Daniel Pouget,2017,AUVERGNE-RHONE-ALPES,SAINT-JUST-SAINT-RAMBERT,4218,1107,5325,
Musée de la Dentelle,2017,AUVERGNE-RHONE-ALPES,ARLANC,1213,133,1346,
Musée Paléontologique,2017,AUVERGNE-RHONE-ALPES,MENAT,154,127,281,
Musée Régional d'Auvergne,2017,AUVERGNE-RHONE-ALPES,RIOM,0,3094,3094,
Musée Historique des Tissus,2017,AUVERGNE-RHONE-ALPES,LYON,49874,3947,53821,
Musée de la Civilisation Gallo-Romaine,2017,AUVERGNE-RHONE-ALPES,LYON,37483,72301,109784,
Musée Archéologique,2017,AUVERGNE-RHONE-ALPES,AIX-LES-BAINS,0,140,140,
Musée Noisot,2017,BOURGOGNE-FRANCHE-COMTE,FIXIN,298,91,389,
Musée des Beaux-Arts,2017,BOURGOGNE-FRANCHE-COMTE,MONTBARD,0,150,150,
Musée Buffon,2017,BOURGOGNE-FRANCHE-COMTE,MONTBARD,3704,5146,8850,
Musée de Plein Air des Maisons Comtoises,2017,BOURGOGNE-FRANCHE-COMTE,NANCRAY,29524,11998,41522,
Musée de la Vigne et du Vin,2017,BOURGOGNE-FRANCHE-COMTE,ARBOIS,3506,2012,5518,
Musée des Beaux-Arts,2017,BOURGOGNE-FRANCHE-COMTE,LONS-LE-SAUNIER,1110,7230,8340,
Viséum-Musée de la Lunette,2017,BOURGOGNE-FRANCHE-COMTE,MOREZ HAUTS DE BIENNE,8951,3309,12260,
Musée de l'Abbaye/Donations Guy Bardone - René Genis,2017,BOURGOGNE-FRANCHE-COMTE,SAINT-CLAUDE,7857,3262,11119,
Musée des Salines,2017,BOURGOGNE-FRANCHE-COMTE,SALINS-LES-BAINS,58631,5216,63847,
Musée du Septennat,2017,BOURGOGNE-FRANCHE-COMTE,CHATEAU-CHINON,7109,1758,8867,
Musée de la Loire,2017,BOURGOGNE-FRANCHE-COMTE,COSNE-SUR-LOIRE,3934,1496,5430,
Musée du Terroir,2017,BOURGOGNE-FRANCHE-COMTE,ROMENAY,2114,871,2985,
Musée de Bibracte,2017,BOURGOGNE-FRANCHE-COMTE,SAINT-LEGER-SOUS BEUVRAY,34075,10734,44809,
Musée d'Art et d'Histoire,2017,BOURGOGNE-FRANCHE-COMTE,AUXERRE,0,29251,29251,
Musée Muncipal,2017,BOURGOGNE-FRANCHE-COMTE,SENS,6474,19042,25516,
Musée Villeneuvien,2017,BOURGOGNE-FRANCHE-COMTE,VILLENEUVE-SUR-YONNE,0,1010,1010,
Musée des Beaux-Arts de Brest,2017,BRETAGNE,BREST,4149,14149,18298,
Musée National de la Marine,2017,BRETAGNE,BREST,36589,37887,74476,
Le Port-Musée,2017,BRETAGNE,DOUARNENEZ,39792,5933,45725,
Musée des Phares et Balises,2017,BRETAGNE,OUESSANT,13850,1679,15529,
Musée de Bretagne,2017,BRETAGNE,RENNES,22416,53564,75980,
Ecomusée de Saint-Dégan,2017,BRETAGNE,BREC'H,8028,2035,10063,
Ecomusée Industriel des Forges,2017,BRETAGNE,INZINZAC-LOCHRIST,1420,1794,3214,
Musée de la Compagnie des Indes,2017,BRETAGNE,PORT-LOUIS,37107,32694,69801,
Musée de la Résistance Bretonne,2017,BRETAGNE,SAINT-MARCEL - MALESTROIT,12631,2180,14811,
Musée des Arts Décoratifs,2017,CENTRE-VAL DE LOIRE,BOURGES,4603,2650,7253,
Musée - Hôtel Morin,2017,CENTRE-VAL DE LOIRE,AMBOISE,0,11252,11252,
Musée François Rabelais,2017,CENTRE-VAL DE LOIRE,SEUILLY,10058,2824,12882,
Muséum d'Histoire Naturelle,2017,CENTRE-VAL DE LOIRE,TOURS,14650,27445,42095,
Château Musées de Blois,2017,CENTRE-VAL DE LOIRE,BLOIS,226326,36844,263170,
Musée de la Corbillière,2017,CENTRE-VAL DE LOIRE,MER,0,4369,4369,
Musée Archéologique,2017,CENTRE-VAL DE LOIRE,THESEE,577,80,657,
Musée de Vendôme,2017,CENTRE-VAL DE LOIRE,VENDOME,0,14774,14774,
Musée de la Marine de Loire,2017,CENTRE-VAL DE LOIRE,CHATEAUNEUF-SUR-LOIRE,8932,6049,14981,
"Hôtel Cabu, Musée d'Histoire et d'Archéologie",2017,CENTRE-VAL DE LOIRE,ORLEANS,1072,11500,12572,
Musée Arthur Rimbaud,2017,GRAND EST,CHARLEVILLE-MEZIERES,8302,12388,20690,
Musée du Château-Fort,2017,GRAND EST,SEDAN Cedex,56082,2732,58814,
Maison de l'Outil  et de la Pensée Ouvrière,2017,GRAND EST,TROYES,14433,4500,18933,
Musée des Beaux-Arts (Musée Pic Saint-Loup),2017,GRAND EST,TROYES,4468,20181,24649,
Musée d'Art Moderne,2017,GRAND EST,TROYES,19568,27324,46892,
Musée Alsacien,2017,GRAND EST,HAGUENAU,723,896,1619,
Cabinet des Estampes et des Dessins,2017,GRAND EST,STRASBOURG,0,10500,10500,
Musée d'Art et d'Histoire,2017,GRAND EST,LANGRES,2969,5403,8372,
Musée de la Coutellerie,2017,GRAND EST,NOGENT,4573,1734,6307,
Musée Bartholdi,2017,GRAND EST,COLMAR,15235,7880,23115,
Musée Historique,2017,GRAND EST,MULHOUSE,0,34144,34144,
Cité du Train,2017,GRAND EST,MULHOUSE,67957,20190,88147,
Musée Garinet,2017,GRAND EST,CHALONS-EN-CHAMPAGNE,166,759,925,
Musée du Château de Montaigu,2017,GRAND EST,LANEUVEVILLE-DEVANT-NANCY,454,400,854,
Musée des Beaux-Arts de Nancy,2017,GRAND EST,NANCY,55883,66894,122777,
Musée Jules Bastien-Lepage - Musée de la Fortification,2017,GRAND EST,MONTMEDY,11184,2095,13279,
Musée d'Argonne,2017,GRAND EST,VARENNES-EN-ARGONNE,1100,0,1100,
Musée Jeanne d'Arc,2017,GRAND EST,VAUCOULEURS,867,378,1245,
Musée du Pays de Sarrebourg,2017,GRAND EST,SARREBOURG,8878,7803,16681,
La Tour aux Puces - Musée du Pays Thionvillois,2017,GRAND EST,THIONVILLE,1006,8706,9712,
Musée de la Lutherie et de l'Archèterie Française,2017,GRAND EST,MIRECOURT,5747,4469,10216,
Ecomusée de Marie-Galante,2017,GUADELOUPE,GRAND-BOURG de MARIE-GALANTE,0,38693,38693,
Musée Départemental Victor Schoelcher,2017,GUADELOUPE,POINTE-A-PITRE,0,9629,9629,
Musée Municipal de Soissons,2017,HAUTS-DE-FRANCE,SOISSONS,4000,7497,11497,
Musée de la Résistance et de la Déportation,2017,HAUTS-DE-FRANCE,TERGNIER,2085,1700,3785,
Forum Antique de Bavay,2017,HAUTS-DE-FRANCE,BAVAY,22377,5074,27451,
Musée Portuaire,2017,HAUTS-DE-FRANCE,DUNKERQUE,48462,30386,78848,
Musée Municipal d'Escaudain,2017,HAUTS-DE-FRANCE,ESCAUDAIN,0,600,600,
Musée des Beaux-Arts,2017,HAUTS-DE-FRANCE,VALENCIENNES,23323,11894,35217,
Cité Internationale de la Dentelle et de la Mode de Calais,2017,HAUTS-DE-FRANCE,CALAIS,45513,20289,65802,
Musée Français de la Photographie,2017,ILE-DE-FRANCE,BIEVRES,3462,2432,5894,
Musée Municipal Robert Dubois-Corneau,2017,ILE-DE-FRANCE,BRUNOY,39,3749,3788,
"Albert-Kahn, Musée et Jardin Départementaux",2017,ILE-DE-FRANCE,BOULOGNE-BILLANCOURT,3127,643,3770,
Musée - Atelier Rodin (Annexe du musée de Paris),2017,ILE-DE-FRANCE,MEUDON,5791,13457,19248,
Cité de la céramique - Sèvres & Limoges,2017,ILE-DE-FRANCE,SEVRES,29627,21928,51555,
Galerie d'Anatomie Comparée et de Paléontologie (Muséum d'Histoire Naturelle),2017,ILE-DE-FRANCE,PARIS,128593,188138,316731,
Etablissement public du musée national J.J. Henner et du musée national G. Moreau/ Musée National Jean-Jacques Henner,2017,ILE-DE-FRANCE,PARIS,9730,6625,16355,
Etablissement public du musée d'Orsay et de l'Orangerie - Musée de l'Orangerie,2017,ILE-DE-FRANCE,PARIS,596958,341323,938281,
Etablissement public du musée d'Orsay et de l'Orangerie - Musée d'Orsay,2017,ILE-DE-FRANCE,PARIS,1703229,1474613,3177842,
Musée d'Art Moderne de la ville de Paris,2017,ILE-DE-FRANCE,PARIS,341439,164807,506246,
Musée de la Gendarmerie Nationale,2017,ILE-DE-FRANCE,MELUN,15522,10731,26253,
Musée Municipal,2017,ILE-DE-FRANCE,MORET-SUR-LOING,0,2463,2463,
Musée Départemental de Préhistoire d'Île de France,2017,ILE-DE-FRANCE,NEMOURS,4972,23131,28103,
Musée Adrien Mentienne,2017,ILE-DE-FRANCE,BRY-SUR-MARNE,0,1265,1265,
Musée de la Toile de Jouy,2017,ILE-DE-FRANCE,JOUY-EN-JOSAS,6200,3554,9754,
Musée Promenade Marly/Louveciennes,2017,ILE-DE-FRANCE,LOUVECIENNES,27,0,27,
Musée-Maison Maurice Ravel,2017,ILE-DE-FRANCE,MONTFORT-L'AMAURY,1469,97,1566,
Musée Rambolitrain,2017,ILE-DE-FRANCE,RAMBOUILLET,2852,16377,19229,
Musée Départemental Maurice Denis,2017,ILE-DE-FRANCE,SAINT-GERMAIN-EN-LAYE,13047,5301,18348,
Etablissement Public du Musée et du Domaine National de Versailles,2017,ILE-DE-FRANCE,VERSAILLES,5919966,1794423,7714389,
Musée de La Canne,2017,MARTINIQUE,LES TROIS ILETS,2096,9939,12035,
Musée du Débarquement,2017,NORMANDIE,ARROMANCHES,277857,12953,290810,
Musée d'Art et d'Histoire de Lisieux,2017,NORMANDIE,LISIEUX,188,4666,4854,
Musée du Château,2017,NORMANDIE,PONTECOULANT,3092,1798,4890,
Château de Saint-Germain de Livet,2017,NORMANDIE,SAINT-GERMAIN DE LIVET,8835,7193,16028,
Musée et Sites archéologiques de Vieux-la-Romaine,2017,NORMANDIE,VIEUX,9167,11009,20176,
Musée Municipal,2017,NORMANDIE,VIRE NORMANDIE,1251,4466,5717,
Musée Municipal,2017,NORMANDIE,BERNAY,1412,6758,8170,
Musée Municipal Nicolas Poussin,2017,NORMANDIE,LES ANDELYS,1911,1149,3060,
Musée Alphonse-Georges Poulain,2017,NORMANDIE,VERNON,11359,6751,18110,
Musée Municipal,2017,NORMANDIE,EQUEURDREVILLLE-HAINNEVILLE,0,2500,2500,
Musée des Beaux-Arts et de la Dentelle,2017,NORMANDIE,ALENCON,7965,6117,14082,
Musée du Château de Flers,2017,NORMANDIE,FLERS,1439,6012,7451,
Museoseine,2017,NORMANDIE,CAUDEBEC-EN-CAUX,17700,0,17700,
Musée d'Elbeuf,2017,NORMANDIE,ELBEUF,7272,18091,25363,
Musée Mathon-Durand,2017,NORMANDIE,NEUFCHATEL-EN-BRAY,475,521,996,
Musée Flaubert et d'Histoire de la Médecine,2017,NORMANDIE,ROUEN,2702,4820,7522,
Musée de la Céramique,2017,NORMANDIE,ROUEN,19776,5518,25294,
Musée de la Mytiliculture,2017,NOUVELLE-AQUITAINE,ESNANDES,3304,863,4167,
Musée National de la Marine,2017,NOUVELLE-AQUITAINE,ROCHEFORT,16134,11672,27806,
Musée d'Art et d'Archéologie,2017,NOUVELLE-AQUITAINE,GUERET,1660,6052,7712,
Musée des Tumulus de Bougon,2017,NOUVELLE-AQUITAINE,BOUGON,13553,2852,16405,
Musée du Tabac,2017,NOUVELLE-AQUITAINE,BERGERAC,4092,1298,5390,
Musée des Arts et Traditions Populaires du Périgord,2017,NOUVELLE-AQUITAINE,MUSSIDAN,823,1260,2083,
Musée Gallo-Romain de Vesunna,2017,NOUVELLE-AQUITAINE,PERIGUEUX,22576,14487,37063,
CAPC Musée d'Art Contemporain de Bordeaux,2017,NOUVELLE-AQUITAINE,BORDEAUX,42761,54351,97112,
Musée Départemental d'Art Contemporain,2017,NOUVELLE-AQUITAINE,ROCHECHOUART,8600,6645,15245,
Musée des Beaux-Arts,2017,NOUVELLE-AQUITAINE,AGEN,8046,11480,19526,
Musée Bonnat-Helleu - Musée des Beaux-Arts de Bayonne,2017,NOUVELLE-AQUITAINE,BAYONNE,0,112,112,
Musée des Traditions Populaires et d'Archéologie,2017,NOUVELLE-AQUITAINE,CHAUVIGNY,6788,1535,8323,
Musée Charbonneau-Lassay,2017,NOUVELLE-AQUITAINE,LOUDUN,0,1626,1626,
Musée de Préhistoire Raymond Touchard,2017,NOUVELLE-AQUITAINE,LUSSAC-LES-CHATEAUX,3418,3562,6980,
Musée de l'hypogée des Dunes,2017,NOUVELLE-AQUITAINE,POITIERS,0,321,321,
Musée Départemental de l'Ariège,2017,OCCITANIE,FOIX,88812,8286,97098,
Musée d'Archéologie,2017,OCCITANIE,MONTSEGUR,15604,0,15604,
Musée Petiet,2017,OCCITANIE,LIMOUX,474,2046,2520,
Palais-Musée des Archevêques de Narbonne,2017,OCCITANIE,NARBONNE,21876,125417,147293,
Musée Municipal Urbain Cabrol,2017,OCCITANIE,VILLEFRANCHE-DE-ROUERGUE,0,8007,8007,
Musée des Beaux-Arts,2017,OCCITANIE,NIMES,0,17085,17085,
Musée des Jacobins,2017,OCCITANIE,AUCH,8196,5348,13544,
Musée de l'Armagnac,2017,OCCITANIE,CONDOM,1339,320,1659,
Musée d'Archéologie,2017,OCCITANIE,LECTOURE,2033,1452,3485,
"Les Abattoirs, Musée d'Art Moderne et Contemporain",2017,OCCITANIE,TOULOUSE,50048,109031,159079,
Musée Paul Dupuy,2017,OCCITANIE,TOULOUSE,9439,17343,26782,
Site Archéologique Lattara - Musée Henri Prades de Montpellier Agglomération,2017,OCCITANIE,LATTES,11724,11299,23023,
Musée du Vieux Montpellier,2017,OCCITANIE,MONTPELLIER,499,4597,5096,
Musée de Vulliod Saint-Germain,2017,OCCITANIE,PEZENAS,4550,620,5170,
Musée de l'Automate,2017,OCCITANIE,SOUILLAC,12929,960,13889,
Ecomusée du Mont Lozère,2017,OCCITANIE,LE PONT DE MONTVERT,1198,1430,2628,
Musée Hyacinthe Rigaud,2017,OCCITANIE,PERPIGNAN,49009,19876,68885,
Musée du Protestantisme de la Réforme à la Laïcité,2017,OCCITANIE,FERRIERES,2396,1620,4016,
Musée Départemental du Textile,2017,OCCITANIE,LA-BASTIDE-ROUAIROUX,2765,3954,6719,
Musée du Pays Vaurais,2017,OCCITANIE,LAVAUR,2154,3900,6054,
Musée Théodore Calbet,2017,OCCITANIE,GRISOLLES,0,3043,3043,
Musée des arts et traditions populaires,2017,OCCITANIE,MOISSAC,216,5386,5602,
Musée de Préhistoire,2017,OCCITANIE,SAINT-ANTONIN-NOBLE-VAL,42,200,242,
Musée des Marais Salant,2017,PAYS DE LA LOIRE,BATZ-SUR-MER,12691,9806,22497,
Musée  Départemental Dobrée,2017,PAYS DE LA LOIRE,NANTES,251,33289,33540,
Musée des Beaux-Arts,2017,PAYS DE LA LOIRE,ANGERS,17743,54694,72437,
Galerie David d'Angers (+ musée-château de Villevêque),2017,PAYS DE LA LOIRE,ANGERS,10635,17597,28232,
Musée Joseph Denais,2017,PAYS DE LA LOIRE,BEAUFORT-EN-VALLEE,5720,2546,8266,
Musée Archéologique Départemental de Jublains,2017,PAYS DE LA LOIRE,JUBLAINS,18918,10564,29482,
Musée du Château de Mayenne,2017,PAYS DE LA LOIRE,MAYENNE,10980,10651,21631,
Musée de l'Image Populaire de Pfaffenhoffen,2001,ALSACE,PFAFFENHOFFEN,2703,702,3405,
Musée du Château des Rohan,2001,ALSACE,SAVERNE,5269,5043,10312,
Musée d'Art Moderne et Contemporain de Strasbourg,2001,ALSACE,STRASBOURG,71870,96775,168645,
Musée des Arts Décoratifs,2001,ALSACE,STRASBOURG,22361,24520,46881,
Musée des Beaux-Arts,2001,ALSACE,STRASBOURG,20859,24760,45619,
Cabinet des Estampes et des Dessins,2001,ALSACE,STRASBOURG,0,494,494,
Musée Westercamp,2001,ALSACE,WISSEMBOURG,3598,526,4124,
Musée des Beaux-Arts,2001,ALSACE,MULHOUSE,0,7356,7356,
Cité du Train,2001,ALSACE,MULHOUSE,96882,0,96882,
Musée Minéralogique de la Société Industrielle de Mulhouse,2001,ALSACE,MULHOUSE,0,150,150,
Musée de l'Impression sur Etoffes,2001,ALSACE,MULHOUSE,17029,10709,27738,
Musée des Amis de Thann,2001,ALSACE,THANN,939,136,1075,
Musée du Tabac,2001,AQUITAINE,BERGERAC,5670,2953,8623,
Musée d'Aquitaine,2001,AQUITAINE,BORDEAUX,12640,44105,56745,
Musée Historique de l'Hydravion,2001,AQUITAINE,BISCARROSSE,14440,826,15266,
Musée de la Chalosse,2001,AQUITAINE,MONTFORT-EN-CHALOSSE,7723,1579,9302,
Musée du Patrimoine Religieux et des Croyances Populaires,2001,AQUITAINE,MOUSTEY,2605,0,2605,
Musée Municipal (Moulin de Gajac),2001,AQUITAINE,VILLENEUVE-SUR-LOT,1250,1235,2485,
Musée Edmond Rostand,2001,AQUITAINE,CAMBO-LES-BAINS,63794,0,63794,
Musée de la Haute Auvergne,2001,AUVERGNE,SAINT-FLOUR,9159,2166,11325,
Musée d'Archéologie Bargoin,2001,AUVERGNE,CLERMONT-FERRAND,2259,8192,10451,
Muséum d'Histoire Naturelle Henri-Lecoq,2001,AUVERGNE,CLERMONT-FERRAND,2581,21839,24420,
Musée E.J Marey,2001,BOURGOGNE,BEAUNE,2770,1336,4106,
Musée d'Art Sacré,2001,BOURGOGNE,DIJON,1043,6379,7422,
Musée des Arts et Traditions des Hautes-Côtes,2001,BOURGOGNE,GEVREY-CHAMBERTIN - Reulle Vergy,7200,0,7200,
Musée du Septennat,2001,BOURGOGNE,CHATEAU-CHINON,24390,2522,26912,
Musée du Prieuré de Charolles,2001,BOURGOGNE,CHAROLLES,4237,0,4237,
"L'Atelier d'un Journal"" de Louhans - Musée Municipal",2001,BOURGOGNE,LOUHANS,2660,195,2855,
Musée des Ursulines,2001,BOURGOGNE,MACON,2345,7252,9597,
Musée de la Tour du Moulin,2001,BOURGOGNE,MARCIGNY,1641,432,2073,
Musée Départemental du Compagnonnage,2001,BOURGOGNE,ROMANECHE-THORINS,2394,546,2940,
Musée Départemental de Préhistoire de Solutré,2001,BOURGOGNE,SOLUTRE-POUILLY,19877,5594,25471,
Musée Colette,2001,BOURGOGNE,SAINT-SAUVEUR-EN-PUISAYE,11460,2773,14233,
Musée Muncipal,2001,BOURGOGNE,SENS,17969,0,17969,
Ecomusée Industriel des Forges,2001,BRETAGNE,INZINZAC-LOCHRIST,6672,4323,10995,
Musée de la Résistance Bretonne,2001,BRETAGNE,SAINT-MARCEL - MALESTROIT,35924,6671,42595,
Musée du Château de Suscinio,2001,BRETAGNE,SARZEAU,75159,0,75159,
Musée du Berry,2001,CENTRE,BOURGES,0,20022,20022,
Musée Emile Chénon,2001,CENTRE,CHATEAUMEILLANT,1379,0,1379,
Musée Saint-Vic,2001,CENTRE,SAINT-AMAND-MONTROND,7612,0,7612,
Musée Municipal,2001,CENTRE,VIERZON,0,325,325,
Conservatoire du Machinisme et des Pratiques Agricoles,2001,CENTRE,CHARTRES-MAINVILLIERS,50290,0,50290,
Musée des Beaux-Arts et d'Histoire Naturelle,2001,CENTRE,CHATEAUDUN,6859,7967,14826,
Musée Ornithologique (Ecomusée de la Brenne),2001,CENTRE,LE BLANC,4790,2937,7727,
Musée de Préhistoire du Grand Pressigny,2001,CENTRE,LE GRAND PRESSIGNY,10794,3980,14774,
Musée de l'Hôtel de Ville,2001,CENTRE,RICHELIEU,10501,0,10501,
Musée Balzac,2001,CENTRE,SACHE,21986,2601,24587,
Muséum d'Histoire Naturelle,2001,CENTRE,TOURS,5464,16200,21664,
Musée des Beaux-Arts,2001,CENTRE,TOURS,15011,24804,39815,
Maison de la Magie,2001,CENTRE,BLOIS,49527,0,49527,
Musée de la Corbillière,2001,CENTRE,MER,975,0,975,
Château-Musée de Gien,2001,CENTRE,GIEN,22584,4039,26623,
Musée du Gatinais,2001,CENTRE,MONTARGIS,314,198,512,
Musée Historique et Archéologique,2001,CENTRE,ORLEANS,3472,0,3472,
Musée du Feutre,2001,CHAMPAGNE-ARDENNES,MOUZON,4677,330,5007,
Musée du Château-Fort,2001,CHAMPAGNE-ARDENNES,SEDAN,55289,0,55289,
Musée d'Art et d'Histoire,2001,CHAMPAGNE-ARDENNES,LANGRES,3497,6564,10061,
Musée Garinet,2001,CHAMPAGNE-ARDENNES,CHALONS-EN-CHAMPAGNE,808,0,808,
Musée Hôtel le Vergeur,2001,CHAMPAGNE-ARDENNES,REIMS,8151,2466,10617,
Musée de la Corse,2001,CORSE,CORTE,55884,6610,62494,
Muséum de Besançon,2001,FRANCHE-COMTE,BESANCON,241840,0,241840,
Musée des Beaux-Arts et d'Archéologie,2001,FRANCHE-COMTE,BESANCON,20552,14491,35043,
Musée-Maison Natale Gustave Courbet,2001,FRANCHE-COMTE,ORNANS,20698,237,20935,
Ecomusée du Pays de la Cerise,2001,FRANCHE-COMTE,FOUGEROLLES,6069,200,6269,
Musée d'Archéologie,2001,FRANCHE-COMTE,LONS-LE-SAUNIER,4486,4882,9368,
Musée des Salines,2001,FRANCHE-COMTE,SALINS-LES-BAINS,50037,0,50037,
Donation Maurice Jardot,2001,FRANCHE-COMTE,BELFORT,7726,0,7726,
Musée Précolombien Edgar Clerc,2001,GUADELOUPE,LE MOULE,6181,2324,8505,
Musée Français de la Photographie,2001,ILE-DE-FRANCE,BIEVRES,3800,0,3800,
Musée Intercommunal d'Etampes,2001,ILE-DE-FRANCE,ETAMPES,910,4070,4980,
Musée Municipal de Saint-Cloud,2001,ILE-DE-FRANCE,SAINT-CLOUD,0,3496,3496,
Musée de l'Homme (Muséum National d'Histoire Naturelle),2001,ILE-DE-FRANCE,PARIS,84964,26427,111391,
Musée Zadkine,2001,ILE-DE-FRANCE,PARIS,9006,10780,19786,
Mémorial du Maréchal Leclerc et de la Libération de Paris - Musée Jean Moulin,2001,ILE-DE-FRANCE,PARIS,4785,6127,10912,
Musée Hébert,2001,ILE-DE-FRANCE,PARIS,1815,1922,3737,
Musée National Auguste Rodin,2001,ILE-DE-FRANCE,PARIS,327250,229040,556290,
Musée du Louvre,2001,ILE-DE-FRANCE,PARIS,3325837,1838088,5163925,
Musée d'Art et d'Histoire du Judaïsme,2001,ILE-DE-FRANCE,PARIS,66696,23187,89883,
Musée Départemental de l'Ecole de Barbizon,2001,ILE-DE-FRANCE,BARBIZON,22834,0,22834,
Musée Municipal des Capucins,2001,ILE-DE-FRANCE,COULOMMIERS,1718,1111,2829,
Musée Gatien Bonnet,2001,ILE-DE-FRANCE,LAGNY-SUR-MARNE,0,1700,1700,
Musée de Provins et du Provinois,2001,ILE-DE-FRANCE,PROVINS,13932,1532,15464,
Ecomusée,2001,ILE-DE-FRANCE,SAVIGNY-LE-TEMPLE,0,4545,4545,
Musée Municipal,2001,ILE-DE-FRANCE,LIVRY-GARGAN,0,9931,9931,
Musée Tavet Delacour,2001,ILE-DE-FRANCE,PONTOISE,2780,1382,4162,
Musée Camille Pissarro,2001,ILE-DE-FRANCE,PONTOISE,0,3960,3960,
Musée de la Batellerie,2001,ILE-DE-FRANCE,CONFLANS-SAINTE-HONORINE,14468,1740,16208,
Musée de la Toile de Jouy,2001,ILE-DE-FRANCE,JOUY-EN-JOSAS,13707,0,13707,
Musée National de Port Royal des Champs,2001,ILE-DE-FRANCE,MAGNY-LES-HAMEAUX,4589,4814,9403,
Musée d'Art et d'Histoire,2001,ILE-DE-FRANCE,POISSY,0,640,640,
Musée d'Archéologie Nationale (des origines à l'an mille) - Château de st-Germain-en-Laye,2001,ILE-DE-FRANCE,SAINT-GERMAIN-EN-LAYE,24240,41611,65851,
Musée Archéologique,2001,LANGUEDOC-ROUSSILLON,NARBONNE,18263,0,18263,
Musée Léon Alègre,2001,LANGUEDOC-ROUSSILLON,BAGNOLS-SUR-CEZE,1191,0,1191,
Musée du Vieux Nîmes,2001,LANGUEDOC-ROUSSILLON,NIMES,3030,6117,9147,
Musée Pierre de Luxembourg,2001,LANGUEDOC-ROUSSILLON,VILLENEUVE-LES-AVIGNON,5561,2159,7720,
Musée des Beaux-Arts de Béziers,2001,LANGUEDOC-ROUSSILLON,BEZIERS,13621,0,13621,
Musée de l'Etang de Thau,2001,LANGUEDOC-ROUSSILLON,BOUZIGUES,19584,222,19806,
Musée Municipal,2001,LANGUEDOC-ROUSSILLON,FRONTIGNAN-LA-PEYRADE,0,11236,11236,
Musée de l'Ephèbe,2001,LANGUEDOC-ROUSSILLON,LE CAP D'AGDE,12523,1681,14204,
Musée Fleury,2001,LANGUEDOC-ROUSSILLON,LODEVE,58847,9947,68794,
Musée du Vieux Montpellier,2001,LANGUEDOC-ROUSSILLON,MONTPELLIER,0,5248,5248,
Musée Languedocien,2001,LANGUEDOC-ROUSSILLON,MONTPELLIER,2566,935,3501,
Musée de Vulliod Saint-Germain,2001,LANGUEDOC-ROUSSILLON,PEZENAS,3570,2598,6168,
Muséum d'Histoire Naturelle,2001,LANGUEDOC-ROUSSILLON,PERPIGNAN,0,8913,8913,
Musée Hyacinthe Rigaud,2001,LANGUEDOC-ROUSSILLON,PERPIGNAN,7027,0,7027,
Musée Labenche d'Art et d'Histoire,2001,LIMOUSIN,BRIVE-LA-GAILLARDE,22660,0,22660,
Musée du Président Jacques Chirac,2001,LIMOUSIN,SARRAN,66776,0,66776,
Musée de l'Evêché,2001,LIMOUSIN,LIMOGES,0,62419,62419,
Musée National Adrien Dubouché,2001,LIMOUSIN,LIMOGES,13585,8423,22008,
Musée Jules Bastien-Lepage - Musée de la Fortification,2001,LORRAINE,MONTMEDY,19382,0,19382,
Musée Militaire et Erckmann-Chatrian,2001,LORRAINE,PHALSBOURG,2043,431,2474,
Musée Charles de Bruyères,2001,LORRAINE,REMIREMONT,1324,4454,5778,
Muséum d'Histoire Naturelle,2001,MARTINIQUE,FORT-DE-FRANCE TERRE-SAINVILLE,212,391,603,
Musée Joseph Vaylet,2001,MIDI-PYRENEES,ESPALION,11099,0,11099,
Musée des Beaux-Arts Denys Puech,2001,MIDI-PYRENEES,RODEZ,1819,6949,8768,
Musée des Arts et Métiers Traditionnels,2001,MIDI-PYRENEES,SALLES-LA-SOURCE,9430,0,9430,
"Les Abattoirs, Musée d'Art Moderne et Contemporain",2001,MIDI-PYRENEES,TOULOUSE,91706,83764,175470,
Musée Paul Dupuy,2001,MIDI-PYRENEES,TOULOUSE,7807,4225,12032,
Musée Saint-Raymond,2001,MIDI-PYRENEES,TOULOUSE,53425,0,53425,
Musée des Augustins,2001,MIDI-PYRENEES,TOULOUSE,75948,35700,111648,
Musée Massey,2001,MIDI-PYRENEES,TARBES,1850,1414,3264,
Musée Champollion,2001,MIDI-PYRENEES,FIGEAC,27674,0,27674,
Musée Jean Jaurès,2001,MIDI-PYRENEES,CASTRES,1869,8345,10214,
Musée Départemental du Textile,2001,MIDI-PYRENEES,LA-BASTIDE-ROUAIROUX,3171,1235,4406,
Musée Théodore Calbet,2001,MIDI-PYRENEES,GRISOLLES,0,937,937,
Musée Benoît de Puydt,2001,NORD-PAS-DE-CALAIS,BAILLEUL,2796,5258,8054,
Musée Municipal de Cambrai,2001,NORD-PAS-DE-CALAIS,CAMBRAI,5484,15291,20775,
Musée d'Archéologie et d'Histoire Locale,2001,NORD-PAS-DE-CALAIS,DENAIN,0,1431,1431,
Musée de la Chartreuse,2001,NORD-PAS-DE-CALAIS,DOUAI,36503,0,36503,
Musée Municipal d'Hazebrouck,2001,NORD-PAS-DE-CALAIS,HAZEBROUCK,736,2259,2995,
Musée d'Histoire Naturelle et de Géologie,2001,NORD-PAS-DE-CALAIS,LILLE,50985,13587,64572,
Musée des Beaux-Arts,2001,NORD-PAS-DE-CALAIS,VALENCIENNES,55840,15701,71541,
Musée Quentovic,2001,NORD-PAS-DE-CALAIS,ETAPLES-SUR-MER,1412,745,2157,
Musée Municipal,2001,NORD-PAS-DE-CALAIS,LE TOUQUET-PARIS-PLAGE,6254,6008,12262,
Mémorial de Caen,2001,BASSE-NORMANDIE,CAEN,374650,38152,412802,
Musée de la Mine,2001,BASSE-NORMANDIE,LE MOLAY-LITTRY,7522,1408,8930,
Château de Saint-Germain de Livet,2001,BASSE-NORMANDIE,SAINT-GERMAIN DE LIVET,14475,8422,22897,
Musée du Vieux Château,2001,BASSE-NORMANDIE,BRICQUEBEC-EN-COTENTIN,846,0,846,
Musée Richard Anacréon,2001,BASSE-NORMANDIE,GRANVILLE,3637,1338,4975,
Musée Christian Dior,2001,BASSE-NORMANDIE,GRANVILLE,13500,2500,16000,
Musée du Granit,2001,BASSE-NORMANDIE,SAINT-MICHEL-DE-MONTJOIE,1384,0,1384,
Musée du Verre et de la Pierre,2001,HAUTE-NORMANDIE,CONCHES-EN-OUCHE,1240,260,1500,
Musée Artisanal et Industriel d'Instruments à Vent,2001,HAUTE-NORMANDIE,LA COUTURE-BOUSSEY,2000,500,2500,
Musée Municipal Nicolas Poussin,2001,HAUTE-NORMANDIE,LES ANDELYS,1203,0,1203,
Musée de la Marine de Seine,2001,HAUTE-NORMANDIE,CAUDEBEC-EN-CAUX,6205,2138,8343,
Musée des Arts & de l'Enfance,2001,HAUTE-NORMANDIE,FECAMP,1272,3973,5245,
Abbaye de Graville - Musée du Prieuré de Graville,2001,HAUTE-NORMANDIE,LE HAVRE,2116,13392,15508,
Musée Départemental Pierre Corneille,2001,HAUTE-NORMANDIE,LE PETIT-COURONNE,970,1989,2959,
Musée du Château des Ducs de Bretagne,2001,PAYS DE LA LOIRE,NANTES,24238,0,24238,
Musée  Départemental Dobrée,2001,PAYS DE LA LOIRE,NANTES,8110,23383,31493,
Musée Jean Lurcat et de la Tapisserie Contemporaine,2001,PAYS DE LA LOIRE,ANGERS,18119,42327,60446,
Musée d'Art et d'Histoire,2001,PAYS DE LA LOIRE,BAUGE,945,1042,1987,
Musée Jules-Desbois,2001,PAYS DE LA LOIRE,PARCAY-LES-PINS,1074,852,1926,
Château-Musée,2001,PAYS DE LA LOIRE,SAUMUR,69072,17564,86636,
Musée de l'Ardoise,2001,PAYS DE LA LOIRE,TRELAZE,5317,4244,9561,
Ecomusée du Marais Breton Vendéen,2001,PAYS DE LA LOIRE,LA BARRE-DE-MONTS,18185,9500,27685,
Musée Clemenceau et de Lattre-de-Tassigny,2001,PAYS DE LA LOIRE,MOUILLERON-EN-PAREDS,1571,814,2385,
Musée d'Art et d'Archéologie,2001,PICARDIE,LAON,2218,2399,4617,
Musée de la Figurine Historique,2001,PICARDIE,COMPIEGNE,4601,1572,6173,
Musée Jean Calvin,2001,PICARDIE,NOYON,2258,1261,3519,
Musée Archéologique de la région de Breteuil,2001,PICARDIE,VENDEUIL-CAPLY,4134,0,4134,
Musée Alfred Danicourt,2001,PICARDIE,PERONNE,0,585,585,
Cité International de la Bande Dessinée et de l'Image - Musée de la Bande Dessinée,2001,POITOU-CHARENTES,ANGOULEME,16533,19306,35839,
Musée de la Mytiliculture,2001,POITOU-CHARENTES,ESNANDES,3014,0,3014,
Muséum d'Histoire Naturelle,2001,POITOU-CHARENTES,LA ROCHELLE,0,38556,38556,
Musée de l'Echevinage,2001,POITOU-CHARENTES,SAINTES,179,4389,4568,
Musée Dupuy-Mestreau,2001,POITOU-CHARENTES,SAINTES,1248,1792,3040,
Musée d'Art et d'Histoire Georges Turpin,2001,POITOU-CHARENTES,PARTHENAY,0,9580,9580,
Musée Rupert de Chièvres,2001,POITOU-CHARENTES,POITIERS,2110,417,2527,
Musée d'Histoire et d'Archéologie,2001,PROVENCE-ALPES-CÔTE D'AZUR,ANTIBES,3403,6618,10021,
Musée de la Castre,2001,PROVENCE-ALPES-CÔTE D'AZUR,CANNES,12367,6616,18983,
Muséum d'Histoire Naturelle,2001,PROVENCE-ALPES-CÔTE D'AZUR,NICE,0,25000,25000,
Musée Matisse,2001,PROVENCE-ALPES-CÔTE D'AZUR,NICE,119094,42960,162054,
Musée d'Art Moderne et d'Art Contemporain,2001,PROVENCE-ALPES-CÔTE D'AZUR,NICE,54909,70870,125779,
"Musée Magnelli, Musée de la Céramique",2001,PROVENCE-ALPES-CÔTE D'AZUR,VALLAURIS,22857,7668,30525,
Musée des Tapisseries,2001,PROVENCE-ALPES-CÔTE D'AZUR,AIX-EN-PROVENCE,8826,6505,15331,
Musée Départemental de l'Arles Antique,2001,PROVENCE-ALPES-CÔTE D'AZUR,ARLES,81149,0,81149,
Musée Folklorique du Vieux Lambesc,2001,PROVENCE-ALPES-CÔTE D'AZUR,LAMBESC,440,410,850,
Musée d'Histoire et d'Archéologie des Baux-de-Provence,2001,PROVENCE-ALPES-CÔTE D'AZUR,LES BAUX DE PROVENCE,302120,0,302120,
Fondation Louis Jou,2001,PROVENCE-ALPES-CÔTE D'AZUR,LES-BAUX-DE-PROVENCE,1992,0,1992,
Musée Grobet-Labadié,2001,PROVENCE-ALPES-CÔTE D'AZUR,MARSEILLE,2939,7794,10733,
Musée des Beaux-Arts de Marseille,2001,PROVENCE-ALPES-CÔTE D'AZUR,MARSEILLE,7178,22176,29354,
Musée de la Faïence,2001,PROVENCE-ALPES-CÔTE D'AZUR,MARSEILLE,5529,10191,15720,
Musée des Alpilles,2001,PROVENCE-ALPES-CÔTE D'AZUR,SAINT-REMY-DE-PROVENCE,2250,4408,6658,
Musée des A.T.P. de Moyenne Provence,2001,PROVENCE-ALPES-CÔTE D'AZUR,DRAGUIGNAN,10859,1703,12562,
Musée Jean Aicard,2001,PROVENCE-ALPES-CÔTE D'AZUR,LE POUVEREL LA GARDE,0,1527,1527,
Musée Archéologique,2001,PROVENCE-ALPES-CÔTE D'AZUR,SAINT-RAPHAËL,6500,600,7100,
Musée de l'Annonciade,2001,PROVENCE-ALPES-CÔTE D'AZUR,SAINT-TROPEZ,55000,0,55000,
Musée Municipal Camille Pautet,2001,PROVENCE-ALPES-CÔTE D'AZUR,MAZAN,0,811,811,
Musée du Brou,2001,RHONE-ALPES,BOURG-EN-BRESSE,74056,0,74056,
Musée du Peigne et de la Plasturgie,2001,RHONE-ALPES,OYONNAX,2852,365,3217,
Musée du Vieux Pérouges,2001,RHONE-ALPES,PEROUGES,17700,0,17700,
Musée Chintreuil,2001,RHONE-ALPES,PONT-DE-VAUX,3299,922,4221,
Musée International de la Chaussure,2001,RHONE-ALPES,ROMANS,19494,19779,39273,
Musée des Beaux-Arts,2001,RHONE-ALPES,VALENCE,15435,7300,22735,
Musée Alpin,2001,RHONE-ALPES,CHAMONIX,22813,3647,26460,
"Notre histoire, Musée de Rumilly",2001,RHONE-ALPES,RUMILLY,0,1336,1336,
Musée - Parc Archéologique du Lac de Paladru,2001,RHONE-ALPES,CHARAVINES,14039,0,14039,
Musée de la Résistance de la Déportation de l'Isère,2001,RHONE-ALPES,GRENOBLE,3855,13687,17542,
Muséum d'Histoire Naturelle de Grenoble,2001,RHONE-ALPES,GRENOBLE,19002,49419,68421,
Musée Dauphinois,2001,RHONE-ALPES,GRENOBLE,50267,0,50267,
Musée Alice Taverne,2001,RHONE-ALPES,AMBIERLE,7029,1124,8153,
Musée de la Soierie,2001,RHONE-ALPES,CHARLIEU,8855,1382,10237,
Atelier - Musée du Chapeau,2001,RHONE-ALPES,CHAZELLES-SUR-LYON,19977,2823,22800,
Musée des Beaux-Arts et d'Archéologie J. Dechelette,2001,RHONE-ALPES,ROANNE,10926,13059,23985,
Musée Gadagne,2001,RHONE-ALPES,LYON,34493,0,34493,
Musée de la Civilisation Gallo-Romaine,2001,RHONE-ALPES,LYON,35330,37595,72925,
Musée du Costume,2001,RHONE-ALPES,BOURG-SAINT-MAURICE,1409,541,1950,
Musée Savoisien,2001,RHONE-ALPES,CHAMBERY,6343,12460,18803,
Musée des Beaux-Arts,2001,RHONE-ALPES,CHAMBERY,900,10100,11000,
Muséum d'histoire naturelle,2001,RHONE-ALPES,CHAMBERY,1931,1232,3163,
Musée de l'Académie de La Val d'Isère,2001,RHONE-ALPES,MOÛTIERS,256,174,430,
Musée du Château des Rohan,2002,ALSACE,SAVERNE,5357,6332,11689,
Musée de l'Œuvre Notre-Dame,2002,ALSACE,STRASBOURG,15413,18364,33777,
Musée J.F. Oberlin,2002,ALSACE,WALDERSBACH,4192,1200,5392,
Musée EDF Electropolis,2002,ALSACE,MULHOUSE,25716,5055,30771,
Musée National de l'Automobile - Collection Schlumpf,2002,ALSACE,MULHOUSE,201715,13418,215133,
Musée de l'Impression sur Etoffes,2002,ALSACE,MULHOUSE,28196,0,28196,
Maison du Sundgau - Musée Paysan,2002,ALSACE,OLTINGUE,4395,726,5121,
Musée Fernand Desmoulin,2002,AQUITAINE,BRANTOME,12957,527,13484,
Musée-Aquarium,2002,AQUITAINE,CREYSSE,7000,0,7000,
Muséum d'Histoire Naturelle de Bordeaux,2002,AQUITAINE,BORDEAUX,6296,31176,37472,
Musée des Beaux-Arts,2002,AQUITAINE,BORDEAUX,17322,23013,40335,
Musée du Patrimoine Religieux et des Croyances Populaires,2002,AQUITAINE,MOUSTEY,1863,0,1863,
Musée Municipal Albert Marzelles,2002,AQUITAINE,MARMANDE,0,10341,10341,
Musée Municipal (Moulin de Gajac),2002,AQUITAINE,VILLENEUVE-SUR-LOT,1923,1637,3560,
Musée National du Château,2002,AQUITAINE,PAU,65241,33591,98832,
Musée Municipal de Gannat,2002,AUVERGNE,GANNAT,1190,438,1628,
Musée Rieckotter,2002,AUVERGNE,NERIS-LES-BAINS,1377,0,1377,
Musée des Sciences,2002,AUVERGNE,AURILLAC,13748,2120,15868,
Musée des Arts et Traditions Populaires de Haute Loire,2002,AUVERGNE,LAVAUDIEU,13768,680,14448,
Musée Crozatier,2002,AUVERGNE,LE PUY-EN-VELAY,11235,11975,23210,
Musée Départemental de la Céramique Gallo-Romaine,2002,AUVERGNE,LEZOUX,1024,2959,3983,
Musée Paléontologique,2002,AUVERGNE,MENAT,1453,0,1453,
Musée du Vin de Bourgogne,2002,BOURGOGNE,BEAUNE,34697,3516,38213,
Musée Rolin,2002,BOURGOGNE,AUTUN,18681,5113,23794,
Museum d'Histoire Naturelle Jacques de La Comble,2002,BOURGOGNE,AUTUN,636,3119,3755,
Musée René Davoine,2002,BOURGOGNE,CHAROLLES,0,610,610,
Musée des Ursulines,2002,BOURGOGNE,MACON,2745,8195,10940,
Musée du Terroir,2002,BOURGOGNE,ROMENAY,184,0,184,
Hôtel Dieu - Musée Greuze,2002,BOURGOGNE,TOURNUS,8514,4439,12953,
Maison du Blé et du Pain,2002,BOURGOGNE,VERDUN-SUR-LE-DOUBS,2845,744,3589,
Musée de l'Avallonnais Jean Després,2002,BOURGOGNE,AVALLON,818,3193,4011,
Musée de la Pêche,2002,BRETAGNE,CONCARNEAU,47000,3000,50000,
Ecomusée d'Ouessant - Vivre sur une Ile,2002,BRETAGNE,OUESSANT,13217,0,13217,
Musée Départemental Breton,2002,BRETAGNE,QUIMPER,24655,20823,45478,
Musée de l'Ecole Rurale en Bretagne,2002,BRETAGNE,TREGARVAN,12169,1639,13808,
Musée des Beaux-Arts,2002,BRETAGNE,RENNES,72145,0,72145,
Musée d'Histoire de la Ville de Saint-Malo,2002,BRETAGNE,SAINT-MALO,37122,11101,48223,
Musée des Rochers-Sévigné,2002,BRETAGNE,VITRE,9370,2671,12041,
Ecomusée de Saint-Dégan,2002,BRETAGNE,BREC'H,9317,220,9537,
Musée du Berry,2002,CENTRE,BOURGES,0,18246,18246,
Musée Emile Chénon,2002,CENTRE,CHATEAUMEILLANT,1043,0,1043,
Musée Saint-Vic,2002,CENTRE,SAINT-AMAND-MONTROND,4974,0,4974,
Musée de la Chemiserie et de l'Elégance Masculine,2002,CENTRE,ARGENTON-SUR-CREUSE,9136,0,9136,
Musée Archéologique d'Argentomagus,2002,CENTRE,SAINT-MARCEL,20522,0,20522,
Musée du Vieux Chinon,2002,CENTRE,CHINON,2000,0,2000,
Musée François Rabelais,2002,CENTRE,SEUILLY,13963,0,13963,
Muséum d'Histoire Naturelle,2002,CENTRE,TOURS,4916,14968,19884,
Musée des Vins de Touraine,2002,CENTRE,TOURS,2488,3586,6074,
Musée du Compagnonnage,2002,CENTRE,TOURS,42011,9128,51139,
Muséum d'Histoire Naturelle,2002,CENTRE,BLOIS,5405,8106,13511,
Atelier Musée Louis Leygue,2002,CENTRE,NAVEIL,22,0,22,
Musée de la Marine de Loire,2002,CENTRE,CHATEAUNEUF-SUR-LOIRE,10297,4791,15088,
Musée Historique et Archéologique,2002,CENTRE,ORLEANS,1031,3346,4377,
Musée du Feutre,2002,CHAMPAGNE-ARDENNES,MOUZON,1970,3420,5390,
Musée Napoléon Ier,2002,CHAMPAGNE-ARDENNES,BRIENNE-LE-CHATEAU,3555,864,4419,
Musée Palais Fesch,2002,CORSE,AJACCIO,37166,13849,51015,
Musée de Plein Air des Maisons Comtoises,2002,FRANCHE-COMTE,NANCRAY,45420,0,45420,
Musée-Maison Natale Gustave Courbet,2002,FRANCHE-COMTE,ORNANS,20072,0,20072,
Musée des Salines,2002,FRANCHE-COMTE,SALINS-LES-BAINS,55404,0,55404,
Donation Maurice Jardot,2002,FRANCHE-COMTE,BELFORT,5395,0,5395,
Musée Municipal Robert Dubois-Corneau,2002,ILE-DE-FRANCE,BRUNOY,295,917,1212,
Musée Français de la Carte à Jouer,2002,ILE-DE-FRANCE,ISSY-LES-MOULINEAUX,5226,7215,12441,
Musée - Atelier Rodin (Annexe du musée de Paris),2002,ILE-DE-FRANCE,MEUDON,2678,3069,5747,
Musée des Automates,2002,ILE-DE-FRANCE,NEUILLY-SUR-SEINE,0,5457,5457,
Musée d'Histoire Locale - Mémoire de la Ville (et Franco Suisse),2002,ILE-DE-FRANCE,RUEIL-MALMAISON,0,2000,2000,
Musée National Eugène Delacroix,2002,ILE-DE-FRANCE,PARIS,13801,10856,24657,
Musée de l'Armée,2002,ILE-DE-FRANCE,PARIS,1014945,0,1014945,
Musée de la Franc-Maçonnerie,2002,ILE-DE-FRANCE,PARIS,9500,0,9500,
Musée de Montmartre,2002,ILE-DE-FRANCE,PARIS,40656,0,40656,
Musée Zadkine,2002,ILE-DE-FRANCE,PARIS,7488,13880,21368,
Musée National Picasso,2002,ILE-DE-FRANCE,PARIS,259814,180803,440617,
Musée du Louvre,2002,ILE-DE-FRANCE,PARIS,3979000,1805000,5784000,
Maison Natale de Louis Braille,2002,ILE-DE-FRANCE,COUPVRAY,2567,1465,4032,
Musée d'Art et d'Histoire Militaire,2002,ILE-DE-FRANCE,FONTAINEBLEAU,1698,3500,5198,
Musée du Château de Fontainebleau,2002,ILE-DE-FRANCE,FONTAINEBLEAU,190747,166848,357595,
Musée d'Art et d'Histoire,2002,ILE-DE-FRANCE,SAINT-DENIS,24133,0,24133,
Musée Archéologique du Val d'Oise,2002,ILE-DE-FRANCE,GUIRY-EN-VEXIN,13917,0,13917,
Musée d'Art et d'Histoire Louis Senlecq,2002,ILE-DE-FRANCE,L'ISLE-ADAM,2401,13284,15685,
Musée Camille Pissarro,2002,ILE-DE-FRANCE,PONTOISE,0,4437,4437,
Musée de la Ville,2002,ILE-DE-FRANCE,MONTIGNY LE BRETONNEUX,0,4087,4087,
Musée d'Art et d'Histoire,2002,ILE-DE-FRANCE,POISSY,0,248,248,
Musée du Jouet Pierre Pinel,2002,ILE-DE-FRANCE,POISSY,20096,3453,23549,
Musée d'Archéologie Nationale (des origines à l'an mille) - Château de st-Germain-en-Laye,2002,ILE-DE-FRANCE,SAINT-GERMAIN-EN-LAYE,19937,34719,54656,
Musée du Colombier,2002,LANGUEDOC-ROUSSILLON,ALES,0,9926,9926,
Musée Cévenol,2002,LANGUEDOC-ROUSSILLON,LE VIGAN,3834,1360,5194,
Musée d'Histoire Naturelle et de Préhistoire,2002,LANGUEDOC-ROUSSILLON,NIMES,29212,0,29212,
Musée de la Préhistoire des Matelles,2002,LANGUEDOC-ROUSSILLON,LES MATELLES,728,2157,2885,
Musée Archéologique,2002,LANGUEDOC-ROUSSILLON,MINERVE,7067,0,7067,
Musée Fabre,2002,LANGUEDOC-ROUSSILLON,MONTPELLIER,12743,17699,30442,
Musée de Préhistoire Régionale et du Mégalithisme,2002,LANGUEDOC-ROUSSILLON,SAINT-PONS-DE-THOMIERES,2305,236,2541,
Musée du Pays d'Ussel,2002,LIMOUSIN,USSEL,0,2950,2950,
Les Sources d'Hercule,2002,LORRAINE,DENEUVRE,5799,749,6548,
Palais des ducs de Lorraine - Musée Historique Lorrain,2002,LORRAINE,NANCY,28532,47652,76184,
Maison du Verre et du Cristal,2002,LORRAINE,MEISENTHAL,16815,284,17099,
Musée de la Mine - Carreau Wendel,2002,LORRAINE,PETITE-ROSSELLE,4022,0,4022,
Musée de La Faïence et des Techniques Faïencières,2002,LORRAINE,SARREGUEMINES,7871,6452,14323,
Musée de la Lutherie et de l'Archèterie Française,2002,LORRAINE,MIRECOURT,6634,2065,8699,
Musée Départemental d'Archéologie Précolombienne et de Préhistoire de la Martinique,2002,MARTINIQUE,FORT-DE-FRANCE,7396,1524,8920,
Musée des Arts et Métiers Traditionnels,2002,MIDI-PYRENEES,SALLES-LA-SOURCE,8649,1105,9754,
Musée Archéologique,2002,MIDI-PYRENEES,EAUZE,6351,1217,7568,
Musée Paul Dupuy,2002,MIDI-PYRENEES,TOULOUSE,10565,6151,16716,
Musée Georges Labit,2002,MIDI-PYRENEES,TOULOUSE,4975,14740,19715,
Musée des Augustins,2002,MIDI-PYRENEES,TOULOUSE,59625,40766,100391,
Musée Pyrénéen,2002,MIDI-PYRENEES,LOURDES,68342,3796,72138,
"Musée Archéologique ""Armand-Viré""",2002,MIDI-PYRENEES,LUZECH,180,80,260,
Musée Départemental du Textile,2002,MIDI-PYRENEES,LA-BASTIDE-ROUAIROUX,2889,2651,5540,
Musée de Préhistoire,2002,MIDI-PYRENEES,SAINT-ANTONIN-NOBLE-VAL,1395,0,1395,
"Forum Antique de Bavay, Musée Archéologique du Département du Nord",2002,NORD-PAS-DE-CALAIS,BAVAY,17713,0,17713,
Musée des Beaux-Arts,2002,NORD-PAS-DE-CALAIS,DUNKERQUE,24942,0,24942,
Musée d'Histoire Naturelle et de Géologie,2002,NORD-PAS-DE-CALAIS,LILLE,23358,27762,51120,
Musée d'Histoire Locale de Marchiennes,2002,NORD-PAS-DE-CALAIS,MARCHIENNES,888,408,1296,
Musée des Beaux-Arts,2002,NORD-PAS-DE-CALAIS,ROUBAIX,212554,0,212554,
Musée Municipal,2002,NORD-PAS-DE-CALAIS,LE TOUQUET-PARIS-PLAGE,5636,4817,10453,
Musée Jean-Charles Cazin,2002,NORD-PAS-DE-CALAIS,SAMER,0,650,650,
Musée Baron Gérard,2002,BASSE-NORMANDIE,BAYEUX,9635,0,9635,
Musée d'Ethnographie et d'Arts Populaires et Musée de la Marine,2002,BASSE-NORMANDIE,HONFLEUR,20296,1266,21562,
Musée de Trouville - Villa Montebello,2002,BASSE-NORMANDIE,TROUVILLE-SUR-MER,1269,16511,17780,
Musée paléontologique,2002,BASSE-NORMANDIE,VILLERS-SUR-MER,0,12500,12500,
Musée Municipal d'Avranches,2002,BASSE-NORMANDIE,AVRANCHES,4612,0,4612,
Maison des Templiers,2002,HAUTE-NORMANDIE,CAUDEBEC-EN-CAUX,800,0,800,
Château-Musée de Dieppe,2002,HAUTE-NORMANDIE,DIEPPE,38185,5525,43710,
Musée Industriel de la Corderie Vallois,2002,HAUTE-NORMANDIE,NOTRE-DAME-DE-BONDEVILLE,3072,8519,11591,
Musée du Pays de Retz,2002,PAYS DE LA LOIRE,BOURGNEUF-EN-RETZ,5828,104,5932,
Musée de la Vigne et du Vin d'Anjou,2002,PAYS DE LA LOIRE,SAINT LAMBERT-DU-LATTAY,6546,841,7387,
Musée Communal Robert Tatin,2002,PAYS DE LA LOIRE,COSSE-LE-VIVIEN,13690,1824,15514,
Musée de l'Ardoise et de la Géologie,2002,PAYS DE LA LOIRE,RENAZE,1930,1550,3480,
Musée de Tessé,2002,PAYS DE LA LOIRE,LE MANS,30625,0,30625,
Musée de l'Abbaye de Sainte-Croix,2002,PAYS DE LA LOIRE,LES SABLES D'OLONNE,4410,10635,15045,
Musée du Château de Blérancourt,2002,PICARDIE,BLERANCOURT,3050,2291,5341,
Musée de la Figurine Historique,2002,PICARDIE,COMPIEGNE,5135,3867,9002,
Musée du Noyonnais,2002,PICARDIE,NOYON,2959,0,2959,
Musée de l'Hôtel de Berny,2002,PICARDIE,AMIENS,445,2956,3401,
Musée de Picardie,2002,PICARDIE,AMIENS,24808,24402,49210,
Musée Alfred Danicourt,2002,PICARDIE,PERONNE,0,1555,1555,
Musée Protestant,2002,POITOU-CHARENTES,LA ROCHELLE,1637,251,1888,
Musée de la Maison de Pierre Loti,2002,POITOU-CHARENTES,ROCHEFORT,38223,0,38223,
Musée de l'Ile d'Oléron,2002,POITOU-CHARENTES,ST-PIERRE D'OLERON,2624,0,2624,
Musée de Bressuire,2002,POITOU-CHARENTES,BRESSUIRE,0,3985,3985,
Musée Municipal de l'Hôtel de Sully,2002,POITOU-CHARENTES,CHATELLERAULT,1898,2144,4042,
Musée Charbonneau-Lassay,2002,POITOU-CHARENTES,LOUDUN,143,186,329,
Musée Rupert de Chièvres,2002,POITOU-CHARENTES,POITIERS,3042,381,3423,
Musée Sainte-Croix,2002,POITOU-CHARENTES,POITIERS,2562,13804,16366,
Musée de la vallée,2002,PROVENCE-ALPES-CÔTE D'AZUR,BARCELONNETTE,16603,0,16603,
Musée Municipal,2002,PROVENCE-ALPES-CÔTE D'AZUR,FORCALQUIER,368,0,368,
Musée Picasso,2002,PROVENCE-ALPES-CÔTE D'AZUR,ANTIBES,131977,32984,164961,
Musée Renoir,2002,PROVENCE-ALPES-CÔTE D'AZUR,CAGNES-SUR-MER,28901,7017,35918,
Musée des Beaux-Arts Jules Chéret,2002,PROVENCE-ALPES-CÔTE D'AZUR,NICE,18048,14999,33047,
Muséon Arlaten,2002,PROVENCE-ALPES-CÔTE D'AZUR,ARLES,29988,15368,45356,
Musée Départemental de l'Arles Antique,2002,PROVENCE-ALPES-CÔTE D'AZUR,ARLES,42780,38796,81576,
Musée des Arts et d’Histoire,2002,PROVENCE-ALPES-CÔTE D'AZUR,BORMES-LES-MIMOSAS,0,11358,11358,
Musée du Petit Palais,2002,PROVENCE-ALPES-CÔTE D'AZUR,AVIGNON,40353,0,40353,
Musée Municipal,2002,PROVENCE-ALPES-CÔTE D'AZUR,SAULT,0,1727,1727,
Musée Vivarois César Filhol,2002,RHONE-ALPES,ANNONAY,1310,1714,3024,
Musée International de la Chaussure,2002,RHONE-ALPES,ROMANS,18594,16130,34724,
"Notre histoire, Musée de Rumilly",2002,RHONE-ALPES,RUMILLY,0,2011,2011,
Musée Géo-Charles,2002,RHONE-ALPES,ECHIROLLES,4619,0,4619,
Conservatoire - Musée des Industries Hydroélectriques,2002,RHONE-ALPES,VAUJANY,0,12993,12993,
Musée Départemental de la Révolution Française,2002,RHONE-ALPES,VIZILLE,36699,0,36699,
Musée d'Archéologie,2002,RHONE-ALPES,FEURS,1142,1984,3126,
Musée des Beaux-Arts et d'Archéologie J. Dechelette,2002,RHONE-ALPES,ROANNE,9661,13724,23385,
Musée Folklorique et Traditions Populaires Marius Audin,2002,RHONE-ALPES,BEAUJEU,5674,496,6170,
Musée de la Civilisation Gallo-Romaine,2002,RHONE-ALPES,LYON,27311,48794,76105,
Musée Paul Dini,2002,RHONE-ALPES,VILLEFRANCHE-SUR-SAONE,6277,11738,18015,
Musée de la Poterie,2003,ALSACE,BETSCHDORF,2250,683,2933,
Musée Historique,2003,ALSACE,HAGUENAU,5680,0,5680,
Maison de l'Archéologie des Vosges du Nord,2003,ALSACE,NIEDERBRONN-LES-BAINS,1803,284,2087,
Cabinet des Estampes et des Dessins,2003,ALSACE,STRASBOURG,13163,21785,34948,
Musée d'Histoire Naturelle et d'Ethnographie de Colmar,2003,ALSACE,COLMAR,2433,3770,6203,
Musée Historique et Militaire de Huningue,2003,ALSACE,HUNINGE,405,0,405,
Maison du Sundgau - Musée Paysan,2003,ALSACE,OLTINGUE,2830,484,3314,
Musée du Dolder,2003,ALSACE,RIQUEWIHR,7530,737,8267,
Musée des Amis de Thann,2003,ALSACE,THANN,592,1317,1909,
Musée de Borda,2003,AQUITAINE,DAX,4484,4306,8790,
Musée de la Faïence et des arts de la table,2003,AQUITAINE,SAMADET,5517,2765,8282,
Musée Municipal Albert Marzelles,2003,AQUITAINE,MARMANDE,0,8363,8363,
Musée Basque et de l'Histoire de Bayonne,2003,AQUITAINE,BAYONNE,20835,10910,31745,
Musée Bernadotte,2003,AQUITAINE,PAU,1993,1417,3410,
Musée Municipal de Souvigny,2003,AUVERGNE,SOUVIGNY,6248,495,6743,
Musée d'Art et d'Archéologie,2003,AUVERGNE,AURILLAC,1928,15901,17829,
Musée de la Haute Auvergne,2003,AUVERGNE,SAINT-FLOUR,6128,1713,7841,
Musée de Paléontologie,2003,AUVERGNE,CHILHAC,2770,223,2993,
Muséum d'Histoire Naturelle Henri-Lecoq,2003,AUVERGNE,CLERMONT-FERRAND,4943,11704,16647,
Musée des Pénitents Blancs,2003,AUVERGNE,MARSAC-EN-LIVRADOIS,602,0,602,
Musée Bonaparte,2003,BOURGOGNE,AUXONNE,0,2352,2352,
Musée des Beaux-Arts,2003,BOURGOGNE,BEAUNE,3973,1370,5343,
Musée François Rude,2003,BOURGOGNE,DIJON,0,30284,30284,
Musée de la Mine,2003,BOURGOGNE,LA MACHINE,5041,1893,6934,
Musée Auguste Grasset,2003,BOURGOGNE,VARZY,2067,1033,3100,
Musée Nicéphore Niepce,2003,BOURGOGNE,CHALON-SUR-SAONE,5336,13400,18736,
Musée René Davoine,2003,BOURGOGNE,CHAROLLES,139,360,499,
Musée Lamartine,2003,BOURGOGNE,MACON,1819,1766,3585,
Musée de la Tour du Moulin,2003,BOURGOGNE,MARCIGNY,1152,585,1737,
Musée du Terroir,2003,BOURGOGNE,ROMENAY,80,0,80,
Musée Départemental de Préhistoire de Solutré,2003,BOURGOGNE,SOLUTRE-POUILLY,18401,7006,25407,
Musée du Château de Dinan,2003,BRETAGNE,DINAN,23958,6946,30904,
Ecomusée des Monts d'Arrée - Moulins de Kerouat & Maison Cornec de Rivoal,2003,BRETAGNE,COMMANA,23171,6581,29752,
Le Port-Musée,2003,BRETAGNE,DOUARNENEZ,34763,5394,40157,
Musée des Phares et Balises,2003,BRETAGNE,OUESSANT,24149,0,24149,
Musée des Beaux-Arts,2003,BRETAGNE,QUIMPER,135304,31251,166555,
Ecomusée du Pays de Rennes,2003,BRETAGNE,RENNES,24213,10807,35020,
Musée International du Long-Cours Cap-Hornier,2003,BRETAGNE,SAINT-MALO,7402,3299,10701,
Musée des Rochers-Sévigné,2003,BRETAGNE,VITRE,8154,2478,10632,
Ecomusée de Saint-Dégan,2003,BRETAGNE,BREC'H,9702,865,10567,
Musée de la Résistance Bretonne,2003,BRETAGNE,SAINT-MARCEL - MALESTROIT,28622,4512,33134,
Musée du Berry,2003,CENTRE,BOURGES,0,19078,19078,
Musée d'Histoire Naturelle Gabriel Foucher,2003,CENTRE,BOURGES,14533,14164,28697,
Musée du Château Charles VII,2003,CENTRE,MEHUN-SUR-YEVRE,7200,800,8000,
Musée Saint-Vic,2003,CENTRE,SAINT-AMAND-MONTROND,1363,3999,5362,
Musée Municipal,2003,CENTRE,VIERZON,0,1200,1200,
Musée des Beaux-Arts,2003,CENTRE,CHARTRES,5303,9487,14790,
Musée des Beaux-Arts et d'Histoire Naturelle,2003,CENTRE,CHATEAUDUN,4646,5036,9682,
Musée d'Art et d'Histoire de Dreux,2003,CENTRE,DREUX,852,3897,4749,
Musée Marcel Proust,2003,CENTRE,ILLIERS-COMBRAY,4009,616,4625,
"""Maison Musée"" René Descartes",2003,CENTRE,DESCARTES,712,0,712,
Musée des Vins de Touraine,2003,CENTRE,TOURS,2760,2264,5024,
Musée de l'Hôtel Goüin,2003,CENTRE,TOURS,3793,4136,7929,
Atelier Musée Louis Leygue,2003,CENTRE,NAVEIL,60,0,60,
Musée de Sologne,2003,CENTRE,ROMORANTIN-LANTHENAY,3781,4154,7935,
Musée de Vendôme,2003,CENTRE,VENDOME,1155,8149,9304,
Musée du Gatinais,2003,CENTRE,MONTARGIS,300,272,572,
Musée des Beaux-Arts,2003,CENTRE,ORLEANS,7974,37103,45077,
Musée de la Maison de la Dernière Cartouche,2003,CHAMPAGNE-ARDENNES,BAZEILLES,760,353,1113,
Musée du Château-Fort,2003,CHAMPAGNE-ARDENNES,SEDAN,53070,0,53070,
Pharmacie Musée de l'Hôtel-Dieu,2003,CHAMPAGNE-ARDENNES,TROYES,2542,2183,4725,
Musée d'Art et d'Histoire,2003,CHAMPAGNE-ARDENNES,LANGRES,4211,5337,9548,
Musée-Maison Natale Gustave Courbet,2003,FRANCHE-COMTE,ORNANS,29100,900,30000,
Musée de Pontarlier,2003,FRANCHE-COMTE,PONTARLIER,4441,6208,10649,
Musée Départemental Albert-et-Félicie Demard - ATP,2003,FRANCHE-COMTE,CHAMPLITTE,7657,7058,14715,
Musée Georges Garret,2003,FRANCHE-COMTE,VESOUL,0,5356,5356,
Musée Roybet Fould,2003,ILE-DE-FRANCE,COURBEVOIE,0,10112,10112,
Musée Français de la Carte à Jouer,2003,ILE-DE-FRANCE,ISSY-LES-MOULINEAUX,4673,8171,12844,
Musée - Atelier Rodin (Annexe du musée de Paris),2003,ILE-DE-FRANCE,MEUDON,2707,2116,4823,
Musée National Eugène Delacroix,2003,ILE-DE-FRANCE,PARIS,17455,16319,33774,
Musée National Jean-Jacques Henner,2003,ILE-DE-FRANCE,PARIS,0,2658,2658,
Musée des Arts d'Afrique et d'Océanie (MAAO),2003,ILE-DE-FRANCE,PARIS,121885,81602,203487,
Musée départemental Stéphane Mallarmé,2003,ILE-DE-FRANCE,VULAINES-SUR-SEINE,2521,620,3141,
Musée de l'Air et de l'Espace,2003,ILE-DE-FRANCE,LE BOURGET Cedex,75867,94953,170820,
Musée de la Renaissance - Château d'Ecouen,2003,ILE-DE-FRANCE,ECOUEN,16136,41299,57435,
Musée de la Toile de Jouy,2003,ILE-DE-FRANCE,JOUY-EN-JOSAS,13120,1147,14267,
Musée de l'Hôtel-Dieu,2003,ILE-DE-FRANCE,MANTES-LA-JOLIE,3407,1663,5070,
Musée Historique de Villèle,2003,LA REUNION,SAINT-GILLES-LES-HAUTS,16135,18988,35123,
Musée Archéologique,2003,LANGUEDOC-ROUSSILLON,SALLELES D'AUDE,13000,0,13000,
Musée-Bibliothèque Pierre-André Benoît,2003,LANGUEDOC-ROUSSILLON,ALES,0,11909,11909,
Musée Archéologique,2003,LANGUEDOC-ROUSSILLON,NIMES,0,25484,25484,
Musée d'Histoire Naturelle et de Préhistoire,2003,LANGUEDOC-ROUSSILLON,NIMES,8214,16162,24376,
Musée Agathois,2003,LANGUEDOC-ROUSSILLON,AGDE,4488,1049,5537,
Musée du Biterrois,2003,LANGUEDOC-ROUSSILLON,BEZIERS,5040,9906,14946,
Musée Archéologique Henri Prades,2003,LANGUEDOC-ROUSSILLON,LATTES,9258,3784,13042,
Musée Archéologique,2003,LANGUEDOC-ROUSSILLON,MINERVE,5470,33,5503,
Musée du Vieux Montpellier,2003,LANGUEDOC-ROUSSILLON,MONTPELLIER,0,5054,5054,
Musée départemental d'Art Moderne,2003,LANGUEDOC-ROUSSILLON,CERET,67534,22511,90045,
Muséum d'Histoire Naturelle,2003,LANGUEDOC-ROUSSILLON,PERPIGNAN,516,7075,7591,
Musée Hyacinthe Rigaud,2003,LANGUEDOC-ROUSSILLON,PERPIGNAN,3932,2739,6671,
Musée du Castillet Casa Pairal,2003,LANGUEDOC-ROUSSILLON,PERPIGNAN,10445,15537,25982,
Musée du Pays d'Ussel,2003,LIMOUSIN,USSEL,0,3275,3275,
Musée National Adrien Dubouché,2003,LIMOUSIN,LIMOGES,12580,10474,23054,
Muséum- Aquarium de Nancy,2003,LORRAINE,NANCY,28130,20370,48500,
"Musée ""au Fil du Papier""",2003,LORRAINE,PONT-A-MOUSSON,2742,3039,5781,
Musée de la Princerie,2003,LORRAINE,VERDUN,2470,2524,4994,
Musées de la Cour d'Or,2003,LORRAINE,METZ,10198,27626,37824,
Musée Militaire et Erckmann-Chatrian,2003,LORRAINE,PHALSBOURG,417,0,417,
Musée du Pays de Sarrebourg,2003,LORRAINE,SARREBOURG,4103,5227,9330,
"Jardin d'Hiver, Musée de La Faïence",2003,LORRAINE,SARREGUEMINES,6461,8282,14743,
Moulin de la Blies - Musée des Techniques Faïencières,2003,LORRAINE,SARREGUEMINES,5944,11960,17904,
Musée de l'Image,2003,LORRAINE,EPINAL,17048,2305,19353,
Musée Charles Friry,2003,LORRAINE,REMIREMONT,387,1926,2313,
Musée Charles de Bruyères,2003,LORRAINE,REMIREMONT,681,4455,5136,
Musée Départemental d'Archéologie Précolombienne et de Préhistoire de la Martinique,2003,MARTINIQUE,FORT-DE-FRANCE,7125,1493,8618,
Musée de La Canne,2003,MARTINIQUE,LES TROIS ILETS,30641,0,30641,
Musée Départemental de l'Ariège,2003,MIDI-PYRENEES,FOIX,80486,7042,87528,
Musée du Palais des Evêques,2003,MIDI-PYRENEES,SAINT-LIZIER,6044,901,6945,
Musée Municipal d'archéologie,2003,MIDI-PYRENEES,ROQUEFORT-SUR-SOULZON,0,2900,2900,
Musée des Arts et Métiers Traditionnels,2003,MIDI-PYRENEES,SALLES-LA-SOURCE,9517,1412,10929,
Musée Archéologique,2003,MIDI-PYRENEES,EAUZE,4791,1283,6074,
Musée Joseph Abeilhé,2003,MIDI-PYRENEES,MARCIAC,28,50,78,
Musée du Vieux Toulouse,2003,MIDI-PYRENEES,TOULOUSE,3252,141,3393,
"Les Abattoirs, Musée d'Art Moderne et Contemporain",2003,MIDI-PYRENEES,TOULOUSE,29652,63252,92904,
Musée Georges Labit,2003,MIDI-PYRENEES,TOULOUSE,5148,14224,19372,
Musée Saint-Raymond,2003,MIDI-PYRENEES,TOULOUSE,19724,38471,58195,
Musée Champollion,2003,MIDI-PYRENEES,FIGEAC,25201,1347,26548,
"Musée Archéologique ""Armand-Viré""",2003,MIDI-PYRENEES,LUZECH,780,253,1033,
Musée Gallo-Romain d'Uxellodunum,2003,MIDI-PYRENEES,MARTEL,350,0,350,
Musée d'Art Sacré,2003,MIDI-PYRENEES,ROCAMADOUR,4694,964,5658,
Musée Toulouse Lautrec,2003,MIDI-PYRENEES,ALBI,108623,23361,131984,
Musée Eugénie et Maurice Guérin,2003,MIDI-PYRENEES,ANDILLAC,2103,2893,4996,
Musée Jean Jaurès,2003,MIDI-PYRENEES,CASTRES,1237,8427,9664,
Musée du protestantisme en Haut-Languedoc,2003,MIDI-PYRENEES,FERRIERES,1031,462,1493,
Musée des Beaux-Arts,2003,MIDI-PYRENEES,GAILLAC,1769,3957,5726,
Musée Raymond Lafage,2003,MIDI-PYRENEES,LISLE-SUR-TARN,1074,235,1309,
Musée du Pays Rabastinois,2003,MIDI-PYRENEES,RABASTENS,909,1064,1973,
Musée Théodore Calbet,2003,MIDI-PYRENEES,GRISOLLES,0,2750,2750,
Musée des arts et traditions populaires,2003,MIDI-PYRENEES,MOISSAC,4216,1109,5325,
Palais des Beaux-Arts de Lille,2003,NORD-PAS-DE-CALAIS,LILLE,84762,63052,147814,
Musée du Verre,2003,NORD-PAS-DE-CALAIS,SARS-POTERIES,5356,3980,9336,
Musée d'Art Moderne de Lille Métropole,2003,NORD-PAS-DE-CALAIS,VILLENEUVE-D'ASCQ,60833,18131,78964,
Musée Quentovic,2003,NORD-PAS-DE-CALAIS,ETAPLES-SUR-MER,2743,1357,4100,
Musée Municipal,2003,NORD-PAS-DE-CALAIS,LE TOUQUET-PARIS-PLAGE,6903,4019,10922,
Musée d'Art et d'Histoire de Lisieux,2003,BASSE-NORMANDIE,LISIEUX,380,615,995,
Musée Régional du Cidre et du Calvados,2003,BASSE-NORMANDIE,VALOGNES,7108,900,8008,
Musée des Beaux-Arts et de la Dentelle,2003,BASSE-NORMANDIE,ALENCON,9614,10504,20118,
Musée du Château de Flers,2003,BASSE-NORMANDIE,FLERS,2339,2852,5191,
Musée du Percheron,2003,BASSE-NORMANDIE,MORTAGNE-AU-PERCHE,0,843,843,
Musée Départemental d'Art Sacré,2003,BASSE-NORMANDIE,SEES,961,0,961,
Musée du Verre et de la Pierre,2003,HAUTE-NORMANDIE,CONCHES-EN-OUCHE,1282,587,1869,
Pavillon Flaubert,2003,HAUTE-NORMANDIE,CANTELEU,778,0,778,
Maison des Templiers,2003,HAUTE-NORMANDIE,CAUDEBEC-EN-CAUX,774,121,895,
Musée de la Marine de Seine,2003,HAUTE-NORMANDIE,CAUDEBEC-EN-CAUX,4673,2195,6868,
Château-Musée de Dieppe,2003,HAUTE-NORMANDIE,DIEPPE,35305,6379,41684,
Musée du Prieuré,2003,HAUTE-NORMANDIE,HARFLEUR,218,4679,4897,
Musée Mathon-Durand,2003,HAUTE-NORMANDIE,NEUFCHATEL-EN-BRAY,475,1364,1839,
Musée des Beaux-Arts,2003,HAUTE-NORMANDIE,ROUEN,37649,34279,71928,
"Musée de la Fève, Crèches et Traditions Populaires",2003,PAYS DE LA LOIRE,BLAIN,3211,568,3779,
Musées du Parc Naturel Régional de Brière,2003,PAYS DE LA LOIRE,SAINT-JOACHIM,2986,45,3031,
Maison de l'Eclusier /Parc Naturel Régional de Brière,2003,PAYS DE LA LOIRE,SAINT-MALO DE GUERSAC,2893,34,2927,
Musée Joseph Denais,2003,PAYS DE LA LOIRE,BEAUFORT-EN-VALLEE,1562,1143,2705,
Musée du Textile,2003,PAYS DE LA LOIRE,CHOLET,5721,5455,11176,
Musée de la Vigne et du Vin d'Anjou,2003,PAYS DE LA LOIRE,SAINT LAMBERT-DU-LATTAY - VAL-DU-LAYON,7118,1516,8634,
Musée de l'Ardoise,2003,PAYS DE LA LOIRE,TRELAZE,5485,2350,7835,
Musée des Tisserands Mayennais,2003,PAYS DE LA LOIRE,AMBRIERES-LES-VALLEES,386,51,437,
Musée d'Art et d'Archéologie Hôtel Fouquet,2003,PAYS DE LA LOIRE,CHATEAU-GONTIER,74,289,363,
Musée Archéologique Départemental de Jublains,2003,PAYS DE LA LOIRE,JUBLAINS,12736,21389,34125,
Centre Minier de Faymoreau,2003,PAYS DE LA LOIRE,FAYMOREAU,19387,7600,26987,
Musée de l'Abbaye de Sainte-Croix,2003,PAYS DE LA LOIRE,LES SABLES D'OLONNE,4628,10554,15182,
Musée du Nord de la Vendée,2003,PAYS DE LA LOIRE,MONTAIGU,0,365,365,
Musée de la Construction Navale Artisanale,2003,PAYS DE LA LOIRE,NOIRMOUTIER EN L'ILE,13198,1149,14347,
Musée du Château de Blérancourt,2003,PICARDIE,BLERANCOURT,2894,1715,4609,
Musée Jeanne d'Aboville,2003,PICARDIE,LA FERE,398,313,711,
Musée Alexandre Dumas,2003,PICARDIE,VILLERS COTTERETS,2285,433,2718,
Musée de la Figurine Historique,2003,PICARDIE,COMPIEGNE,4187,5244,9431,
Musée du Noyonnais,2003,PICARDIE,NOYON,936,2409,3345,
Musée de la Vénerie,2003,PICARDIE,SENLIS,5573,3715,9288,
Musée de l'Hôtel de Berny,2003,PICARDIE,AMIENS,277,2716,2993,
Musée de la Mytiliculture,2003,POITOU-CHARENTES,ESNANDES,2801,158,2959,
Musée du Nouveau Monde,2003,POITOU-CHARENTES,LA ROCHELLE,4765,5340,10105,
Musée des Beaux-Arts,2003,POITOU-CHARENTES,LA ROCHELLE,6127,2173,8300,
Musée Protestant,2003,POITOU-CHARENTES,LA ROCHELLE,1506,214,1720,
Musée Archéologique,2003,POITOU-CHARENTES,SAINTES,1410,31613,33023,
Musée de l'Ile d'Oléron,2003,POITOU-CHARENTES,ST-PIERRE D'OLERON,2375,0,2375,
Musée de Bressuire,2003,POITOU-CHARENTES,BRESSUIRE,0,8040,8040,
Musée Municipal de l'Hôtel de Sully,2003,POITOU-CHARENTES,CHATELLERAULT,1422,1606,3028,
Musée Rupert de Chièvres,2003,POITOU-CHARENTES,POITIERS,959,1721,2680,
Musée Sainte-Croix,2003,POITOU-CHARENTES,POITIERS,5000,13157,18157,
Musée Archéologique,2003,PROVENCE-ALPES-CÔTE D'AZUR,RIEZ-LA-ROMAINE,897,112,1009,
Musée archéologique,2003,PROVENCE-ALPES-CÔTE D'AZUR,VACHERES,1260,134,1394,
Villa-Musée Jean-Honoré Fragonard,2003,PROVENCE-ALPES-CÔTE D'AZUR,GRASSE,94,155,249,
Musée International de la Parfumerie,2003,PROVENCE-ALPES-CÔTE D'AZUR,GRASSE,41276,0,41276,
Musée d'Art Moderne et d'Art Contemporain,2003,PROVENCE-ALPES-CÔTE D'AZUR,NICE,48758,41218,89976,
Musée Picasso la guerre et la paix à Vallauris,2003,PROVENCE-ALPES-CÔTE D'AZUR,VALLAURIS,21801,7882,29683,
Muséon Arlaten,2003,PROVENCE-ALPES-CÔTE D'AZUR,ARLES,20105,14087,34192,
Musée Départemental de l'Arles Antique,2003,PROVENCE-ALPES-CÔTE D'AZUR,ARLES,35788,39075,74863,
Musée Municipal Méditerranéen de Cassis A.T.P.,2003,PROVENCE-ALPES-CÔTE D'AZUR,CASSIS,0,5300,5300,
Musée Alphonse Daudet,2003,PROVENCE-ALPES-CÔTE D'AZUR,FONTVIEILLE,40700,0,40700,
Musée d'Histoire et d'Archéologie des Baux-de-Provence (Château),2003,PROVENCE-ALPES-CÔTE D'AZUR,LES BAUX DE PROVENCE,274402,0,274402,
Musée Grobet-Labadié,2003,PROVENCE-ALPES-CÔTE D'AZUR,MARSEILLE,2207,8200,10407,
Musée de la Mode,2003,PROVENCE-ALPES-CÔTE D'AZUR,MARSEILLE,5997,6236,12233,
Musée de la Faïence,2003,PROVENCE-ALPES-CÔTE D'AZUR,MARSEILLE,3774,10426,14200,
Muséum d'Histoire Naturelle,2003,PROVENCE-ALPES-CÔTE D'AZUR,MARSEILLE,4132,32434,36566,
Musée des Arts et d’Histoire,2003,PROVENCE-ALPES-CÔTE D'AZUR,BORMES-LES-MIMOSAS,0,13786,13786,
Musée Municipal,2003,PROVENCE-ALPES-CÔTE D'AZUR,DRAGUIGNAN,0,7643,7643,
Musée du Vêtement Provençal (Jean Aicard),2003,PROVENCE-ALPES-CÔTE D'AZUR,SOLLIES-VILLE,0,3505,3505,
Musée Comtadin-Duplessis,2003,PROVENCE-ALPES-CÔTE D'AZUR,CARPENTRAS,882,855,1737,
Musée Sobirats,2003,PROVENCE-ALPES-CÔTE D'AZUR,CARPENTRAS,620,573,1193,
Musée Municipal,2003,PROVENCE-ALPES-CÔTE D'AZUR,ORANGE,62636,0,62636,
Musée Municipal,2003,PROVENCE-ALPES-CÔTE D'AZUR,SAULT,0,1062,1062,
Musée du Brou,2003,RHONE-ALPES,BOURG-EN-BRESSE,47463,23136,70599,
Musée Chintreuil,2003,RHONE-ALPES,PONT-DE-VAUX,5133,944,6077,
Musée Vivarois César Filhol,2003,RHONE-ALPES,ANNONAY,916,1097,2013,
Musée de la Batellerie du Rhône,2003,RHONE-ALPES,SERRIERES,1308,0,1308,
Musée et Site Archéologiques,2003,RHONE-ALPES,SOYONS,8000,2000,10000,
Musée du Rhône,2003,RHONE-ALPES,TOURNON-SUR-RHÔNE,5275,3059,8334,
Musée d'Histoire et d'Archéologie,2003,RHONE-ALPES,DIE,535,683,1218,
Musée International de la Chaussure,2003,RHONE-ALPES,ROMANS,20117,13583,33700,
Musée Alpin,2003,RHONE-ALPES,CHAMONIX,18479,5823,24302,
Musée Léon Marès,2003,RHONE-ALPES,LOVAGNY,22387,0,22387,
Musée des Vallées de Thônes,2003,RHONE-ALPES,THONES,1838,617,2455,
Musée du Chablais,2003,RHONE-ALPES,THONON-LES-BAINS,2072,1063,3135,
Musée d'Huez et de l'Oisans,2003,RHONE-ALPES,ALPE D'HUEZ,3362,1290,4652,
Musée Géo-Charles,2003,RHONE-ALPES,ECHIROLLES,982,2187,3169,
Musée Stendhal,2003,RHONE-ALPES,GRENOBLE,0,6001,6001,
Musée-Cloître Saint-André-Le-Bas,2003,RHONE-ALPES,VIENNE,9204,0,9204,
Musée Lapidaire Saint-Pierre,2003,RHONE-ALPES,VIENNE,5962,0,5962,
Musée Hospitalier,2003,RHONE-ALPES,CHARLIEU,3486,1616,5102,
Musée d'Allard,2003,RHONE-ALPES,MONTBRISON,5344,5600,10944,
Musée Rural,2003,RHONE-ALPES,USSON-EN-FOREZ,4996,1353,6349,
Musée Folklorique et Traditions Populaires Marius Audin,2003,RHONE-ALPES,BEAUJEU,4651,814,5465,
Musée du docteur Faure,2003,RHONE-ALPES,AIX-LES-BAINS,10753,4684,15437,
Musée des Beaux-Arts,2003,RHONE-ALPES,CHAMBERY,5483,15780,21263,
Musée des Charmettes,2003,RHONE-ALPES,CHAMBERY,2338,7743,10081,
Musée du Château des Rohan,2004,ALSACE,SAVERNE,7225,5705,12930,
Musée d'Art Moderne et Contemporain de Strasbourg,2004,ALSACE,STRASBOURG,69843,101994,171837,
Maison du Sundgau - Musée Paysan,2004,ALSACE,OLTINGUE,2184,468,2652,
Musée du Dolder,2004,ALSACE,RIQUEWIHR,6510,495,7005,
Musée des Amis de Thann,2004,ALSACE,THANN,642,1200,1842,
Ecomusée d'Alsace,2004,ALSACE,UNGERSHEIM,266791,43126,309917,
Musée-Aquarium,2004,AQUITAINE,CREYSSE,5068,0,5068,
Musée Paul Reclus,2004,AQUITAINE,DOMME,0,15300,15300,
Musée des Arts et Traditions Populaires du Périgord,2004,AQUITAINE,MUSSIDAN,1299,1228,2527,
Musée Militaire - Souvenir du Périgord,2004,AQUITAINE,PERIGUEUX,1720,954,2674,
Musée des Arts Décoratifs,2004,AQUITAINE,BORDEAUX,31005,0,31005,
CAPC Musée d'Art Contemporain de Bordeaux,2004,AQUITAINE,BORDEAUX,90055,0,90055,
Musée de la Voiture à Cheval,2004,AQUITAINE,BOURG-SUR-GIRONDE,3143,882,4025,
Musée Historique de l'Hydravion,2004,AQUITAINE,BISCARROSSE,17304,847,18151,
Musée Archéologique,2004,AQUITAINE,HASTINGUES,5366,9898,15264,
Musée de la Faïence et des arts de la table,2004,AQUITAINE,SAMADET,8621,0,8621,
Musée Charles-Louis Philippe,2004,AUVERGNE,CERILLY,203,0,203,
Musée des Sciences,2004,AUVERGNE,AURILLAC,7440,8528,15968,
Musée d'Art et d'Archéologie,2004,AUVERGNE,AURILLAC,1591,21021,22612,
Musée d'art et d'histoire Alfred Douët,2004,AUVERGNE,SAINT-FLOUR,2120,1800,3920,
Musée des Arts et Traditions Populaires de Haute Loire,2004,AUVERGNE,LAVAUDIEU,14348,439,14787,
Musée Crozatier,2004,AUVERGNE,LE PUY-EN-VELAY,13213,14876,28089,
Musée des Peintres de l'Ecole de Murols,2004,AUVERGNE,MUROL,3511,144,3655,
Musée Municipal de la Coutellerie,2004,AUVERGNE,THIERS,33450,5209,38659,
Musée Municipal Marcel Sahut,2004,AUVERGNE,VOLVIC,846,2120,2966,
"Musée de la Vie Bourguignonne, Perrin de Puycousin",2004,BOURGOGNE,DIJON,2998,32043,35041,
Muséum - Jardin des Sciences,2004,BOURGOGNE,DIJON,2251,67690,69941,
Musée Municipal,2004,BOURGOGNE,NUITS-SAINT-GEORGES,835,1980,2815,
Musée d'Art et d'Histoire Romain Rolland,2004,BOURGOGNE,CLAMECY,1562,2805,4367,
Musée Auguste Grasset,2004,BOURGOGNE,VARZY,2147,1425,3572,
Musée Rolin,2004,BOURGOGNE,AUTUN,17083,5628,22711,
Musée Eucharistique du Hiéron,2004,BOURGOGNE,PARAY-LE-MONIAL,1933,2234,4167,
Ecomusée de la Bresse Bourguignonne,2004,BOURGOGNE,PIERRE-DE-BRESSE,25361,5196,30557,
Musée du Terroir,2004,BOURGOGNE,ROMENAY,90,0,90,
Musée Départemental de Préhistoire de Solutré,2004,BOURGOGNE,SOLUTRE-POUILLY,17157,7116,24273,
Hôtel Dieu - Musée Greuze,2004,BOURGOGNE,TOURNUS,10546,3626,14172,
Maison du Blé et du Pain,2004,BOURGOGNE,VERDUN-SUR-LE-DOUBS,4161,845,5006,
Musée d'Art et d'Histoire,2004,BOURGOGNE,AUXERRE,12347,22327,34674,
Musée Villeneuvien,2004,BOURGOGNE,VILLENEUVE-SUR-YONNE,0,3762,3762,
Musée des Phares et Balises,2004,BRETAGNE,OUESSANT,19575,0,19575,
Musée Bigouden,2004,BRETAGNE,PONT-L'ABBE,15206,3859,19065,
Musée Départemental Breton,2004,BRETAGNE,QUIMPER,25991,19082,45073,
Musée de l'Ecole Rurale en Bretagne,2004,BRETAGNE,TREGARVAN,12031,1804,13835,
Musée de la Résistance Bretonne,2004,BRETAGNE,SAINT-MARCEL - MALESTROIT,32124,7660,39784,
Musée d'Histoire et d'Archéologie de Vannes,2004,BRETAGNE,VANNES,4671,0,4671,
Musée Estève,2004,CENTRE,BOURGES,0,18312,18312,
Musée d'Histoire Naturelle Gabriel Foucher,2004,CENTRE,BOURGES,17674,12057,29731,
Musée Municipal,2004,CENTRE,VIERZON,0,1989,1989,
Musée des Beaux-Arts,2004,CENTRE,CHARTRES,8705,5668,14373,
Musées de Châteauroux - Hôtel Bertrand,2004,CENTRE,CHATEAUROUX,0,11858,11858,
Musée de l'Hôtel des Communes,2004,CENTRE,AMBOISE,0,4672,4672,
Musée du Vieux Chinon,2004,CENTRE,CHINON,3250,0,3250,
"""Maison Musée"" René Descartes",2004,CENTRE,DESCARTES,659,0,659,
Musée de Minerve,2004,CENTRE,YZEURES-SUR-CREUSE,0,2300,2300,
Muséum d'Histoire Naturelle,2004,CENTRE,BLOIS,9110,3166,12276,
Musée de Sologne,2004,CENTRE,ROMORANTIN-LANTHENAY,5691,7473,13164,
Musée d'Art et d'Archéologie,2004,CENTRE,CHATILLON-COLIGNY,474,404,878,
Musée Historique et Archéologique,2004,CENTRE,ORLEANS,4262,0,4262,
Musée des Sciences Naturelles,2004,CENTRE,ORLEANS,7580,64473,72053,
Musée Arthur Rimbaud,2004,CHAMPAGNE-ARDENNES,CHARLEVILLE-MEZIERES,17940,0,17940,
Musée d'Art et d'Histoire,2004,CHAMPAGNE-ARDENNES,LANGRES,13487,1960,15447,
Planétarium/Musée de l'Ancien Collège des Jésuites,2004,CHAMPAGNE-ARDENNES,REIMS,33843,12856,46699,
Musée de la Corse,2004,CORSE,CORTE,44519,8626,53145,
Musée Comtois,2004,FRANCHE-COMTE,BESANCON,65975,0,65975,
Musée-Maison Natale Gustave Courbet,2004,FRANCHE-COMTE,ORNANS,24113,0,24113,
Musée Baron Martin,2004,FRANCHE-COMTE,GRAY,15503,0,15503,
Viséum-Musée de la Lunette,2004,FRANCHE-COMTE,MOREZ HAUTS DE BIENNE,17170,0,17170,
Musée d'Art et d'Histoire,2004,FRANCHE-COMTE,BELFORT,16482,0,16482,
Forge-Musée,2004,FRANCHE-COMTE,ETUEFFONT,1538,0,1538,
Musée Précolombien Edgar Clerc,2004,GUADELOUPE,LE MOULE,0,2479,2479,
Musée Français de la Photographie,2004,ILE-DE-FRANCE,BIEVRES,972,1647,2619,
Musée Municipal Robert Dubois-Corneau,2004,ILE-DE-FRANCE,BRUNOY,477,2549,3026,
Musée Intercommunal d'Etampes,2004,ILE-DE-FRANCE,ETAMPES,933,5468,6401,
Musée Roybet Fould,2004,ILE-DE-FRANCE,COURBEVOIE,0,17567,17567,
Musée d'Art et d'Histoire,2004,ILE-DE-FRANCE,MEUDON,857,10404,11261,
Musée national de céramique de Sèvres,2004,ILE-DE-FRANCE,SEVRES,24367,20726,45093,
Musée René Sordes,2004,ILE-DE-FRANCE,SURESNES,0,1487,1487,
Musée de l'Homme (Muséum National d'Histoire Naturelle),2004,ILE-DE-FRANCE,PARIS,105936,20753,126689,
Maison de Victor Hugo,2004,ILE-DE-FRANCE,PARIS,11958,155713,167671,
Musée National Eugène Delacroix,2004,ILE-DE-FRANCE,PARIS,21071,19151,40222,
Musée de l'Assistance Publique - Hôpitaux de Paris,2004,ILE-DE-FRANCE,PARIS,8272,7480,15752,
Musée des Arts Décoratifs (Union Centrale des Arts Décoratifs),2004,ILE-DE-FRANCE,PARIS,135122,48997,184119,
Musée - Atelier Rodin (Annexe du musée de Paris),2004,ILE-DE-FRANCE,PARIS,318456,214993,533449,
Musée d'Art Moderne de la ville de Paris,2004,ILE-DE-FRANCE,PARIS,29044,68143,97187,
Musée de la Chasse et de la Nature,2004,ILE-DE-FRANCE,PARIS,7861,0,7861,
Musée National des Techniques,2004,ILE-DE-FRANCE,PARIS,215178,0,215178,
Musée des Monnaies et des Médailles,2004,ILE-DE-FRANCE,PARIS,11444,0,11444,
Musée Départemental de l'Ecole de Barbizon,2004,ILE-DE-FRANCE,BARBIZON,20295,1215,21510,
Musée Municipal de Chelles Alfred Bonno,2004,ILE-DE-FRANCE,CHELLES,0,3528,3528,
Maison Natale de Louis Braille,2004,ILE-DE-FRANCE,COUPVRAY,2748,1420,4168,
Musée Henri Chapu,2004,ILE-DE-FRANCE,LE MEE-SUR-SEINE,0,945,945,
Ecomusée,2004,ILE-DE-FRANCE,SAVIGNY-LE-TEMPLE,0,7743,7743,
Musée de l'Air et de l'Espace,2004,ILE-DE-FRANCE,LE BOURGET,145709,50464,196173,
Musée Municipal,2004,ILE-DE-FRANCE,LIVRY-GARGAN,0,12866,12866,
Musée intercommunal d’histoire et d’archéologie de Louvres,2004,ILE-DE-FRANCE,ROISSY-EN-FRANCE,505,0,505,
Musée Victor Aubert,2004,ILE-DE-FRANCE,MAULE,0,1140,1140,
Musée du Jouet Pierre Pinel,2004,ILE-DE-FRANCE,POISSY,17293,3813,21106,
Musée Rambolitrain,2004,ILE-DE-FRANCE,RAMBOUILLET,9802,857,10659,
Muséum Agricole et Industriel Stella Matutina,2004,LA REUNION,PITON-SAINT-LEU,34643,9116,43759,
Musée d'Art et d'Histoire - Ensemble monumental de Narbonne,2004,LANGUEDOC-ROUSSILLON,NARBONNE,293478,0,293478,
Musée Municipal de la Vignasse,2004,LANGUEDOC-ROUSSILLON,BEAUCAIRE,473,3259,3732,
Musée du Vieux Nîmes,2004,LANGUEDOC-ROUSSILLON,NIMES,0,13892,13892,
Musée Archéologique,2004,LANGUEDOC-ROUSSILLON,NIMES,0,25338,25338,
Musée des Vallées Cévenoles,2004,LANGUEDOC-ROUSSILLON,SAINT-JEAN DU GARD,13900,0,13900,
Musée Agathois,2004,LANGUEDOC-ROUSSILLON,AGDE,4993,0,4993,
Musée de l'Ephèbe,2004,LANGUEDOC-ROUSSILLON,LE CAP D'AGDE,13270,0,13270,
Musée Archéologique,2004,LANGUEDOC-ROUSSILLON,MINERVE,5886,0,5886,
Musée de Préhistoire Régionale et du Mégalithisme,2004,LANGUEDOC-ROUSSILLON,SAINT-PONS-DE-THOMIERES,1885,0,1885,
Ecomusée du Mont Lozère,2004,LANGUEDOC-ROUSSILLON,LE PONT DE MONTVERT,3005,2173,5178,
Musée du Président Jacques Chirac,2004,LIMOUSIN,SARRAN,33926,0,33926,
Musée du Pays d'Ussel,2004,LIMOUSIN,USSEL,0,2708,2708,
Musée du Château de Montaigu,2004,LORRAINE,LANEUVEVILLE-DEVANT-NANCY,438,0,438,
"Musée ""au Fil du Papier""",2004,LORRAINE,PONT-A-MOUSSON,3521,2313,5834,
Musée Départemental du Sel,2004,LORRAINE,MARSAL,4948,4539,9487,
"Jardin d'Hiver, Musée de La Faïence",2004,LORRAINE,SARREGUEMINES,9259,5132,14391,
La Tour aux Puces - Musée du Pays Thionvillois,2004,LORRAINE,THIONVILLE,2878,5714,8592,
Musée de la Lutherie et de l'Archèterie Française,2004,LORRAINE,MIRECOURT,6335,1652,7987,
Musée Pierre Noël - Musée de la Vie dans les Hautes-Vosges,2004,LORRAINE,SAINT-DIE-DES-VOSGES,10776,9776,20552,
Musée du Textile et du Peigne en Corne,2004,MIDI-PYRENEES,LAVELANET,1623,225,1848,
Musée de la Préhistoire,2004,MIDI-PYRENEES,LE MAS D'AZIL,13670,0,13670,
Musée Fenaille,2004,MIDI-PYRENEES,RODEZ,9023,11302,20325,
Musée Georges Labit,2004,MIDI-PYRENEES,TOULOUSE,6930,16769,23699,
Musée Henri Martin,2004,MIDI-PYRENEES,CAHORS,3566,8980,12546,
Musée Jean Jaurès,2004,MIDI-PYRENEES,CASTRES,1458,6650,8108,
Musée du Pays Vaurais,2004,MIDI-PYRENEES,LAVAUR,6679,2235,8914,
Musée du Vieil Auvillar,2004,MIDI-PYRENEES,AUVILLAR,2018,356,2374,
Musée du Dessin et de l'Estampe Originale,2004,NORD-PAS-DE-CALAIS,GRAVELINES,2361,11311,13672,
Musée Départemental Matisse,2004,NORD-PAS-DE-CALAIS,LE CATEAU-CAMBRESIS,35043,44097,79140,
"Musée de la Mine, Centre Historique Minier",2004,NORD-PAS-DE-CALAIS,LEWARDE,138734,11101,149835,
Musée de l'Hospice Comtesse,2004,NORD-PAS-DE-CALAIS,LILLE,82680,102932,185612,
Musée d'Histoire Naturelle et de Géologie,2004,NORD-PAS-DE-CALAIS,LILLE,55958,0,55958,
Musée d'Art et d'Industrie,2004,NORD-PAS-DE-CALAIS,TOURCOING,0,22096,22096,
Musée Municipal Bruno Danvin,2004,NORD-PAS-DE-CALAIS,SAINT-POL-SUR-TERNOISE,0,1894,1894,
Musée du Débarquement,2004,BASSE-NORMANDIE,ARROMANCHES,400044,14534,414578,
Musée Langlois,2004,BASSE-NORMANDIE,BEAUMONT-EN-AUGE,230,0,230,
Musée de la Bataille de Tilly-Sur-Seulles 1944,2004,BASSE-NORMANDIE,TILLY-SUR-SEULLES,1101,0,1101,
Musée Municipal d'Avranches,2004,BASSE-NORMANDIE,AVRANCHES,5787,0,5787,
"Musée du Bocage Normand, ferme du bois Jugan",2004,BASSE-NORMANDIE,SAINT-LO,1385,1643,3028,
Musée Barbey d'Aurevilly,2004,BASSE-NORMANDIE,SAINT-SAUVEUR-LE-VICOMTE,833,596,1429,
Musée du Château,2004,BASSE-NORMANDIE,TORIGNI-SUR-VIRE,123,200,323,
Château-Musée de Dieppe,2004,HAUTE-NORMANDIE,DIEPPE,33744,10351,44095,
Musée d'Elbeuf,2004,HAUTE-NORMANDIE,ELBEUF,0,6822,6822,
Musée des Arts & de l'Enfance,2004,HAUTE-NORMANDIE,FECAMP,688,2577,3265,
Musée des Terres-Neuvas et de la Pêche,2004,HAUTE-NORMANDIE,FECAMP,17191,24494,41685,
Muséum d'Histoire Naturelle,2004,HAUTE-NORMANDIE,LE HAVRE,0,27508,27508,
Association de l'Horlogerie Aliermontaise,2004,HAUTE-NORMANDIE,SAINT-NICOLAS-D'ALIERMONT,425,234,659,
Musée Municipal des Ivoires,2004,HAUTE-NORMANDIE,YVETOT,459,327,786,
Musée du Pays de Guérande et de la Porte Saint Michel,2004,PAYS DE LA LOIRE,GUERANDE,20713,3020,23733,
Musée du Vignoble Nantais,2004,PAYS DE LA LOIRE,LE PALLET,3691,1368,5059,
Musée  Départemental Dobrée,2004,PAYS DE LA LOIRE,NANTES,7914,27837,35751,
Galerie David d'Angers,2004,PAYS DE LA LOIRE,ANGERS,6178,16075,22253,
Musée du Textile,2004,PAYS DE LA LOIRE,CHOLET,5980,7312,13292,
Musée Jules-Desbois,2004,PAYS DE LA LOIRE,PARCAY-LES-PINS,885,1972,2857,
Musée Communal Robert Tatin,2004,PAYS DE LA LOIRE,COSSE-LE-VIVIEN,15139,2116,17255,
Musée de la Reine Bérengère,2004,PAYS DE LA LOIRE,LE MANS,4137,2249,6386,
Centre Minier de Faymoreau,2004,PAYS DE LA LOIRE,FAYMOREAU,21060,8208,29268,
Musée Vendéen,2004,PAYS DE LA LOIRE,FONTENAY-LE-COMTE,1299,2744,4043,
Musée La Bourrine du Bois-Juquaud,2004,PAYS DE LA LOIRE,SAINT-HILAIRE-DE-RIEZ,12988,10361,23349,
Musée municipal de Chauny,2004,PICARDIE,CHAUNY,0,1880,1880,
Familistère de Guise,2004,PICARDIE,GUISE,23000,0,23000,
Musée Entomologique,2004,PICARDIE,SAINT-QUENTIN,2205,6617,8822,
Musée Antoine Lecuyer,2004,PICARDIE,SAINT-QUENTIN,3607,6597,10204,
Musée Municipal de Soissons,2004,PICARDIE,SOISSONS,0,21608,21608,
Musée Alexandre Dumas,2004,PICARDIE,VILLERS COTTERETS,754,1448,2202,
Musée de la Figurine Historique,2004,PICARDIE,COMPIEGNE,4241,4742,8983,
Musée Jean Calvin,2004,PICARDIE,NOYON,1795,1018,2813,
Musée Alfred Danicourt,2004,PICARDIE,PERONNE,0,1541,1541,
Musée-Historial de la Grande Guerre,2004,PICARDIE,PERONNE,76961,0,76961,
Musée de la Mytiliculture,2004,POITOU-CHARENTES,ESNANDES,4212,73,4285,
Musée Napoléonien et Africain,2004,POITOU-CHARENTES,ILE D'AIX,13914,23176,37090,
Musée des Beaux-Arts,2004,POITOU-CHARENTES,LA ROCHELLE,8493,0,8493,
Musée Cappon,2004,POITOU-CHARENTES,MARANS,372,4,376,
Musée National de la Marine,2004,POITOU-CHARENTES,ROCHEFORT,21920,9701,31621,
Musée de l'Echevinage,2004,POITOU-CHARENTES,SAINTES,949,3907,4856,
Musée Municipal des Cordeliers,2004,POITOU-CHARENTES,SAINT-JEAN-D'ANGELY,1878,1906,3784,
Musée Ernest Cognacq,2004,POITOU-CHARENTES,SAINT-MARTIN-DE-RE,9853,0,9853,
Musée des Tumulus de Bougon,2004,POITOU-CHARENTES,BOUGON,31299,0,31299,
Musée de Bressuire,2004,POITOU-CHARENTES,BRESSUIRE,0,3445,3445,
Musée des Ruralies,2004,POITOU-CHARENTES,PRAHECQ,7000,0,7000,
"Musée de la Moto, de l'Automobile et du Vélo",2004,POITOU-CHARENTES,CHATELLERAULT,12277,0,12277,
Musée Charbonneau-Lassay,2004,POITOU-CHARENTES,LOUDUN,433,0,433,
Musée de la vallée,2004,PROVENCE-ALPES-CÔTE D'AZUR,BARCELONNETTE,15682,0,15682,
Musée de la Faïence,2004,PROVENCE-ALPES-CÔTE D'AZUR,MOUSTIERS-SAINTE-MARIE,11023,0,11023,
Musée du Vieux Sisteron,2004,PROVENCE-ALPES-CÔTE D'AZUR,SISTERON,0,667,667,
Musée Picasso,2004,PROVENCE-ALPES-CÔTE D'AZUR,ANTIBES,133458,0,133458,
Musée des Beaux-Arts Jules Chéret,2004,PROVENCE-ALPES-CÔTE D'AZUR,NICE,22483,29984,52467,
Musées de la Citadelle,2004,PROVENCE-ALPES-CÔTE D'AZUR,VILLEFRANCHE-SUR-MER,0,47181,47181,
Musée du Parlement de Provence et du Vieil Aix,2004,PROVENCE-ALPES-CÔTE D'AZUR,AIX-EN-PROVENCE,12409,0,12409,
Musée- Atelier de Paul Cézanne,2004,PROVENCE-ALPES-CÔTE D'AZUR,AIX-EN-PROVENCE,73817,0,73817,
Muséon Arlaten,2004,PROVENCE-ALPES-CÔTE D'AZUR,ARLES,18038,15141,33179,
Musée Réattu,2004,PROVENCE-ALPES-CÔTE D'AZUR,ARLES,15643,14294,29937,
Musée des Beaux-Arts de Marseille,2004,PROVENCE-ALPES-CÔTE D'AZUR,MARSEILLE,27972,0,27972,
Musée d'Histoire de Marseille,2004,PROVENCE-ALPES-CÔTE D'AZUR,MARSEILLE,35617,0,35617,
Musée Baroncelli,2004,PROVENCE-ALPES-CÔTE D'AZUR,SAINTES-MARIES-DE-LA-MER,751,0,751,
Musée Municipal,2004,PROVENCE-ALPES-CÔTE D'AZUR,DRAGUIGNAN,0,10700,10700,
Musée d'Apt,2004,PROVENCE-ALPES-CÔTE D'AZUR,APT,4478,0,4478,
Musée du Petit Palais,2004,PROVENCE-ALPES-CÔTE D'AZUR,AVIGNON,20386,14287,34673,
Musée Municipal,2004,PROVENCE-ALPES-CÔTE D'AZUR,SAULT,0,1253,1253,
Musée du Brou,2004,RHONE-ALPES,BOURG-EN-BRESSE,57103,14353,71456,
Musée du Bugey-Valmorey,2004,RHONE-ALPES,LOCHIEU,3956,0,3956,
Musée du Vieux Pérouges,2004,RHONE-ALPES,PEROUGES,17635,0,17635,
Musée Vivarois César Filhol,2004,RHONE-ALPES,ANNONAY,1692,0,1692,
Musée des Beaux-Arts,2004,RHONE-ALPES,VALENCE,12744,6914,19658,
Musée-château d'Annecy,2004,RHONE-ALPES,ANNECY,89676,0,89676,
Musée Alpin,2004,RHONE-ALPES,CHAMONIX,19968,6138,26106,
Musée de Bourgoin-Jallieu,2004,RHONE-ALPES,BOURGOIN-JALLIEU,12725,0,12725,
Muséum d'Histoire Naturelle de Grenoble,2004,RHONE-ALPES,GRENOBLE,16231,62495,78726,
Musée-Cloître Saint-André-Le-Bas,2004,RHONE-ALPES,VIENNE,3711,4163,7874,
Musée Lapidaire Saint-Pierre,2004,RHONE-ALPES,VIENNE,2222,4132,6354,
Atelier - Musée du Chapeau,2004,RHONE-ALPES,CHAZELLES-SUR-LYON,17687,0,17687,
Musée des Beaux-Arts et d'Archéologie J. Dechelette,2004,RHONE-ALPES,ROANNE,15023,0,15023,
Musée Folklorique du Vieux Saint-Etienne,2004,RHONE-ALPES,SAINT-ETIENNE,598,0,598,
Musée de la Mine / Site Couriot,2004,RHONE-ALPES,SAINT-ETIENNE,51944,0,51944,
Musée Folklorique et Traditions Populaires Marius Audin,2004,RHONE-ALPES,BEAUJEU,4070,605,4675,
Musée Historique des Tissus,2004,RHONE-ALPES,LYON,59395,20138,79533,
Musée Municipal d'Albertville-Conflans,2004,RHONE-ALPES,ALBERTVILLE,6191,0,6191,
Musée des Beaux-Arts,2004,RHONE-ALPES,CHAMBERY,1666,6780,8446,
Musée de l'Académie de La Val d'Isère,2004,RHONE-ALPES,MOÛTIERS,203,168,371,
Musée Historique,2005,ALSACE,HAGUENAU,5606,0,5606,
Maison de l'Archéologie des Vosges du Nord,2005,ALSACE,NIEDERBRONN-LES-BAINS,1736,542,2278,
Musée du Fer,2005,ALSACE,REICHSHOFFEN,1003,126,1129,
Musée Alsacien,2005,ALSACE,STRASBOURG,21330,29530,50860,
Musée des Beaux-Arts,2005,ALSACE,STRASBOURG,18542,31464,50006,
Musée Bartholdi,2005,ALSACE,COLMAR,7175,4365,11540,
Musée du Florival,2005,ALSACE,GUEBWILLER,2054,3026,5080,
Musée des Arts et Traditions Populaires du Périgord,2005,AQUITAINE,MUSSIDAN,756,629,1385,
CAPC Musée d'Art Contemporain de Bordeaux,2005,AQUITAINE,BORDEAUX,12870,74553,87423,
Musée d'Art et d'Histoire du Cap de Gascogne,2005,AQUITAINE,SAINT-SEVER,0,1700,1700,
Musée de la Faïence et des arts de la table,2005,AQUITAINE,SAMADET,5651,2022,7673,
Musée Municipal Albert Marzelles,2005,AQUITAINE,MARMANDE,0,9001,9001,
Musée du Château Henri IV,2005,AQUITAINE,NERAC,15656,3868,19524,
Musée National du Château,2005,AQUITAINE,PAU,57717,41846,99563,
Musée Municipal des Beaux-Arts,2005,AQUITAINE,PAU,10590,12943,23533,
Musée Bernadotte,2005,AQUITAINE,PAU,3756,0,3756,
Musée Charles-Louis Philippe,2005,AUVERGNE,CERILLY,254,0,254,
Musée des Arts D'Afrique et D'Asie,2005,AUVERGNE,VICHY,2928,1094,4022,
Musée Crozatier,2005,AUVERGNE,LE PUY-EN-VELAY,10182,10550,20732,
Musée d'Archéologie Bargoin,2005,AUVERGNE,CLERMONT-FERRAND,387,2396,2783,
Musée des Peintres de l'Ecole de Murols,2005,AUVERGNE,MUROL,4315,92,4407,
Musée Francisque Mandet,2005,AUVERGNE,RIOM,2758,8002,10760,
Musée Régional d'Auvergne,2005,AUVERGNE,RIOM,896,885,1781,
Musée Bonaparte,2005,BOURGOGNE,AUXONNE,0,2914,2914,
Musée du Pays Châtillonnais - Trésor de Vix,2005,BOURGOGNE,CHATILLON-SUR-SEINE,14328,8808,23136,
Musée d'Art Sacré,2005,BOURGOGNE,DIJON,0,6412,6412,
Musée Buffon,2005,BOURGOGNE,MONTBARD,2042,4607,6649,
Musée Municipal,2005,BOURGOGNE,SEMUR-EN-AUXOIS,1665,2460,4125,
Musée d'Art et d'Histoire Romain Rolland,2005,BOURGOGNE,CLAMECY,1875,3687,5562,
Musée Municipal,2005,BOURGOGNE,LA CHARITE-SUR-LOIRE,349,0,349,
Musée Nicéphore Niepce,2005,BOURGOGNE,CHALON-SUR-SAONE,5809,13220,19029,
Ecomusée de la Communauté Le Creusot-Monceau-Les-Mines,2005,BOURGOGNE,LE CREUSOT,13847,6360,20207,
"L'Atelier d'un Journal"" de Louhans - Musée Municipal",2005,BOURGOGNE,LOUHANS,1930,369,2299,
Musée Lamartine,2005,BOURGOGNE,MACON,1469,1965,3434,
Musée Eucharistique du Hiéron,2005,BOURGOGNE,PARAY-LE-MONIAL,1895,3179,5074,
Le Port-Musée,2005,BRETAGNE,DOUARNENEZ,36735,10300,47035,
Musée de Morlaix,2005,BRETAGNE,MORLAIX,8068,14235,22303,
Musée Départemental Breton,2005,BRETAGNE,QUIMPER,21969,16704,38673,
Ecomusée du Pays de Rennes,2005,BRETAGNE,RENNES,16094,19955,36049,
Musée International du Long-Cours Cap-Hornier,2005,BRETAGNE,SAINT-MALO,7720,2580,10300,
Ecomusée de l'Île de Groix,2005,BRETAGNE,ILE DE GROIX,8543,1117,9660,
Musée National de la Marine,2005,BRETAGNE,PORT-LOUIS,37935,17577,55512,
Musée de la Résistance Bretonne,2005,BRETAGNE,SAINT-MARCEL - MALESTROIT,26604,3558,30162,
Musée d'Histoire et d'Archéologie de Vannes,2005,BRETAGNE,VANNES,4985,3310,8295,
Musée du Château Charles VII,2005,CENTRE,MEHUN-SUR-YEVRE,8615,0,8615,
Conservatoire du Machinisme et des Pratiques Agricoles,2005,CENTRE,CHARTRES-MAINVILLIERS,16969,34031,51000,
Musées de Châteauroux - Hôtel Bertrand,2005,CENTRE,CHATEAUROUX,0,14635,14635,
Musée George Sand et de la Vallée Noire,2005,CENTRE,LA CHATRE,3667,1623,5290,
Musée des Beaux-Arts,2005,CENTRE,TOURS,19226,27440,46666,
Musée de Minerve,2005,CENTRE,YZEURES-SUR-CREUSE,0,2340,2340,
Musée Historique et Archéologique,2005,CENTRE,ORLEANS,760,2703,3463,
Musée de la Résistance,2005,CHAMPAGNE-ARDENNES,MUSSY-SUR-SEINE,101,55,156,
Maison de l'Outil  et de la Pensée Ouvrière,2005,CHAMPAGNE-ARDENNES,TROYES,17060,10848,27908,
Pharmacie Musée de l'Hôtel-Dieu,2005,CHAMPAGNE-ARDENNES,TROYES,2526,2329,4855,
Muséum de Besançon,2005,FRANCHE-COMTE,BESANCON,257342,0,257342,
Musée de la résistance et de la Déportation,2005,FRANCHE-COMTE,BESANCON,66911,0,66911,
Musée du Temps,2005,FRANCHE-COMTE,BESANCON,58481,0,58481,
Musée de la Tour des Echevins,2005,FRANCHE-COMTE,LUXEUIL-LES-BAINS,1128,1794,2922,
Musée Georges Garret,2005,FRANCHE-COMTE,VESOUL,0,3647,3647,
Musée Municipal d'Archéologie,2005,FRANCHE-COMTE,CHAMPAGNOLE,296,34,330,
Musée d'Art et d'Histoire,2005,FRANCHE-COMTE,BELFORT,21719,0,21719,
Musée Intercommunal d'Etampes,2005,ILE-DE-FRANCE,ETAMPES,629,5612,6241,
Musée Roybet Fould,2005,ILE-DE-FRANCE,COURBEVOIE,0,10687,10687,
Musée Français de la Carte à Jouer,2005,ILE-DE-FRANCE,ISSY-LES-MOULINEAUX,5266,12379,17645,
Musée national de céramique de Sèvres,2005,ILE-DE-FRANCE,SEVRES,14215,17109,31324,
Musée National de la Marine,2005,ILE-DE-FRANCE,PARIS,168738,33366,202104,
Musée de l'Armée,2005,ILE-DE-FRANCE,PARIS,1070122,0,1070122,
Musée du Moyen Age-Thermes et Hôtel de Cluny,2005,ILE-DE-FRANCE,PARIS,171942,119040,290982,
Musée Carnavalet-Histoire de Paris,2005,ILE-DE-FRANCE,PARIS,225830,446892,672722,
Musée Bourdelle,2005,ILE-DE-FRANCE,PARIS,9840,28912,38752,
Maison de Balzac,2005,ILE-DE-FRANCE,PARIS,1379,20845,22224,
Musée National Auguste Rodin,2005,ILE-DE-FRANCE,PARIS,337995,256361,594356,
Musée des Arts d'Afrique et d'Océanie - Aquarium,2005,ILE-DE-FRANCE,PARIS,119462,82339,201801,
Musée Bouchard,2005,ILE-DE-FRANCE,PARIS,1408,646,2054,
Musée National d'Art Moderne (Centre National d'Art et de Culture Georges Pompidou),2005,ILE-DE-FRANCE,PARIS,2327336,0,2327336,
Musée des Monnaies et des Médailles,2005,ILE-DE-FRANCE,PARIS,10424,0,10424,
Musée Départemental de l'Ecole de Barbizon - Auberge Ganne,2005,ILE-DE-FRANCE,BARBIZON,21590,2639,24229,
Musée Municipal de Chelles Alfred Bonno,2005,ILE-DE-FRANCE,CHELLES,0,1899,1899,
Musée du Château de Fontainebleau,2005,ILE-DE-FRANCE,FONTAINEBLEAU,212365,104353,316718,
Musée de Saint-Maur - Villa Médicis,2005,ILE-DE-FRANCE,LA VARENNE-SAINT-HILAIRE,0,10494,10494,
Musée Archéologique du Val d'Oise,2005,ILE-DE-FRANCE,GUIRY-EN-VEXIN,10157,1715,11872,
Musée d'Art et d'Histoire Louis Senlecq,2005,ILE-DE-FRANCE,L'ISLE-ADAM,2016,12064,14080,
Musée de la Toile de Jouy,2005,ILE-DE-FRANCE,JOUY-EN-JOSAS,9781,1060,10841,
Musée de la Ville,2005,ILE-DE-FRANCE,MONTIGNY LE BRETONNEUX,7630,3131,10761,
Musée Lambinet,2005,ILE-DE-FRANCE,VERSAILLES,9960,1446,11406,
Musée Albert André,2005,LANGUEDOC-ROUSSILLON,BAGNOLS-SUR-CEZE,1491,1298,2789,
Musée Léon Alègre,2005,LANGUEDOC-ROUSSILLON,BAGNOLS-SUR-CEZE,275,325,600,
Musée des Cultures Taurines (Annexe Musée du Vieux Nîmes),2005,LANGUEDOC-ROUSSILLON,NIMES,636,8295,8931,
Musée Archéologique,2005,LANGUEDOC-ROUSSILLON,NIMES,0,24530,24530,
Musée des Beaux-Arts,2005,LANGUEDOC-ROUSSILLON,NIMES,5940,7149,13089,
Musée Municipal Georges Borias,2005,LANGUEDOC-ROUSSILLON,UZES,987,1112,2099,
Musée Pierre de Luxembourg,2005,LANGUEDOC-ROUSSILLON,VILLENEUVE-LES-AVIGNON,4171,2859,7030,
Musée Agathois,2005,LANGUEDOC-ROUSSILLON,AGDE,3015,2021,5036,
Musée de l'Etang de Thau,2005,LANGUEDOC-ROUSSILLON,BOUZIGUES,17170,0,17170,
Musée Municipal,2005,LANGUEDOC-ROUSSILLON,FRONTIGNAN-LA-PEYRADE,0,7500,7500,
Musée de Cerdagne,2005,LANGUEDOC-ROUSSILLON,SAINTE-LEOCADIE,2236,983,3219,
Musée du Président Jacques Chirac,2005,LIMOUSIN,SARRAN,35135,0,35135,
Musée National Adrien Dubouché,2005,LIMOUSIN,LIMOGES,11302,8757,20059,
Musée Départemental d'Art Contemporain,2005,LIMOUSIN,ROCHECHOUART,7967,4607,12574,
Musée de la Céramique et de l'Ivoire,2005,LORRAINE,COMMERCY,2836,1231,4067,
Musée Départemental Raymond Poincaré,2005,LORRAINE,SAMPIGNY,200,538,738,
Musée Militaire et Erckmann-Chatrian,2005,LORRAINE,PHALSBOURG,745,28,773,
Musée du Pays de Sarrebourg,2005,LORRAINE,SARREBOURG,4227,5567,9794,
Musée de La Canne,2005,MARTINIQUE,LES TROIS ILETS,25479,3988,29467,
Musée du Textile et du Peigne en Corne,2005,MIDI-PYRENEES,LAVELANET,2342,0,2342,
Musée Joseph Vaylet,2005,MIDI-PYRENEES,ESPALION,3173,439,3612,
Musée Fenaille,2005,MIDI-PYRENEES,RODEZ,9323,12906,22229,
Musée Campanaire,2005,MIDI-PYRENEES,L'ISLE JOURDAIN,12749,1926,14675,
Musée Municipal d'Art et d'Histoire,2005,MIDI-PYRENEES,SAINT-GAUDENS,658,481,1139,
"Les Abattoirs, Musée d'Art Moderne et Contemporain",2005,MIDI-PYRENEES,TOULOUSE,23323,90985,114308,
Musée Georges Labit,2005,MIDI-PYRENEES,TOULOUSE,6165,16368,22533,
Musée Municipal - Musée Trésor,2005,MIDI-PYRENEES,LUZ-SAINT-SAUVEUR,985,0,985,
Musée Champollion,2005,MIDI-PYRENEES,FIGEAC,12884,90,12974,
Musée Raymond Lafage,2005,MIDI-PYRENEES,LISLE-SUR-TARN,577,793,1370,
Musée Théodore Calbet,2005,MIDI-PYRENEES,GRISOLLES,0,3150,3150,
Musée de Préhistoire,2005,MIDI-PYRENEES,SAINT-ANTONIN-NOBLE-VAL,990,0,990,
Musée du Mont-de-Piété,2005,NORD-PAS-DE-CALAIS,BERGUES,2117,0,2117,
Musée de la Chartreuse,2005,NORD-PAS-DE-CALAIS,DOUAI,7752,20818,28570,
Lieu d'Art et Action Contemporaine de Dunkerque - LAAC,2005,NORD-PAS-DE-CALAIS,DUNKERQUE,23900,0,23900,
Musée du Dessin et de l'Estampe Originale,2005,NORD-PAS-DE-CALAIS,GRAVELINES,7903,0,7903,
Musée Départemental Matisse,2005,NORD-PAS-DE-CALAIS,LE CATEAU-CAMBRESIS,34417,47371,81788,
Musée d'Art et d'Industrie,2005,NORD-PAS-DE-CALAIS,TOURCOING,0,18553,18553,
Château musée,2005,NORD-PAS-DE-CALAIS,BOULOGNE-SUR-MER,18294,9382,27676,
Musée des Beaux-Arts et de la Dentelle,2005,NORD-PAS-DE-CALAIS,CALAIS,19580,8245,27825,
Musée Municipal,2005,NORD-PAS-DE-CALAIS,LE TOUQUET-PARIS-PLAGE,10028,3462,13490,
Musée Jean-Charles Cazin,2005,NORD-PAS-DE-CALAIS,SAMER,0,560,560,
Musée Baron Gérard,2005,BASSE-NORMANDIE,BAYEUX,1295,13372,14667,
Musée de la Poste et des Techniques de communication,2005,BASSE-NORMANDIE,CAEN,3660,3819,7479,
Musée de Normandie,2005,BASSE-NORMANDIE,CAEN,125003,0,125003,
Musée d'Initiation à la Nature,2005,BASSE-NORMANDIE,CAEN,0,8206,8206,
Musée Eugène Boudin,2005,BASSE-NORMANDIE,HONFLEUR,28283,2492,30775,
Musée Municipal,2005,BASSE-NORMANDIE,ORBEC,0,2338,2338,
Musée de la Pomme et de la Poire,2005,BASSE-NORMANDIE,BARENTON,2059,870,2929,
Musée des Beaux-Arts,2005,BASSE-NORMANDIE,SAINT-LO,4951,0,4951,
Musée Barbey d'Aurevilly,2005,BASSE-NORMANDIE,SAINT-SAUVEUR-LE-VICOMTE,722,851,1573,
Musée Maritime de l'Ile de Tatihou,2005,BASSE-NORMANDIE,SAINT-VAAST-LA-HOUGUE,52445,0,52445,
Musée du Château,2005,BASSE-NORMANDIE,TORIGNI-SUR-VIRE,1200,0,1200,
Musée Régional du Cidre et du Calvados,2005,BASSE-NORMANDIE,VALOGNES,4830,0,4830,
Musée du Château de Flers,2005,BASSE-NORMANDIE,FLERS,2351,3013,5364,
Musée Départemental d'Art Sacré,2005,BASSE-NORMANDIE,SEES,801,0,801,
Musée Alphonse-Georges Poulain,2005,HAUTE-NORMANDIE,VERNON,4487,5425,9912,
Pavillon Flaubert,2005,HAUTE-NORMANDIE,CANTELEU,401,372,773,
Château-Musée de Dieppe,2005,HAUTE-NORMANDIE,DIEPPE,37335,12338,49673,
Musée d'Art Moderne André Malraux - MuMa,2005,HAUTE-NORMANDIE,LE HAVRE,72994,28675,101669,
Musée Mathon-Durand,2005,HAUTE-NORMANDIE,NEUFCHATEL-EN-BRAY,555,1358,1913,
Musée Flaubert et d'Histoire de la Médecine,2005,HAUTE-NORMANDIE,ROUEN,1996,4842,6838,
Musée Victor Hugo,2005,HAUTE-NORMANDIE,VILLEQUIER,5461,7897,13358,
Musée  Départemental Dobrée,2005,PAYS DE LA LOIRE,NANTES,4710,21500,26210,
Musées du Parc Naturel Régional de Brière,2005,PAYS DE LA LOIRE,SAINT-JOACHIM,2840,218,3058,
Muséum des Sciences Naturelles,2005,PAYS DE LA LOIRE,ANGERS,2780,11107,13887,
Galerie David d'Angers,2005,PAYS DE LA LOIRE,ANGERS,6804,16266,23070,
Musée Joseph Denais,2005,PAYS DE LA LOIRE,BEAUFORT-EN-VALLEE,2863,3487,6350,
Musée Jules-Desbois,2005,PAYS DE LA LOIRE,PARCAY-LES-PINS,1578,1652,3230,
Musée Archéologique Départemental de Jublains,2005,PAYS DE LA LOIRE,JUBLAINS,10993,22575,33568,
Musée du Vieux Château,2005,PAYS DE LA LOIRE,LAVAL,4380,12109,16489,
Musée des Sciences - CCSTI,2005,PAYS DE LA LOIRE,LAVAL,10291,12976,23267,
Musée Vendéen,2005,PAYS DE LA LOIRE,FONTENAY-LE-COMTE,1515,4032,5547,
Musée des Traditions de l'Île,2005,PAYS DE LA LOIRE,LA GUERINIERE,4579,181,4760,
Musée Municipal,2005,PAYS DE LA LOIRE,LA ROCHE-SUR-YON,0,8799,8799,
Musée Jean de la Fontaine,2005,PICARDIE,CHATEAU-THIERRY,7057,3676,10733,
Musée de La Thiérache,2005,PICARDIE,VERVINS,0,6000,6000,
Musée Alexandre Dumas,2005,PICARDIE,VILLERS COTTERETS,608,1096,1704,
Musée Gallé-Juillet,2005,PICARDIE,CREIL,2443,2118,4561,
Musée de l'Archerie et de l'Art Sacré,2005,PICARDIE,CREPY-EN-VALOIS,3810,1832,5642,
Musée Napoléonien et Africain,2005,POITOU-CHARENTES,ILE D'AIX,20848,20953,41801,
Musée National de la Marine,2005,POITOU-CHARENTES,ROCHEFORT,14680,6484,21164,
Musée du Présidial,2005,POITOU-CHARENTES,SAINTES,515,2462,2977,
Musée Dupuy-Mestreau,2005,POITOU-CHARENTES,SAINTES,772,2576,3348,
Musée des Ruralies- Conservatoire du Machinisme et des Pratiques Agricoles,2005,POITOU-CHARENTES,PRAHECQ,8099,153,8252,
Musée des Traditions Populaires et d'Archéologie,2005,POITOU-CHARENTES,CHAUVIGNY,5528,5277,10805,
Musée de la vallée,2005,PROVENCE-ALPES-CÔTE D'AZUR,BARCELONNETTE,12328,2634,14962,
Musée archéologique,2005,PROVENCE-ALPES-CÔTE D'AZUR,VACHERES,1126,246,1372,
Musée-Château de Cagnes,2005,PROVENCE-ALPES-CÔTE D'AZUR,CAGNES-SUR-MER,18332,15240,33572,
Musée Départemental des Merveilles,2005,PROVENCE-ALPES-CÔTE D'AZUR,TENDE,15120,8240,23360,
Musée du Pavillon de Vendôme,2005,PROVENCE-ALPES-CÔTE D'AZUR,AIX-EN-PROVENCE,5792,9301,15093,
Musée Paul Arbaud,2005,PROVENCE-ALPES-CÔTE D'AZUR,AIX-EN-PROVENCE,1261,0,1261,
Musée du Vieux Marseille,2005,PROVENCE-ALPES-CÔTE D'AZUR,MARSEILLE,2377,9630,12007,
Musée Grobet-Labadié,2005,PROVENCE-ALPES-CÔTE D'AZUR,MARSEILLE,2125,7780,9905,
Musée Municipal Paul Lafran,2005,PROVENCE-ALPES-CÔTE D'AZUR,SAINT-CHAMAS,0,2791,2791,
Musée des A.T.P. de Moyenne Provence,2005,PROVENCE-ALPES-CÔTE D'AZUR,DRAGUIGNAN,9845,5024,14869,
Musée Jean Aicard,2005,PROVENCE-ALPES-CÔTE D'AZUR,LE POUVEREL LA GARDE,0,2623,2623,
Muséum d'Histoire Naturelle Esprit Requien,2005,PROVENCE-ALPES-CÔTE D'AZUR,AVIGNON,0,14678,14678,
Musée Comtadin-Duplessis,2005,PROVENCE-ALPES-CÔTE D'AZUR,CARPENTRAS,1196,1222,2418,
Musée Municipal,2005,PROVENCE-ALPES-CÔTE D'AZUR,SAULT,0,943,943,
Musée Départemental du Cartonnage et de l'Imprimerie,2005,PROVENCE-ALPES-CÔTE D'AZUR,VALREAS,2061,1466,3527,
Musée de la Résistance et de la Déportation de l'Ain,2005,RHONE-ALPES,NANTUA,7743,689,8432,
Musée du Peigne et de la Plasturgie,2005,RHONE-ALPES,OYONNAX,2396,1813,4209,
Musée Chintreuil,2005,RHONE-ALPES,PONT-DE-VAUX,6018,635,6653,
Musée de la Bresse - Domaine des Planons,2005,RHONE-ALPES,SAINT-CYR-SUR-MENTHON,17424,3339,20763,
Cité de Préhistoire,2005,RHONE-ALPES,ORGNAC-L'AVEN,121809,0,121809,
Musée et Site Archéologiques,2005,RHONE-ALPES,SOYONS,9053,1650,10703,
Château de Grignan,2005,RHONE-ALPES,GRIGNAN,93281,0,93281,
Musée d'Art Sacré,2005,RHONE-ALPES,MOURS SAINT-EUSEBE,1884,290,2174,
Musée d'Archéologie Tricastine,2005,RHONE-ALPES,SAINT-PAUL-TROIS-CHATEAUX,1724,898,2622,
Musée-château d'Annecy,2005,RHONE-ALPES,ANNECY,41575,46526,88101,
Musée de la Résistance de la Déportation de l'Isère,2005,RHONE-ALPES,GRENOBLE,0,24637,24637,
Musée des Beaux-Arts et d'Archéologie,2005,RHONE-ALPES,VIENNE,1197,2033,3230,
Musée Départemental de la Révolution Française,2005,RHONE-ALPES,VIZILLE,0,54534,54534,
Musée Lucien Mainssieux,2005,RHONE-ALPES,VOIRON,427,172,599,
Musée Alice Taverne,2005,RHONE-ALPES,AMBIERLE,4721,1169,5890,
Musée des Beaux-Arts et d'Archéologie J. Dechelette,2005,RHONE-ALPES,ROANNE,16634,0,16634,
Musée d'Art et d'Industrie,2005,RHONE-ALPES,SAINT-ETIENNE,21074,11467,32541,
Musée d'Art Moderne et Contemporain,2005,RHONE-ALPES,SAINT-ETIENNE,30747,22975,53722,
Musée Folklorique et Traditions Populaires Marius Audin,2005,RHONE-ALPES,BEAUJEU,3275,638,3913,
Musée Historique des Tissus,2005,RHONE-ALPES,LYON,56439,14859,71298,
Musées Gadagne,2005,RHONE-ALPES,LYON,8613,2676,11289,
Musée Paul Dini,2005,RHONE-ALPES,VILLEFRANCHE-SUR-SAONE,13592,2838,16430,
Musée archéologique et minéralogique Pierre Borrione,2005,RHONE-ALPES,AIME-EN-TARENTAISE,1696,0,1696,
Musée de la Folie Marco,2006,ALSACE,BARR,2682,2343,5025,
Musée des Arts Décoratifs,2006,ALSACE,STRASBOURG,18774,31720,50494,
Musée Sundgauvien d'Altkirch,2006,ALSACE,ALTKIRCH,1398,10212,11610,
Musée Bartholdi,2006,ALSACE,COLMAR,6327,3799,10126,
Musée du Florival,2006,ALSACE,GUEBWILLER,3139,1957,5096,
Château de Bourdeilles,2006,AQUITAINE,BOURDEILLES,25000,0,25000,
Musée National de la Préhistoire,2006,AQUITAINE,LES EYZIES-DE-TAYAC,47952,38056,86008,
Musée d'Aquitaine,2006,AQUITAINE,BORDEAUX,11416,90481,101897,
CAPC Musée d'Art Contemporain de Bordeaux,2006,AQUITAINE,BORDEAUX,21789,81589,103378,
Musée des Beaux-Arts,2006,AQUITAINE,BORDEAUX,67107,66799,133906,
Musée Municipal de Gannat,2006,AUVERGNE,GANNAT,813,988,1801,
Musée Anne de Beaujeu,2006,AUVERGNE,MOULINS,4172,4563,8735,
Musée des Sciences,2006,AUVERGNE,AURILLAC,4294,10272,14566,
Musée d'art et d'histoire Alfred Douët,2006,AUVERGNE,SAINT-FLOUR,1725,1510,3235,
Musée de la Dentelle,2006,AUVERGNE,ARLANC,1312,325,1637,
Musée d'Art Roger-Quillot,2006,AUVERGNE,CLERMONT-FERRAND,4187,27314,31501,
Musée du Pays Châtillonnais - Trésor de Vix,2006,BOURGOGNE,CHATILLON-SUR-SEINE,12452,3453,15905,
Musée Municipal,2006,BOURGOGNE,NUITS-SAINT-GEORGES,1091,733,1824,
Musée du Costume,2006,BOURGOGNE,CHATEAU-CHINON,6494,1508,8002,
Musée de la Mine,2006,BOURGOGNE,LA MACHINE,7103,0,7103,
Museum d'Histoire Naturelle Jacques de La Comble,2006,BOURGOGNE,AUTUN,1727,2883,4610,
Musée de la Mine,2006,BOURGOGNE,BLANZY,13693,1670,15363,
Musée Eucharistique du Hiéron,2006,BOURGOGNE,PARAY-LE-MONIAL,4636,4391,9027,
Muséum - Maison de l'Eau,2006,BOURGOGNE,AUXERRE,0,21064,21064,
Musée Zervos - Maison Romain Rolland,2006,BOURGOGNE,VEZELAY,11045,1805,12850,
Musée Villeneuvien,2006,BOURGOGNE,VILLENEUVE-SUR-YONNE,0,8328,8328,
Musée du Château de Dinan,2006,BRETAGNE,DINAN,22598,0,22598,
Musée d'Art et d'Histoire,2006,BRETAGNE,SAINT-BRIEUC,0,41811,41811,
Musée National de la Marine,2006,BRETAGNE,BREST,30790,25871,56661,
Le Port-Musée,2006,BRETAGNE,DOUARNENEZ,36163,10325,46488,
Musée des Phares et Balises,2006,BRETAGNE,OUESSANT,21969,0,21969,
Musée des Beaux-Arts,2006,BRETAGNE,QUIMPER,26184,20438,46622,
Musée de l'Ecole Rurale en Bretagne,2006,BRETAGNE,TREGARVAN,10288,1151,11439,
Ecomusée du Pays de Montfort,2006,BRETAGNE,MONTFORT-SUR-MEU,1918,1876,3794,
Musée de Bretagne,2006,BRETAGNE,RENNES,48277,0,48277,
Ecomusée de l'Île de Groix,2006,BRETAGNE,ILE DE GROIX,6515,1355,7870,
Musée de la Compagnie des Indes,2006,BRETAGNE,PORT-LOUIS,39281,22162,61443,
Musée d'Histoire et d'Archéologie de Vannes,2006,BRETAGNE,VANNES,2561,12594,15155,
Musée Estève,2006,CENTRE,BOURGES,0,17163,17163,
Musée d'Histoire Naturelle Gabriel Foucher,2006,CENTRE,BOURGES,8495,20731,29226,
Musée Emile Chénon,2006,CENTRE,CHATEAUMEILLANT,824,1340,2164,
Musée Municipal,2006,CENTRE,VIERZON,0,3406,3406,
Musées de Châteauroux - Hôtel Bertrand,2006,CENTRE,CHATEAUROUX,0,9303,9303,
Musée Archéologique d'Argentomagus,2006,CENTRE,SAINT-MARCEL,9722,7586,17308,
Musée du Vieux Chinon,2006,CENTRE,CHINON,2241,1051,3292,
Musée de Préhistoire du Grand Pressigny,2006,CENTRE,LE GRAND PRESSIGNY,4863,3904,8767,
Muséum d'Histoire Naturelle,2006,CENTRE,BLOIS,4330,7730,12060,
Musée de Sologne,2006,CENTRE,ROMORANTIN-LANTHENAY,4445,10748,15193,
Château-Musée de Gien,2006,CENTRE,GIEN,16783,2896,19679,
Musée Historique et Archéologique,2006,CENTRE,ORLEANS,718,3279,3997,
Musée de l'Ardenne,2006,CHAMPAGNE-ARDENNES,CHARLEVILLE-MEZIERES,4407,68942,73349,
Musée Paul Dubois-Alfred Boucher,2006,CHAMPAGNE-ARDENNES,NOGENT-SUR-SEINE,473,735,1208,
Musée du Temps,2006,FRANCHE-COMTE,BESANCON,57437,0,57437,
Musée Départemental Albert-et-Félicie Demard - ATP,2006,FRANCHE-COMTE,CHAMPLITTE,7997,10602,18599,
Musée de la Tour des Echevins,2006,FRANCHE-COMTE,LUXEUIL-LES-BAINS,1171,1616,2787,
Musée Georges Garret,2006,FRANCHE-COMTE,VESOUL,0,4265,4265,
Musée d'Archéologie,2006,FRANCHE-COMTE,LONS-LE-SAUNIER,1537,4287,5824,
Musée d'Art et d'Histoire,2006,FRANCHE-COMTE,BELFORT,17348,0,17348,
Musée des Cultures Guyanaises,2006,GUYANE,CAYENNE,0,8524,8524,
Musée Municipal Robert Dubois-Corneau,2006,ILE-DE-FRANCE,BRUNOY,829,3198,4027,
Musée Intercommunal d'Etampes,2006,ILE-DE-FRANCE,ETAMPES,702,6436,7138,
Musée National des Châteaux de Malmaison et de Bois-Préau,2006,ILE-DE-FRANCE,RUEIL-MALMAISON,34509,22938,57447,
Musée National de la Marine,2006,ILE-DE-FRANCE,PARIS,77258,32981,110239,
Maison de Balzac,2006,ILE-DE-FRANCE,PARIS,2359,16747,19106,
Musée de Montmartre,2006,ILE-DE-FRANCE,PARIS,42722,4108,46830,
Musée du Service de Santé des Armées du Val-de-Grâce,2006,ILE-DE-FRANCE,PARIS,11000,0,11000,
Musée du Quai Branly,2006,ILE-DE-FRANCE,PARIS,585311,366759,952070,
Musée Municipal des Capucins,2006,ILE-DE-FRANCE,COULOMMIERS,1607,962,2569,
Musée Bossuet,2006,ILE-DE-FRANCE,MEAUX,5200,3123,8323,
Musée de Provins et du Provinois,2006,ILE-DE-FRANCE,PROVINS,15134,6435,21569,
Musée des Pays de Seine-et-Marne,2006,ILE-DE-FRANCE,SAINT-CYR-SUR-MORIN,2281,4198,6479,
Ecomusée,2006,ILE-DE-FRANCE,SAVIGNY-LE-TEMPLE,211,7161,7372,
Musée de l'Histoire Vivante,2006,ILE-DE-FRANCE,MONTREUIL-SOUS-BOIS,3905,0,3905,
Ecomusée du Val de Bièvre,2006,ILE-DE-FRANCE,FRESNES,0,8919,8919,
Musée de Saint-Maur - Villa Médicis,2006,ILE-DE-FRANCE,LA VARENNE-SAINT-HILAIRE,66,7806,7872,
"MAC VAL, Musée d'Art Contemporain du Val-de-Marne",2006,ILE-DE-FRANCE,VITRY SUR SEINE,35821,71488,107309,
Musée Départemental Maurice Denis,2006,ILE-DE-FRANCE,SAINT-GERMAIN-EN-LAYE,26332,3007,29339,
Muséum d'Histoire Naturelle,2006,LA REUNION,SAINT-DENIS DE LA REUNION,4720,22953,27673,
Musée des Beaux-Arts,2006,LANGUEDOC-ROUSSILLON,CARCASSONNE,0,41781,41781,
Musée Archéologique du Lauragais,2006,LANGUEDOC-ROUSSILLON,CASTELNAUDARY,0,1538,1538,
Musée de l'Etang de Thau,2006,LANGUEDOC-ROUSSILLON,BOUZIGUES,17406,0,17406,
Musée Municipal,2006,LANGUEDOC-ROUSSILLON,FRONTIGNAN-LA-PEYRADE,0,5323,5323,
Musée Fleury,2006,LANGUEDOC-ROUSSILLON,LODEVE,59392,12532,71924,
Agropolis-Muséum,2006,LANGUEDOC-ROUSSILLON,MONTPELLIER,25000,0,25000,
Musée d'Art Moderne - Fonds Peskè,2006,LANGUEDOC-ROUSSILLON,COLLIOURE,4276,1284,5560,
Muséum d'Histoire Naturelle,2006,LANGUEDOC-ROUSSILLON,PERPIGNAN,288,1420,1708,
Musée Hyacinthe Rigaud,2006,LANGUEDOC-ROUSSILLON,PERPIGNAN,3024,2847,5871,
Musée du Château de Lunéville,2006,LORRAINE,LUNEVILLE,0,8072,8072,
Palais des ducs de Lorraine - Musée Historique Lorrain,2006,LORRAINE,NANCY,24983,30924,55907,
Musée d'Argonne,2006,LORRAINE,VARENNES-EN-ARGONNE,2742,0,2742,
Musée Départemental du Sel,2006,LORRAINE,MARSAL,10275,0,10275,
Maison du Verre et du Cristal,2006,LORRAINE,MEISENTHAL,13898,1196,15094,
Musée Départemental de l'Ariège,2006,MIDI-PYRENEES,FOIX,80409,5995,86404,
Musée de la Forge,2006,MIDI-PYRENEES,MONTGAILHARD,26217,2317,28534,
Musée Régional de Géologie Pierre Vetter,2006,MIDI-PYRENEES,DECAZEVILLE,1410,2375,3785,
Musée Municipal de la Vignasse,2006,MIDI-PYRENEES,BEAUCAIRE,560,2636,3196,
Carré d'Art Musée d'Art Contemporain de Nîmes,2006,MIDI-PYRENEES,NIMES,18763,29475,48238,
Musée Paul Raymond,2006,MIDI-PYRENEES,PONT-SAINT-ESPRIT,186,1598,1784,
Musée de l'Armagnac,2006,MIDI-PYRENEES,CONDOM,4792,324,5116,
Musée du Vieux Toulouse,2006,MIDI-PYRENEES,TOULOUSE,12000,0,12000,
Musée Georges Labit,2006,MIDI-PYRENEES,TOULOUSE,5622,16456,22078,
Musée Pyrénéen,2006,MIDI-PYRENEES,LOURDES,62897,3959,66856,
Musée Municipal - Musée Trésor,2006,MIDI-PYRENEES,LUZ-SAINT-SAUVEUR,881,0,881,
Musée Henri Martin,2006,MIDI-PYRENEES,CAHORS,3461,9549,13010,
Musée d'Art et d'Histoire Charles Portal,2006,MIDI-PYRENEES,CORDES-SUR-CIEL,315,307,622,
Musée Théodore Calbet,2006,MIDI-PYRENEES,GRISOLLES,0,889,889,
Musée de Préhistoire,2006,MIDI-PYRENEES,SAINT-ANTONIN-NOBLE-VAL,1530,0,1530,
Lieu d'Art et Action Contemporaine de Dunkerque - LAAC,2006,NORD-PAS-DE-CALAIS,DUNKERQUE,43667,0,43667,
Musée Portuaire,2006,NORD-PAS-DE-CALAIS,DUNKERQUE,33930,21134,55064,
Musée d'Histoire Naturelle et de Géologie,2006,NORD-PAS-DE-CALAIS,LILLE,64850,0,64850,
Musée d'Art et d'Industrie,2006,NORD-PAS-DE-CALAIS,TOURCOING,0,24282,24282,
Musée des Beaux-Arts,2006,NORD-PAS-DE-CALAIS,VALENCIENNES,17779,22304,40083,
Musée des Beaux-Arts,2006,NORD-PAS-DE-CALAIS,ARRAS,9698,18567,28265,
Musée de la Céramique,2006,NORD-PAS-DE-CALAIS,DESVRES,10028,1832,11860,
Musée d'Histoire et d'Archéologie,2006,NORD-PAS-DE-CALAIS,HARNES,0,1120,1120,
Mémorial de Caen,2006,BASSE-NORMANDIE,CAEN,354500,26000,380500,
Musée d'Ethnographie et d'Arts Populaires et Musée de la Marine,2006,BASSE-NORMANDIE,HONFLEUR,16496,1247,17743,
Musée de la Bataille de Tilly-Sur-Seulles 1944,2006,BASSE-NORMANDIE,TILLY-SUR-SEULLES,469,0,469,
Musée et Sites archéologiques de Vieux-la-Romaine,2006,BASSE-NORMANDIE,VIEUX,7126,16818,23944,
Musée Municipal,2006,BASSE-NORMANDIE,VIRE NORMANDIE,508,1354,1862,
Musée de la Pomme et de la Poire,2006,BASSE-NORMANDIE,BARENTON,2132,639,2771,
Musée du Granit,2006,BASSE-NORMANDIE,SAINT-MICHEL-DE-MONTJOIE,2130,94,2224,
Musée Barbey d'Aurevilly,2006,BASSE-NORMANDIE,SAINT-SAUVEUR-LE-VICOMTE,737,406,1143,
Musée Maritime de l'Ile de Tatihou,2006,BASSE-NORMANDIE,SAINT-VAAST-LA-HOUGUE,47000,0,47000,
Musée Municipal - Musée du Jouet,2006,BASSE-NORMANDIE,LA FERTE-MACE,1480,0,1480,
Maison des Templiers,2006,HAUTE-NORMANDIE,CAUDEBEC-EN-CAUX,546,434,980,
Château-Musée de Dieppe,2006,HAUTE-NORMANDIE,DIEPPE,33146,10619,43765,
Musée d'Elbeuf,2006,HAUTE-NORMANDIE,ELBEUF,0,6774,6774,
Musée d'Art Moderne André Malraux - MuMa,2006,HAUTE-NORMANDIE,LE HAVRE,24633,10864,35497,
La Maison de l'Armateur,2006,HAUTE-NORMANDIE,LE HAVRE,1901,2902,4803,
Musée des Traditions et Arts Normands,2006,HAUTE-NORMANDIE,MARTAINVILLE-EPREVILLE,9528,10812,20340,
Musée-Maison Natale Pierre Corneille,2006,HAUTE-NORMANDIE,ROUEN,0,6567,6567,
Musée Municipal des Ivoires,2006,HAUTE-NORMANDIE,YVETOT,903,474,1377,
Musée du Pays de Guérande et de la Porte Saint Michel,2006,PAYS DE LA LOIRE,GUERANDE Cedex,17266,4527,21793,
Musée Jean Lurcat et de la Tapisserie Contemporaine,2006,PAYS DE LA LOIRE,ANGERS,13267,43474,56741,
Musée de la Vigne et du Vin d'Anjou,2006,PAYS DE LA LOIRE,SAINT LAMBERT-DU-LATTAY - VAL-DU-LAYON,4794,1727,6521,
Musée de l'Ardoise,2006,PAYS DE LA LOIRE,TRELAZE,9800,5700,15500,
Musée Archéologique Départemental de Jublains,2006,PAYS DE LA LOIRE,JUBLAINS,9422,23223,32645,
Centre Minier de Faymoreau,2006,PAYS DE LA LOIRE,FAYMOREAU,21693,5399,27092,
Musée des Traditions de l'Île,2006,PAYS DE LA LOIRE,LA GUERINIERE,4288,248,4536,
Musée du Nord de la Vendée,2006,PAYS DE LA LOIRE,MONTAIGU,0,1705,1705,
Musée La Bourrine du Bois-Juquaud,2006,PAYS DE LA LOIRE,SAINT-HILAIRE-DE-RIEZ,10575,12183,22758,
Musée municipal de Chauny,2006,PICARDIE,CHAUNY,0,2550,2550,
Musée de La Thiérache,2006,PICARDIE,VERVINS,0,2752,2752,
Musée du Château de Compiègne,2006,PICARDIE,COMPIEGNE,30238,40810,71048,
Musée du Noyonnais,2006,PICARDIE,NOYON,676,2778,3454,
Musée de l'Hôtel de Berny,2006,PICARDIE,AMIENS,336,139,475,
Musée de la Mytiliculture,2006,POITOU-CHARENTES,ESNANDES,4305,126,4431,
Musée du Nouveau Monde,2006,POITOU-CHARENTES,LA ROCHELLE,10904,0,10904,
Hôtel Hèbre de Saint-Clément - Musée d'Art et d'Histoire,2006,POITOU-CHARENTES,ROCHEFORT,0,4115,4115,
Musée de l'Echevinage,2006,POITOU-CHARENTES,SAINTES,1788,2487,4275,
Musée du Présidial,2006,POITOU-CHARENTES,SAINTES,1211,1241,2452,
Musée Ernest Cognacq,2006,POITOU-CHARENTES,SAINT-MARTIN-DE-RE,1179,1192,2371,
Musée Henri Barré,2006,POITOU-CHARENTES,THOUARS,618,1046,1664,
Musée des Traditions Populaires et d'Archéologie,2006,POITOU-CHARENTES,CHAUVIGNY,9071,0,9071,
Musée d'Histoire Locale,2006,PROVENCE-ALPES-CÔTE D'AZUR,BIOT,3246,4691,7937,
Musée des Tapisseries,2006,PROVENCE-ALPES-CÔTE D'AZUR,AIX-EN-PROVENCE,9557,19421,28978,
Musée Camarguais,2006,PROVENCE-ALPES-CÔTE D'AZUR,ARLES,12223,3907,16130,
Musée des Docks Romains,2006,PROVENCE-ALPES-CÔTE D'AZUR,MARSEILLE,2265,4934,7199,
Muséum d'Histoire Naturelle,2006,PROVENCE-ALPES-CÔTE D'AZUR,MARSEILLE,8998,28079,37077,
Musée Ziem,2006,PROVENCE-ALPES-CÔTE D'AZUR,MARTIGUES,0,8226,8226,
Musée des Arts et d’Histoire,2006,PROVENCE-ALPES-CÔTE D'AZUR,BORMES-LES-MIMOSAS,0,8945,8945,
Musée Municipal,2006,PROVENCE-ALPES-CÔTE D'AZUR,DRAGUIGNAN,0,9595,9595,
Musée Archéologique,2006,PROVENCE-ALPES-CÔTE D'AZUR,SAINT-RAPHAËL,0,9095,9095,
Musée National de la Marine de Toulon,2006,PROVENCE-ALPES-CÔTE D'AZUR,TOULON,12559,18744,31303,
Musée-Bibliothèque François Pétrarque,2006,PROVENCE-ALPES-CÔTE D'AZUR,FONTAINE-DE-VAUCLUSE,2024,1894,3918,
Musée Archéologique,2006,RHONE-ALPES,IZERNORE,330,174,504,
Musée du Peigne et de la Plasturgie,2006,RHONE-ALPES,OYONNAX,2152,1667,3819,
Musée Départemental du Revermont,2006,RHONE-ALPES,VAL-REVERMONT,6358,15360,21718,
Musée du Rhône,2006,RHONE-ALPES,TOURNON-SUR-RHÔNE,5248,4153,9401,
Musée d'Histoire et d'Archéologie,2006,RHONE-ALPES,DIE,867,1376,2243,
Musée-château d'Annecy,2006,RHONE-ALPES,ANNECY,42274,46176,88450,
Musée Alpin,2006,RHONE-ALPES,CHAMONIX,15217,7800,23017,
Musée du Chablais,2006,RHONE-ALPES,THONON-LES-BAINS,1167,1719,2886,
Musée Jadis Allevard,2006,RHONE-ALPES,ALLEVARD-LES-BAINS,1629,3030,4659,
Musée - Parc Archéologique du Lac de Paladru,2006,RHONE-ALPES,CHARAVINES,10747,1378,12125,
Musée Géo-Charles,2006,RHONE-ALPES,ECHIROLLES,0,7823,7823,
Musée de la Résistance de la Déportation de l'Isère,2006,RHONE-ALPES,GRENOBLE,0,22330,22330,
Musée Lucien Mainssieux,2006,RHONE-ALPES,VOIRON,0,1251,1251,
Atelier - Musée du Chapeau,2006,RHONE-ALPES,CHAZELLES-SUR-LYON,12784,2919,15703,
Musée d'Histoire du  20ème Siècle - Résistance et Déportation,2006,RHONE-ALPES,ESTIVAREILLES,2572,625,3197,
Musée d'Allard,2006,RHONE-ALPES,MONTBRISON,2871,3804,6675,
Musée des Beaux-Arts et d'Archéologie J. Dechelette,2006,RHONE-ALPES,ROANNE,3774,10939,14713,
Musée Savoisien,2006,RHONE-ALPES,CHAMBERY,4517,9494,14011,
Musée des Charmettes,2006,RHONE-ALPES,CHAMBERY,0,11520,11520,
Musée Alsacien,2007,ALSACE,HAGUENAU,1440,1490,2930,
Musée de l'Image Populaire de Pfaffenhoffen,2007,ALSACE,PFAFFENHOFFEN,2350,1129,3479,
Musée du Fer,2007,ALSACE,REICHSHOFFEN,889,465,1354,
Musée Archéologique,2007,ALSACE,STRASBOURG,16061,28807,44868,
Musée Zoologique de Strasbourg,2007,ALSACE,STRASBOURG,6920,31928,38848,
Musée des Arts Décoratifs,2007,ALSACE,STRASBOURG,12442,36851,49293,
Musée J.F. Oberlin,2007,ALSACE,WALDERSBACH,20433,4024,24457,
Musée des Beaux-Arts,2007,ALSACE,MULHOUSE,0,14595,14595,
Cité du Train,2007,ALSACE,MULHOUSE,85289,14404,99693,
Musée Vauban,2007,ALSACE,NEUF-BRISACH,3407,1244,4651,
Maison du Sundgau - Musée Paysan,2007,ALSACE,OLTINGUE,1900,528,2428,
Musée du Papier Peint,2007,ALSACE,RIXHEIM,6542,2901,9443,
Musée d'Art et d'Archéologie du Périgord (MAAP),2007,AQUITAINE,PERIGUEUX,4620,19150,23770,
Muséum d'Histoire Naturelle de Bordeaux,2007,AQUITAINE,BORDEAUX,8810,59770,68580,
Musée des Beaux-Arts et d'Archéologie,2007,AQUITAINE,LIBOURNE,0,6750,6750,
Musée Bonnat,2007,AQUITAINE,BAYONNE,14157,14805,28962,
Musée Municipal de Guéthary,2007,AQUITAINE,GUETHARY,593,1263,1856,
Musée Rieckotter,2007,AUVERGNE,NERIS-LES-BAINS,549,511,1060,
Musée des Sciences,2007,AUVERGNE,AURILLAC,5349,9439,14788,
Musée de Paléontologie,2007,AUVERGNE,CHILHAC,1477,0,1477,
Musée Crozatier,2007,AUVERGNE,LE PUY-EN-VELAY,8963,10138,19101,
Musée de la Dentelle,2007,AUVERGNE,ARLANC,1400,106,1506,
Musée des Pénitents Blancs,2007,AUVERGNE,MARSAC-EN-LIVRADOIS,146,0,146,
Musée Paléontologique,2007,AUVERGNE,MENAT,1131,118,1249,
Musée Régional d'Auvergne,2007,AUVERGNE,RIOM,698,1693,2391,
Musée du Pays Châtillonnais - Trésor de Vix,2007,BOURGOGNE,CHATILLON-SUR-SEINE,12585,3020,15605,
Musée Archéologique,2007,BOURGOGNE,DIJON,0,28209,28209,
Musée Buffon,2007,BOURGOGNE,MONTBARD,10887,0,10887,
Musée du Septennat,2007,BOURGOGNE,CHATEAU-CHINON,17231,2608,19839,
Musée du Prieuré de Charolles,2007,BOURGOGNE,CHAROLLES,1269,656,1925,
Musée Eucharistique du Hiéron,2007,BOURGOGNE,PARAY-LE-MONIAL,4055,3214,7269,
Ecomusée de la Bresse Bourguignonne,2007,BOURGOGNE,PIERRE-DE-BRESSE,25329,12297,37626,
Musée Départemental du Compagnonnage,2007,BOURGOGNE,ROMANECHE-THORINS,2229,1716,3945,
Maison du Blé et du Pain,2007,BOURGOGNE,VERDUN-SUR-LE-DOUBS,3000,675,3675,
Muséum - Maison de l'Eau,2007,BOURGOGNE,AUXERRE,0,14356,14356,
Musée Leblanc-Duvernois,2007,BOURGOGNE,AUXERRE,1043,1621,2664,
Musée de l'Avallonnais Jean Després,2007,BOURGOGNE,AVALLON,0,7112,7112,
Musée des Arts Naïfs et Populaires de Noyers sur Serein,2007,BOURGOGNE,NOYERS-SUR-SEREIN,1853,892,2745,
Musée Colette,2007,BOURGOGNE,SAINT-SAUVEUR-EN-PUISAYE,8734,683,9417,
Musée Zervos - Maison Romain Rolland,2007,BOURGOGNE,VEZELAY,9170,2167,11337,
Musée de la Pêche,2007,BRETAGNE,CONCARNEAU,30755,3497,34252,
Musée de Pont-Aven,2007,BRETAGNE,PONT-AVEN,31729,9173,40902,
Musée des Beaux-Arts,2007,BRETAGNE,QUIMPER,47947,31176,79123,
Ecomusée de l'Île de Groix,2007,BRETAGNE,ILE DE GROIX,8024,1496,9520,
Musée du Château de Suscinio,2007,BRETAGNE,SARZEAU,80258,15204,95462,
Musée d'Histoire et d'Archéologie de Vannes,2007,BRETAGNE,VANNES,3027,1441,4468,
Musée Estève,2007,CENTRE,BOURGES,0,15947,15947,
Musée de l'Histoire du Perche,2007,CENTRE,NOGENT-LE-ROTROU,12617,7464,20081,
Musée de la Chemiserie et de l'Elégance Masculine,2007,CENTRE,ARGENTON-SUR-CREUSE,4656,3390,8046,
Musées de Châteauroux - Hôtel Bertrand,2007,CENTRE,CHATEAUROUX,0,20792,20792,
Musée du Savignéen,2007,CENTRE,SAVIGNE-SUR-LATHAN,1829,264,2093,
Musée de la Maison de la Dernière Cartouche,2007,CHAMPAGNE-ARDENNES,BAZEILLES,1670,1277,2947,
Musée de la Résistance,2007,CHAMPAGNE-ARDENNES,MUSSY-SUR-SEINE,105,55,160,
Maison de l'Outil  et de la Pensée Ouvrière,2007,CHAMPAGNE-ARDENNES,TROYES,12777,4524,17301,
Ecomusée de la Montagne de Reims,2007,CHAMPAGNE-ARDENNES,POURCY,341,44,385,
Musée de l'Ancien Collège des Jésuites/Planétarium,2007,CHAMPAGNE-ARDENNES,REIMS,2768,23934,26702,
Musée Palais Fesch,2007,CORSE,AJACCIO,29718,10937,40655,
Musée des Beaux-Arts et d'Archéologie,2007,FRANCHE-COMTE,BESANCON,11936,47350,59286,
Musée de Pontarlier,2007,FRANCHE-COMTE,PONTARLIER,3149,6645,9794,
Musée Départemental Albert-et-Félicie Demard - ATP,2007,FRANCHE-COMTE,CHAMPLITTE,7090,8944,16034,
Musée Baron Martin,2007,FRANCHE-COMTE,GRAY,6312,0,6312,
Musée Sarret de Grozon,2007,FRANCHE-COMTE,ARBOIS,0,254,254,
Musée de la Vigne et du Vin,2007,FRANCHE-COMTE,ARBOIS,3468,876,4344,
Musée Municipal d'Archéologie,2007,FRANCHE-COMTE,CHAMPAGNOLE,219,350,569,
Musée d'Art et d'Histoire,2007,FRANCHE-COMTE,BELFORT,3237,10806,14043,
Donation Maurice Jardot,2007,FRANCHE-COMTE,BELFORT,1201,3160,4361,
Musée Français de la Photographie,2007,ILE-DE-FRANCE,BIEVRES,2948,2836,5784,
Musée d'Art et d'Histoire,2007,ILE-DE-FRANCE,MEUDON,0,10895,10895,
Musée - Atelier Rodin (Annexe du musée de Paris),2007,ILE-DE-FRANCE,MEUDON,4804,4522,9326,
Musée Franco-Suisse,2007,ILE-DE-FRANCE,RUEIL-MALMAISON,463,300,763,
Musée national de céramique de Sèvres,2007,ILE-DE-FRANCE,SEVRES,21460,16284,37744,
Etablissement public de la Porte Dorée - Cité Nationale de l’Histoire de l’Immigration,2007,ILE-DE-FRANCE,PARIS,21904,28130,50034,
Musée de la Franc-Maçonnerie,2007,ILE-DE-FRANCE,PARIS,4586,2300,6886,
Musée des Arts Décoratifs (Union Centrale des Arts Décoratifs),2007,ILE-DE-FRANCE,PARIS,289944,131429,421373,
Musée du Quai Branly,2007,ILE-DE-FRANCE,PARIS,920886,571554,1492440,
Maison Natale de Louis Braille,2007,ILE-DE-FRANCE,COUPVRAY,2800,850,3650,
Musée du Château de Fontainebleau,2007,ILE-DE-FRANCE,FONTAINEBLEAU,239897,144350,384247,
Musée Municipal,2007,ILE-DE-FRANCE,MORET-SUR-LOING,0,7091,7091,
Ecomusée du Val de Bièvre,2007,ILE-DE-FRANCE,FRESNES,0,9831,9831,
Musée de Nogent-Sur-Marne,2007,ILE-DE-FRANCE,NOGENT-SUR-MARNE,0,5785,5785,
Musée Emile Jean,2007,ILE-DE-FRANCE,VILLIERS-SUR-MARNE,0,454,454,
"MAC VAL, Musée d'Art Contemporain du Val-de-Marne",2007,ILE-DE-FRANCE,VITRY SUR SEINE,22587,63634,86221,
Musée de la Renaissance - Château d'Ecouen,2007,ILE-DE-FRANCE,ECOUEN,16988,37557,54545,
Musée de la Toile de Jouy,2007,ILE-DE-FRANCE,JOUY-EN-JOSAS,8711,1348,10059,
Collections de la Fondation de Coubertin,2007,ILE-DE-FRANCE,SAINT-REMY-LES-CHEVREUSE,809,2154,2963,
Muséum d'Histoire Naturelle,2007,LA REUNION,SAINT-DENIS,3814,21892,25706,
Musée du Colombier,2007,LANGUEDOC-ROUSSILLON,ALES,0,12354,12354,
Musée Albert André,2007,LANGUEDOC-ROUSSILLON,BAGNOLS-SUR-CEZE,868,2893,3761,
Musée Archéologique,2007,LANGUEDOC-ROUSSILLON,NIMES,0,43267,43267,
Musée d'Histoire Naturelle et de Préhistoire,2007,LANGUEDOC-ROUSSILLON,NIMES,0,60504,60504,
Musée Paul Raymond,2007,LANGUEDOC-ROUSSILLON,PONT-SAINT-ESPRIT,0,2400,2400,
Musée Agathois,2007,LANGUEDOC-ROUSSILLON,AGDE,1977,3168,5145,
Musée du Biterrois,2007,LANGUEDOC-ROUSSILLON,BEZIERS,2959,11160,14119,
Musée Municipal,2007,LANGUEDOC-ROUSSILLON,FRONTIGNAN-LA-PEYRADE,0,5541,5541,
Musée Fabre,2007,LANGUEDOC-ROUSSILLON,MONTPELLIER,211527,139501,351028,
Ecomusée du Mont Lozère,2007,LANGUEDOC-ROUSSILLON,LE PONT DE MONTVERT,3082,1953,5035,
Musée départemental d'Art Moderne,2007,LANGUEDOC-ROUSSILLON,CERET,54622,25581,80203,
Musée d'Art Moderne - Fonds Peskè,2007,LANGUEDOC-ROUSSILLON,COLLIOURE,19011,5300,24311,
Musée René Baubérot,2007,LIMOUSIN,CHATEAUPONSAC,3883,583,4466,
Musée du Château de Lunéville,2007,LORRAINE,LUNEVILLE,0,7800,7800,
Musée de l'Ecole de Nancy,2007,LORRAINE,NANCY,33295,26211,59506,
Palais des ducs de Lorraine - Musée Historique Lorrain,2007,LORRAINE,NANCY,28850,33952,62802,
"Musée ""au Fil du Papier""",2007,LORRAINE,PONT-A-MOUSSON,4604,4951,9555,
Musée Barrois,2007,LORRAINE,BAR-LE-DUC,3108,6846,9954,
Musée Départemental Raymond Poincaré,2007,LORRAINE,SAMPIGNY,202,253,455,
Musée des Mines de fer de Lorraine,2007,LORRAINE,NEUFCHEF,20354,927,21281,
Moulin de la Blies - Musée des Techniques Faïencières,2007,LORRAINE,SARREGUEMINES,3819,8276,12095,
La Tour aux Puces - Musée du Pays Thionvillois,2007,LORRAINE,THIONVILLE,2563,8316,10879,
Musée Départemental d'Art Ancien et Contemporain,2007,LORRAINE,EPINAL,2635,12754,15389,
Musée Départemental d'Archéologie Précolombienne et de Préhistoire de la Martinique,2007,MARTINIQUE,FORT-DE-FRANCE,5823,1281,7104,
Musée de La Canne,2007,MARTINIQUE,LES TROIS ILETS,16001,2518,18519,
Musée du Textile et du Peigne en Corne,2007,MIDI-PYRENEES,LAVELANET,1320,0,1320,
Musée des Arts et Métiers Traditionnels,2007,MIDI-PYRENEES,SALLES-LA-SOURCE,8040,1168,9208,
Musée de l'Armagnac,2007,MIDI-PYRENEES,CONDOM,4001,247,4248,
Musée Campanaire,2007,MIDI-PYRENEES,L'ISLE JOURDAIN,6061,6696,12757,
Musée des Beaux-Arts et des Arts Décoratifs,2007,MIDI-PYRENEES,MIRANDE,761,101,862,
Musée Municipal d'Art et d'Histoire,2007,MIDI-PYRENEES,SAINT-GAUDENS,303,934,1237,
Musée des Transports et des Communications,2007,MIDI-PYRENEES,TOULOUSE,0,2925,2925,
Musée Municipal,2007,MIDI-PYRENEES,VAYRAC,323,0,323,
Musée du Protestantisme en Haut-Languedoc,2007,MIDI-PYRENEES,FERRIERES,1448,680,2128,
Musée des Beaux-Arts,2007,MIDI-PYRENEES,GAILLAC,1887,1703,3590,
Musée Raymond Lafage,2007,MIDI-PYRENEES,LISLE-SUR-TARN,759,2604,3363,
Musée du Vieil Auvillar,2007,MIDI-PYRENEES,AUVILLAR,2991,288,3279,
Musée Théodore Calbet,2007,MIDI-PYRENEES,GRISOLLES,0,1566,1566,
Musée Ingres,2007,MIDI-PYRENEES,MONTAUBAN,21471,29010,50481,
Musée Théophile Jouglet,2007,NORD-PAS-DE-CALAIS,ANZIN,0,2125,2125,
Musée Municipal d'Escaudain,2007,NORD-PAS-DE-CALAIS,ESCAUDAIN,0,644,644,
Musée Municipal d'Hazebrouck,2007,NORD-PAS-DE-CALAIS,HAZEBROUCK,450,2474,2924,
Musée des Beaux-Arts,2007,NORD-PAS-DE-CALAIS,VALENCIENNES,89681,51062,140743,
Château musée,2007,NORD-PAS-DE-CALAIS,BOULOGNE-SUR-MER,40168,0,40168,
Musée de la Céramique,2007,NORD-PAS-DE-CALAIS,DESVRES,8333,3398,11731,
Musée Langlois,2007,BASSE-NORMANDIE,BEAUMONT-EN-AUGE,489,128,617,
Musée des Beaux-Arts,2007,BASSE-NORMANDIE,CAEN,5415,58723,64138,
Musée Municipal,2007,BASSE-NORMANDIE,ORBEC,1342,1235,2577,
Musée du Vieux Château,2007,BASSE-NORMANDIE,BRICQUEBEC-EN-COTENTIN,614,180,794,
Musée Thomas Henry,2007,BASSE-NORMANDIE,CHERBOURG-EN-COTENTIN,0,18957,18957,
Muséum Emmanuel Liais,2007,BASSE-NORMANDIE,CHERBOURG-EN-COTENTIN,0,22480,22480,
Musée Régional du Cidre et du Calvados,2007,BASSE-NORMANDIE,VALOGNES,3878,657,4535,
Musée du Percheron,2007,BASSE-NORMANDIE,MORTAGNE-AU-PERCHE,0,1061,1061,
Musée Municipal,2007,HAUTE-NORMANDIE,BERNAY,2248,5871,8119,
Museoseine,2007,HAUTE-NORMANDIE,CAUDEBEC-EN-CAUX,2729,1689,4418,
La Maison de l'Armateur,2007,HAUTE-NORMANDIE,LE HAVRE,7050,4624,11674,
Musée des Antiquités de la Seine-Maritime,2007,HAUTE-NORMANDIE,ROUEN,2858,26261,29119,
Musées du Parc Naturel Régional de Brière,2007,PAYS DE LA LOIRE,SAINT-JOACHIM,2786,304,3090,
Musée des Beaux-Arts,2007,PAYS DE LA LOIRE,ANGERS,27336,45369,72705,
Galerie David d'Angers,2007,PAYS DE LA LOIRE,ANGERS,6758,13297,20055,
Musée d'Art et d'Histoire,2007,PAYS DE LA LOIRE,BAUGE,3610,2075,5685,
Musée d'Art et d'Histoire,2007,PAYS DE LA LOIRE,CHOLET,1553,13073,14626,
Musée Jules-Desbois,2007,PAYS DE LA LOIRE,PARCAY-LES-PINS,2024,3408,5432,
Musée des Tisserands Mayennais,2007,PAYS DE LA LOIRE,AMBRIERES-LES-VALLEES,657,149,806,
Musée Communal Robert Tatin,2007,PAYS DE LA LOIRE,COSSE-LE-VIVIEN,14520,2911,17431,
Musée de la Reine Bérengère,2007,PAYS DE LA LOIRE,LE MANS,1772,2903,4675,
Musée Clemenceau et de Lattre-de-Tassigny,2007,PAYS DE LA LOIRE,MOUILLERON-EN-PAREDS,1498,2067,3565,
Musée du Château,2007,PAYS DE LA LOIRE,NOIRMOUTIER-EN-L'ILE,19761,2690,22451,
Musée de la Vie Rurale et Forestière,2007,PICARDIE,SAINT-MICHEL-EN-THIERACHE,2106,0,2106,
Musée Municipal de Soissons,2007,PICARDIE,SOISSONS,0,29602,29602,
Musée de la Figurine Historique,2007,PICARDIE,COMPIEGNE,3468,6455,9923,
Musée Gallé-Juillet,2007,PICARDIE,CREIL,2369,4032,6401,
Musée Régional de Fouras,2007,POITOU-CHARENTES,FOURAS,6260,6707,12967,
Musée Napoléonien et Africain,2007,POITOU-CHARENTES,ILE D'AIX,14024,14646,28670,
Musée des Beaux-Arts,2007,POITOU-CHARENTES,LA ROCHELLE,1852,5224,7076,
Musée d'Orbigny-Bernon,2007,POITOU-CHARENTES,LA ROCHELLE,1534,7133,8667,
Musée National de la Marine,2007,POITOU-CHARENTES,ROCHEFORT,13599,11785,25384,
Musée des Traditions Populaires et d'Archéologie,2007,POITOU-CHARENTES,CHAUVIGNY,9323,6686,16009,
Musée Municipal de Civray,2007,POITOU-CHARENTES,CIVRAY,0,478,478,
Musée du baptistère Saint-Jean,2007,POITOU-CHARENTES,POITIERS,16339,1415,17754,
Musée de la Faïence,2007,PROVENCE-ALPES-CÔTE D'AZUR,MOUSTIERS-SAINTE-MARIE,6532,4330,10862,
Musée-Château de Cagnes,2007,PROVENCE-ALPES-CÔTE D'AZUR,CAGNES-SUR-MER,20535,19374,39909,
Musée Renoir,2007,PROVENCE-ALPES-CÔTE D'AZUR,CAGNES-SUR-MER,28797,10361,39158,
Muséum d'Histoire Naturelle,2007,PROVENCE-ALPES-CÔTE D'AZUR,NICE,0,83581,83581,
Ecomusée du Pays de la Roudoule,2007,PROVENCE-ALPES-CÔTE D'AZUR,PUGET-ROSTANG,2079,533,2612,
Musées de la Citadelle,2007,PROVENCE-ALPES-CÔTE D'AZUR,VILLEFRANCHE-SUR-MER,0,21430,21430,
Musée du Pavillon de Vendôme,2007,PROVENCE-ALPES-CÔTE D'AZUR,AIX-EN-PROVENCE,3578,7927,11505,
Muséum d'Histoire Naturelle,2007,PROVENCE-ALPES-CÔTE D'AZUR,AIX-EN-PROVENCE,9838,19142,28980,
Musée Départemental de l'Arles Antique,2007,PROVENCE-ALPES-CÔTE D'AZUR,ARLES,23560,49282,72842,
Musée Alphonse Daudet,2007,PROVENCE-ALPES-CÔTE D'AZUR,FONTVIEILLE,31564,275,31839,
Musée Folklorique du Vieux Lambesc,2007,PROVENCE-ALPES-CÔTE D'AZUR,LAMBESC,0,950,950,
Musée d'Histoire de Marseille,2007,PROVENCE-ALPES-CÔTE D'AZUR,MARSEILLE,12125,24843,36968,
Musée du Vieux Marseille,2007,PROVENCE-ALPES-CÔTE D'AZUR,MARSEILLE,3090,6330,9420,
Musée de la Faïence,2007,PROVENCE-ALPES-CÔTE D'AZUR,MARSEILLE,2652,14391,17043,
Musée d'Art Contemporain - Galeries Contemporaines,2007,PROVENCE-ALPES-CÔTE D'AZUR,MARSEILLE,6521,13674,20195,
Musée des Arts et d’Histoire,2007,PROVENCE-ALPES-CÔTE D'AZUR,BORMES-LES-MIMOSAS,0,9527,9527,
Musée des A.T.P. de Moyenne Provence,2007,PROVENCE-ALPES-CÔTE D'AZUR,DRAGUIGNAN,4728,8473,13201,
Musée de l'Artillerie,2007,PROVENCE-ALPES-CÔTE D'AZUR,DRAGUIGNAN,0,19827,19827,
Musée des Troupes de Marine,2007,PROVENCE-ALPES-CÔTE D'AZUR,FREJUS,0,15812,15812,
Musée Municipal,2007,PROVENCE-ALPES-CÔTE D'AZUR,HYERES,0,10386,10386,
Musée du Vêtement Provençal (Jean Aicard),2007,PROVENCE-ALPES-CÔTE D'AZUR,SOLLIES-VILLE,0,4294,4294,
Musée Comtadin-Duplessis,2007,PROVENCE-ALPES-CÔTE D'AZUR,CARPENTRAS,1105,3811,4916,
Synagogue Musée Juif Comtadin,2007,PROVENCE-ALPES-CÔTE D'AZUR,CAVAILLON,3755,5396,9151,
Musée Municipal,2007,PROVENCE-ALPES-CÔTE D'AZUR,SAULT,0,1540,1540,
Musée Départemental du Cartonnage et de l'Imprimerie,2007,PROVENCE-ALPES-CÔTE D'AZUR,VALREAS,3314,1764,5078,
Musée de la Société d'Histoire et d'Archéologie,2007,RHONE-ALPES,BRIORD,25,30,55,
Musée de la Bresse - Domaine des Planons,2007,RHONE-ALPES,SAINT-CYR-SUR-MENTHON,16423,8449,24872,
Musée et Site Archéologiques,2007,RHONE-ALPES,SOYONS,9422,2034,11456,
"Notre histoire, Musée de Rumilly",2007,RHONE-ALPES,RUMILLY,0,1709,1709,
Musée des Vallées de Thônes,2007,RHONE-ALPES,THONES,1893,600,2493,
Musée du Chablais,2007,RHONE-ALPES,THONON-LES-BAINS,1194,1441,2635,
Musée de la Soierie,2007,RHONE-ALPES,CHARLIEU,5241,655,5896,
Musée Hospitalier,2007,RHONE-ALPES,CHARLIEU,3567,435,4002,
Musée d'Art et d'Industrie,2007,RHONE-ALPES,SAINT-ETIENNE,25537,19988,45525,
Musée Historique des Tissus,2007,RHONE-ALPES,LYON,63774,13928,77702,
Centre d'Histoire de la Résistance et de la Déportation,2007,RHONE-ALPES,LYON,19811,43716,63527,
Musée Municipal,2007,SAINT-PIERRE ET MIQUELON,SAINT-PIERRE ET MIQUELON,1141,135,1276,
Musée de la Folie Marco,2008,ALSACE,BARR,2187,2339,4526,
Musée Archéologique,2008,ALSACE,STRASBOURG,7720,34574,42294,
Musée des Arts Décoratifs,2008,ALSACE,STRASBOURG,13761,38953,52714,
Musée Gallo-Romain,2008,ALSACE,BIESHEIM,866,1950,2816,
Musée Bartholdi,2008,ALSACE,COLMAR,7062,4246,11308,
Musée d'Histoire Naturelle et d'Ethnographie de Colmar,2008,ALSACE,COLMAR,6646,5243,11889,
Musée des Beaux-Arts,2008,ALSACE,MULHOUSE,0,15615,15615,
Musée Minéralogique de la Société Industrielle de Mulhouse,2008,ALSACE,MULHOUSE,0,159,159,
Musée du Papier Peint,2008,ALSACE,RIXHEIM,6554,3733,10287,
Musée Paul Reclus,2008,AQUITAINE,DOMME,0,13691,13691,
Musée Militaire - Souvenir du Périgord,2008,AQUITAINE,PERIGUEUX,1679,850,2529,
Musée Archéologique,2008,AQUITAINE,HASTINGUES,3957,5843,9800,
Musée Municipal,2008,AQUITAINE,ARUDY,1236,842,2078,
Musée des Arts et Traditions Populaires de Haute Loire,2008,AUVERGNE,LAVAUDIEU,9954,1218,11172,
Musée Crozatier,2008,AUVERGNE,LE PUY-EN-VELAY,0,17179,17179,
Musée des Peintres de l'Ecole de Murols,2008,AUVERGNE,MUROL,4187,150,4337,
Musée Francisque Mandet,2008,AUVERGNE,RIOM,1852,7195,9047,
Musée du Vin de Bourgogne,2008,BOURGOGNE,BEAUNE,23518,4411,27929,
Musée Buffon,2008,BOURGOGNE,MONTBARD,0,13057,13057,
Musée de la Loire,2008,BOURGOGNE,COSNE-SUR-LOIRE,1255,3636,4891,
Musée de la Mine,2008,BOURGOGNE,BLANZY,11661,1056,12717,
"L'Atelier d'un Journal"" de Louhans - Musée Municipal",2008,BOURGOGNE,LOUHANS,2387,655,3042,
Ecomusée de la Bresse Bourguignonne,2008,BOURGOGNE,PIERRE-DE-BRESSE,23845,9629,33474,
Musée Départemental du Compagnonnage,2008,BOURGOGNE,ROMANECHE-THORINS,2017,1473,3490,
Muséum - Maison de l'Eau,2008,BOURGOGNE,AUXERRE,0,12208,12208,
Musée des Arts Naïfs et Populaires de Noyers sur Serein,2008,BOURGOGNE,NOYERS-SUR-SEREIN,1781,1074,2855,
Musée de l'Aventure du Son,2008,BOURGOGNE,SAINT-FARGEAU,3855,277,4132,
Musée des Beaux-Arts de Brest,2008,BRETAGNE,BREST,4786,18389,23175,
Musée National de la Marine,2008,BRETAGNE,BREST,31346,27404,58750,
Musée Bigouden,2008,BRETAGNE,PONT-L'ABBE,9808,3155,12963,
Ecomusée du Pays de Montfort,2008,BRETAGNE,MONTFORT-SUR-MEU,1972,1785,3757,
Musée des Beaux-Arts,2008,BRETAGNE,RENNES,23314,33025,56339,
Musée de Bretagne,2008,BRETAGNE,RENNES,48779,50774,99553,
Musée des Rochers-Sévigné,2008,BRETAGNE,VITRE,4943,2257,7200,
Musée du Château de Vitré,2008,BRETAGNE,VITRE,10120,6697,16817,
Ecomusée Industriel des Forges,2008,BRETAGNE,INZINZAC-LOCHRIST,4375,0,4375,
"La Cohue, Musée des Beaux-Arts de vannes",2008,BRETAGNE,VANNES,10471,26191,36662,
Musée Estève,2008,CENTRE,BOURGES,0,17173,17173,
Musée du Berry,2008,CENTRE,BOURGES,0,13643,13643,
Musée du Château Charles VII,2008,CENTRE,MEHUN-SUR-YEVRE,7935,0,7935,
Musée de la Chemiserie et de l'Elégance Masculine,2008,CENTRE,ARGENTON-SUR-CREUSE,3619,4885,8504,
Château Musée,2008,CENTRE,AZAY-LE-FERRON,11801,4198,15999,
Musée de l'Hospice Saint-Roch,2008,CENTRE,ISSOUDUN,327,23798,24125,
Musée George Sand et de la Vallée Noire,2008,CENTRE,LA CHATRE,2482,1532,4014,
Musée de l'Hôtel des Communes,2008,CENTRE,AMBOISE,0,4318,4318,
Musée Municipal,2008,CENTRE,SAINTE-MAURE-DE-TOURAINE,127,72,199,
Musée des Vins de Touraine,2008,CENTRE,TOURS,1826,681,2507,
Musée de Minerve,2008,CENTRE,YZEURES-SUR-CREUSE,0,754,754,
Château Musées de Blois,2008,CENTRE,BLOIS,243166,31429,274595,
Musée Municipal Théâtre Forain et Archéologique,2008,CENTRE,ARTENAY,2982,5162,8144,
Musée d'Art et d'Archéologie,2008,CENTRE,CHATILLON-COLIGNY,371,201,572,
Château-Musée de Gien,2008,CENTRE,GIEN Cedex,17528,2348,19876,
Musée Girodet,2008,CENTRE,MONTARGIS,2109,3811,5920,
Musée des Sciences Naturelles,2008,CENTRE,ORLEANS,8068,52615,60683,
Musée des Beaux-Arts,2008,CENTRE,ORLEANS,7934,47273,55207,
Musée du Château-Fort,2008,CHAMPAGNE-ARDENNES,SEDAN,60711,0,60711,
Musée d'Art Moderne,2008,CHAMPAGNE-ARDENNES,TROYES,14118,19353,33471,
Musée Garinet,2008,CHAMPAGNE-ARDENNES,CHALONS-EN-CHAMPAGNE,204,472,676,
Muséum de Besançon,2008,FRANCHE-COMTE,BESANCON,214660,48191,262851,
Musée du Temps,2008,FRANCHE-COMTE,BESANCON,6801,28911,35712,
Musée Baron Martin,2008,FRANCHE-COMTE,GRAY,1911,2880,4791,
Musée de la Tour des Echevins,2008,FRANCHE-COMTE,LUXEUIL-LES-BAINS,1255,4185,5440,
Forge-Musée,2008,FRANCHE-COMTE,ETUEFFONT,1023,494,1517,
Musée Départemental Victor Schoelcher,2008,GUADELOUPE,POINTE-A-PITRE,3000,570,3570,
Ecomusée Municipal d'Approuague-Kaw,2008,GUYANE,REGINA,559,2489,3048,
Musée Intercommunal d'Etampes,2008,ILE-DE-FRANCE,ETAMPES,967,9889,10856,
Musée Départemental Albert-Kahn,2008,ILE-DE-FRANCE,BOULOGNE-BILLANCOURT,64981,39665,104646,
Musée Français de la Carte à Jouer,2008,ILE-DE-FRANCE,ISSY-LES-MOULINEAUX,4177,10909,15086,
Musée National des Châteaux de Malmaison et de Bois-Préau,2008,ILE-DE-FRANCE,RUEIL-MALMAISON,40350,30066,70416,
Musée Municipal de Saint-Cloud,2008,ILE-DE-FRANCE,SAINT-CLOUD,0,2353,2353,
Musée national de céramique de Sèvres,2008,ILE-DE-FRANCE,SEVRES,20104,14153,34257,
Musée de l'Homme (Muséum National d'Histoire Naturelle),2008,ILE-DE-FRANCE,PARIS,141711,38110,179821,
Galerie de Minéralogie et de Géologie (Muséum d'Histoire Naturelle),2008,ILE-DE-FRANCE,PARIS,89100,19282,108382,
Musée de l'Armée,2008,ILE-DE-FRANCE,PARIS,918518,347663,1266181,
Musée de l'Assistance Publique - Hôpitaux de Paris,2008,ILE-DE-FRANCE,PARIS,13993,9210,23203,
Musée National de la Légion d'Honneur et des Ordres de Chevalerie,2008,ILE-DE-FRANCE,PARIS,0,35000,35000,
Musée des Monnaies et des Médailles,2008,ILE-DE-FRANCE,PARIS,10313,11000,21313,
Musée Municipal des Capucins,2008,ILE-DE-FRANCE,COULOMMIERS,1894,1416,3310,
Musée Gatien Bonnet,2008,ILE-DE-FRANCE,LAGNY-SUR-MARNE,1017,3089,4106,
Musée Henri Chapu,2008,ILE-DE-FRANCE,LE MEE-SUR-SEINE,0,585,585,
Château-musée de Nemours,2008,ILE-DE-FRANCE,NEMOURS,2074,3829,5903,
Ecomusée,2008,ILE-DE-FRANCE,SAVIGNY-LE-TEMPLE,298,12288,12586,
Musée de Saint-Maur - Villa Médicis,2008,ILE-DE-FRANCE,LA VARENNE-SAINT-HILAIRE,119,10454,10573,
Musée Emile Jean,2008,ILE-DE-FRANCE,VILLIERS-SUR-MARNE,0,950,950,
"MAC VAL, Musée d'Art Contemporain du Val-de-Marne",2008,ILE-DE-FRANCE,VITRY SUR SEINE,13655,60579,74234,
Musée de la Renaissance - Château d'Ecouen,2008,ILE-DE-FRANCE,ECOUEN,12938,70539,83477,
Musée de la Batellerie et des Voies Navigables,2008,ILE-DE-FRANCE,CONFLANS-SAINTE-HONORINE,9625,1610,11235,
Musée de l'Hôtel-Dieu,2008,ILE-DE-FRANCE,MANTES-LA-JOLIE,2597,6153,8750,
Musée de la Ville,2008,ILE-DE-FRANCE,MONTIGNY LE BRETONNEUX,6324,6976,13300,
Musée du Jouet Pierre Pinel,2008,ILE-DE-FRANCE,POISSY,12345,7229,19574,
Musée d'Archéologie Nationale (des origines à l'an mille) - Château de st-Germain-en-Laye,2008,ILE-DE-FRANCE,SAINT-GERMAIN-EN-LAYE,9881,100316,110197,
Collections de la Fondation de Coubertin,2008,ILE-DE-FRANCE,SAINT-REMY-LES-CHEVREUSE,1587,2217,3804,
Etablissement Public du Musée et du Domaine National de Versailles,2008,ILE-DE-FRANCE,VERSAILLES,4642974,963153,5606127,
Musée Archéologique du Lauragais,2008,LANGUEDOC-ROUSSILLON,CASTELNAUDARY,676,740,1416,
Musée Archéologique,2008,LANGUEDOC-ROUSSILLON,SALLELES D'AUDE,8527,114,8641,
Musée-Bibliothèque Pierre-André Benoît,2008,LANGUEDOC-ROUSSILLON,ALES,0,15889,15889,
Musée des Cultures Taurines (Annexe du Vieux Nîmes),2008,LANGUEDOC-ROUSSILLON,NIMES,427,10884,11311,
Musée Paul Raymond,2008,LANGUEDOC-ROUSSILLON,PONT-SAINT-ESPRIT,0,2154,2154,
Musée du Vieux Montpellier,2008,LANGUEDOC-ROUSSILLON,MONTPELLIER,0,5292,5292,
Musée Hyacinthe Rigaud,2008,LANGUEDOC-ROUSSILLON,PERPIGNAN,3335,6748,10083,
Musée des Monnaies et Médailles Joseph Puig,2008,LANGUEDOC-ROUSSILLON,PERPIGNAN,89,1072,1161,
Musée de Tautavel,2008,LANGUEDOC-ROUSSILLON,TAUTAVEL,64226,8187,72413,
Musée Labenche d'Art et d'Histoire,2008,LIMOUSIN,BRIVE-LA-GAILLARDE,2613,10972,13585,
Musée du Cloître de Tulle André Mazeyrie,2008,LIMOUSIN,TULLE,2646,24640,27286,
Musée National Adrien Dubouché,2008,LIMOUSIN,LIMOGES,7666,19350,27016,
Muséum- Aquarium de Nancy,2008,LORRAINE,NANCY,25106,47926,73032,
Musée des Beaux-Arts de Nancy,2008,LORRAINE,NANCY,54719,63982,118701,
Musée Barrois,2008,LORRAINE,BAR-LE-DUC,2815,6564,9379,
Musée de la Céramique et de l'Ivoire,2008,LORRAINE,COMMERCY,1947,1512,3459,
Musée de la Bière et du Pays de Stenay,2008,LORRAINE,STENAY,4474,10534,15008,
Musée d'Argonne,2008,LORRAINE,VARENNES-EN-ARGONNE,1927,0,1927,
Musée des Mines de fer de Lorraine,2008,LORRAINE,NEUFCHEF,19267,897,20164,
Musée de la Mine - Carreau Wendel,2008,LORRAINE,PETITE-ROSSELLE,29454,16032,45486,
Musée Départemental d'Art Ancien et Contemporain,2008,LORRAINE,EPINAL,2926,16098,19024,
Musée de la Lutherie et de l'Archèterie Française,2008,LORRAINE,MIRECOURT,6015,3117,9132,
Musée Charles de Bruyères,2008,LORRAINE,REMIREMONT,981,3408,4389,
Musée d'Archéologie,2008,MIDI-PYRENEES,MONTSEGUR,30000,0,30000,
"Musée des Mœurs et Coutumes, Musée du Rouergue",2008,MIDI-PYRENEES,ESPALION,492,51,543,
Musée Joseph Vaylet,2008,MIDI-PYRENEES,ESPALION,2628,223,2851,
Musée des jacobins,2008,MIDI-PYRENEES,AUCH,5359,7787,13146,
Musée Archéologique,2008,MIDI-PYRENEES,EAUZE,3567,2569,6136,
Musée du Pays de Luchon,2008,MIDI-PYRENEES,BAGNERES-DE-LUCHON,2291,1158,3449,
Musée Saint-Raymond,2008,MIDI-PYRENEES,TOULOUSE,20550,55370,75920,
Musée Municipal - Musée Trésor,2008,MIDI-PYRENEES,LUZ-SAINT-SAUVEUR,0,1200,1200,
Musée de Préhistoire Amédée Lémozi,2008,MIDI-PYRENEES,CABRERETS,71888,0,71888,
"Musée Archéologique ""Armand-Viré""",2008,MIDI-PYRENEES,LUZECH,765,143,908,
Musée Municipal,2008,MIDI-PYRENEES,VAYRAC,226,0,226,
Musée Eugénie et Maurice Guérin,2008,MIDI-PYRENEES,ANDILLAC,2056,2791,4847,
Musée Charles Portal - Histoire et Patrimoine,2008,MIDI-PYRENEES,CORDES-SUR-CIEL,239,200,439,
Musée du Protestantisme en Haut-Languedoc,2008,MIDI-PYRENEES,FERRIERES,1310,923,2233,
Musée de l'Abbaye Saint-Michel,2008,MIDI-PYRENEES,GAILLAC,2530,727,3257,
Musée Théodore Calbet,2008,MIDI-PYRENEES,GRISOLLES,0,2190,2190,
Musée Municipal d'Escaudain,2008,NORD-PAS-DE-CALAIS,ESCAUDAIN,0,643,643,
"Musée de la Mine, Centre Historique Minier",2008,NORD-PAS-DE-CALAIS,LEWARDE,126384,12858,139242,
Musée des Beaux-Arts,2008,NORD-PAS-DE-CALAIS,ROUBAIX,98146,79475,177621,
Musée Municipal,2008,NORD-PAS-DE-CALAIS,SAINT-AMAND-LES-EAUX,1534,3185,4719,
Musée Régional d'Ethnologie,2008,NORD-PAS-DE-CALAIS,BETHUNE,0,1100,1100,
Musée Langlois,2008,BASSE-NORMANDIE,BEAUMONT-EN-AUGE,432,35,467,
Musée des Beaux-Arts,2008,BASSE-NORMANDIE,CAEN,8785,54006,62791,
Musée d'Initiation à la Nature,2008,BASSE-NORMANDIE,CAEN,0,5725,5725,
Musée Municipal,2008,BASSE-NORMANDIE,ORBEC,421,1721,2142,
Musée de Trouville - Villa Montebello,2008,BASSE-NORMANDIE,TROUVILLE-SUR-MER,5153,6744,11897,
Musée Municipal d'Avranches,2008,BASSE-NORMANDIE,AVRANCHES,0,2102,2102,
Musée Thomas Henry,2008,BASSE-NORMANDIE,CHERBOURG-EN-COTENTIN,0,18265,18265,
Musée Quesnel-Morinière,2008,BASSE-NORMANDIE,COUTANCES,243,7644,7887,
Musée Municipal,2008,BASSE-NORMANDIE,EQUEURDREVILLLE-HAINNEVILLE,0,2890,2890,
Musée Richard Anacréon,2008,BASSE-NORMANDIE,GRANVILLE,8136,5623,13759,
Musée Maritime de l'Ile de Tatihou,2008,BASSE-NORMANDIE,SAINT-VAAST-LA-HOUGUE,52448,2961,55409,
Musée du Château,2008,BASSE-NORMANDIE,TORIGNI-SUR-VIRE,800,1200,2000,
Musée des Beaux-Arts et de la Dentelle,2008,BASSE-NORMANDIE,ALENCON,9654,8145,17799,
Musée du Château de Flers,2008,BASSE-NORMANDIE,FLERS,2254,2991,5245,
Musée de l'Ancien Evêché,2008,HAUTE-NORMANDIE,EVREUX,3515,7460,10975,
Museoseine,2008,HAUTE-NORMANDIE,CAUDEBEC-EN-CAUX,3783,1379,5162,
Musée des Terres-Neuvas et de la Pêche,2008,HAUTE-NORMANDIE,FECAMP,15189,21073,36262,
Musée du Prieuré,2008,HAUTE-NORMANDIE,HARFLEUR,243,4605,4848,
Musée Mathon-Durand,2008,HAUTE-NORMANDIE,NEUFCHATEL-EN-BRAY,392,1868,2260,
Musée-Maison Natale Pierre Corneille,2008,HAUTE-NORMANDIE,ROUEN,0,3194,3194,
Musée de la Céramique,2008,HAUTE-NORMANDIE,ROUEN,4684,10115,14799,
Muséum d'Histoire Naturelle,2008,HAUTE-NORMANDIE,ROUEN,21156,24801,45957,
Ecomusée de Saint-Nazaire,2008,PAYS DE LA LOIRE,SAINT-NAZAIRE,3452,65847,69299,
Muséum des Sciences Naturelles,2008,PAYS DE LA LOIRE,ANGERS,3506,12044,15550,
Musée Archéologique Départemental de Jublains,2008,PAYS DE LA LOIRE,JUBLAINS,8522,21692,30214,
Musée des Sciences - CCSTI,2008,PAYS DE LA LOIRE,LAVAL,2548,31356,33904,
Musée La Bourrine du Bois-Juquaud,2008,PAYS DE LA LOIRE,SAINT-HILAIRE-DE-RIEZ,10205,8042,18247,
Familistère de Guise,2008,PICARDIE,GUISE,28848,2956,31804,
Musée Jeanne d'Aboville,2008,PICARDIE,LA FERE,303,215,518,
Musée d'Art et d'Archéologie,2008,PICARDIE,LAON,1567,5140,6707,
Musée des Beaux-Arts Antoine Lecuyer,2008,PICARDIE,SAINT-QUENTIN,5270,5141,10411,
Musée du Noyonnais,2008,PICARDIE,NOYON,835,1960,2795,
Musée Départemental de l'Abbaye de Saint-Riquier,2008,PICARDIE,ABBEVILLE,0,26697,26697,
Musée Alfred Danicourt,2008,PICARDIE,PERONNE,0,2505,2505,
Atelier - Musée du Papier,2008,POITOU-CHARENTES,ANGOULEME,0,12409,12409,
Musée de la Mytiliculture,2008,POITOU-CHARENTES,ESNANDES,4950,0,4950,
Hôtel Hèbre de Saint-Clément - Musée d'Art et d'Histoire,2008,POITOU-CHARENTES,ROCHEFORT,4138,17763,21901,
Musée Ernest Cognacq,2008,POITOU-CHARENTES,SAINT-MARTIN-DE-RE,8025,5666,13691,
Musée Henri Barré,2008,POITOU-CHARENTES,THOUARS,367,1802,2169,
Musée Charbonneau-Lassay,2008,POITOU-CHARENTES,LOUDUN,19,289,308,
Musée Rupert de Chièvres,2008,POITOU-CHARENTES,POITIERS,983,2921,3904,
Musée du baptistère Saint-Jean,2008,POITOU-CHARENTES,POITIERS,13908,1527,15435,
Collection d'Histoire Naturelle,2008,POITOU-CHARENTES,POITIERS,9674,46017,55691,
Musée de la vallée,2008,PROVENCE-ALPES-CÔTE D'AZUR,BARCELONNETTE,11597,2258,13855,
Musée Gassendi,2008,PROVENCE-ALPES-CÔTE D'AZUR,DIGNE-LES-BAINS,2462,6754,9216,
Musée de Salagon,2008,PROVENCE-ALPES-CÔTE D'AZUR,MANE,26900,6079,32979,
Musée de la Faïence,2008,PROVENCE-ALPES-CÔTE D'AZUR,MOUSTIERS-SAINTE-MARIE,6110,4566,10676,
Musée du Vieux Sisteron,2008,PROVENCE-ALPES-CÔTE D'AZUR,SISTERON,0,567,567,
Musée d'Histoire Locale,2008,PROVENCE-ALPES-CÔTE D'AZUR,BIOT,2631,2206,4837,
Musée International de la Parfumerie,2008,PROVENCE-ALPES-CÔTE D'AZUR,GRASSE,0,30567,30567,
Musée Jean Cocteau Collection Séverin Wunderman,2008,PROVENCE-ALPES-CÔTE D'AZUR,MENTON,11178,7251,18429,
Musée d'Art Naïf Anatole Jakovsky,2008,PROVENCE-ALPES-CÔTE D'AZUR,NICE,1685,17422,19107,
Ecomusée du Pays de la Roudoule,2008,PROVENCE-ALPES-CÔTE D'AZUR,PUGET-ROSTANG,866,988,1854,
Musée du Parlement de Provence et du Vieil Aix,2008,PROVENCE-ALPES-CÔTE D'AZUR,AIX-EN-PROVENCE,3671,6443,10114,
Muséum d'Histoire Naturelle,2008,PROVENCE-ALPES-CÔTE D'AZUR,AIX-EN-PROVENCE,9739,22770,32509,
Musée des Tapisseries,2008,PROVENCE-ALPES-CÔTE D'AZUR,AIX-EN-PROVENCE,8192,13033,21225,
Musée Archéologique d'Istres René Beaucaire,2008,PROVENCE-ALPES-CÔTE D'AZUR,ISTRES,0,5468,5468,
Musée Folklorique du Vieux Lambesc,2008,PROVENCE-ALPES-CÔTE D'AZUR,LAMBESC,0,1159,1159,
Musée d'Histoire et d'Archéologie des Baux-de-Provence,2008,PROVENCE-ALPES-CÔTE D'AZUR,LES BAUX DE PROVENCE,222024,38215,260239,
Musée de la Mode,2008,PROVENCE-ALPES-CÔTE D'AZUR,MARSEILLE,5758,7094,12852,
Musée de la Faïence,2008,PROVENCE-ALPES-CÔTE D'AZUR,MARSEILLE,3929,11158,15087,
Musée des Alpilles,2008,PROVENCE-ALPES-CÔTE D'AZUR,SAINT-REMY-DE-PROVENCE,2863,5969,8832,
Musée du Vêtement Provençal (Jean Aicard),2008,PROVENCE-ALPES-CÔTE D'AZUR,SOLLIES-VILLE,0,3802,3802,
Musée d'Apt,2008,PROVENCE-ALPES-CÔTE D'AZUR,APT,3177,6867,10044,
Musée du Petit Palais,2008,PROVENCE-ALPES-CÔTE D'AZUR,AVIGNON,21461,10936,32397,
Musée du Vieux Pérouges,2008,RHONE-ALPES,PEROUGES,11550,1035,12585,
Musée et Site Archéologiques,2008,RHONE-ALPES,SOYONS,9504,1921,11425,
Musée d'Histoire et d'Archéologie,2008,RHONE-ALPES,DIE,567,1284,1851,
Musée International de la Chaussure,2008,RHONE-ALPES,ROMANS,18268,17799,36067,
Musée d'Archéologie Tricastine,2008,RHONE-ALPES,SAINT-PAUL-TROIS-CHATEAUX,690,3127,3817,
Musée du Chablais,2008,RHONE-ALPES,THONON-LES-BAINS,4768,0,4768,
Musée Jadis Allevard,2008,RHONE-ALPES,ALLEVARD-LES-BAINS,1497,2921,4418,
Musée - Parc Archéologique du Lac de Paladru,2008,RHONE-ALPES,CHARAVINES,11772,739,12511,
Musée de la Grande Chartreuse,2008,RHONE-ALPES,SAINT-PIERRE-DE-CHARTREUSE,53720,0,53720,
Conservatoire - Musée des Industries Hydroélectriques,2008,RHONE-ALPES,VAUJANY,0,11436,11436,
Musée de la Soierie,2008,RHONE-ALPES,CHARLIEU,5335,1664,6999,
Musée de la Diana,2008,RHONE-ALPES,MONTBRISON,1648,0,1648,
Musée des Beaux-Arts et d'Archéologie J. Dechelette,2008,RHONE-ALPES,ROANNE,1854,11666,13520,
Musée Folklorique du Vieux Saint-Etienne,2008,RHONE-ALPES,SAINT-ETIENNE,732,1676,2408,
Musée d'Art Moderne et Contemporain,2008,RHONE-ALPES,SAINT-ETIENNE,28045,25853,53898,
Musée des Civilisations : Daniel Pouget,2008,RHONE-ALPES,SAINT-JUST-SAINT-RAMBERT,4059,652,4711,
Musée Historique des Tissus et des Arts Décoratifs,2008,RHONE-ALPES,LYON,64674,21558,86232,
Musée de l'Imprimerie et de la Communication Graphique,2008,RHONE-ALPES,LYON,11972,9184,21156,
Muséum d'Histoire Naturelle,2008,RHONE-ALPES,LYON,0,16544,16544,
Musée Paul Dini,2008,RHONE-ALPES,VILLEFRANCHE-SUR-SAONE,14415,7088,21503,
Musée du docteur Faure,2008,RHONE-ALPES,AIX-LES-BAINS,5989,3958,9947,
Musée Municipal,2008,ST PIERRE ET MIQUELON,SAINT-PIERRE ET MIQUELON,1310,109,1419,
Musée du Château des Rohan,2009,ALSACE,SAVERNE,4940,4977,9917,
Musée Bartholdi,2009,ALSACE,COLMAR,7387,4030,11417,
Musée d'Histoire Naturelle et d'Ethnographie de Colmar,2009,ALSACE,COLMAR,6560,6053,12613,
Musée Historique et Militaire de Huningue,2009,ALSACE,HUNINGE,179,108,287,
Musée de l'Impression sur Etoffes,2009,ALSACE,MULHOUSE,19301,15490,34791,
Maison du Sundgau - Musée Paysan,2009,ALSACE,OLTINGUE,1777,308,2085,
Musée du Dolder,2009,ALSACE,RIQUEWIHR,1682,276,1958,
Musée National de la Préhistoire,2009,AQUITAINE,LES EYZIES-DE-TAYAC,48727,35412,84139,
Musée d'Art et Traditions Populaires,2009,AQUITAINE,VILLEFRANCHE-DE-LONCHAT,0,884,884,
Musée des Beaux-Arts et d'Archéologie,2009,AQUITAINE,LIBOURNE,0,3327,3327,
Musée Archéologique,2009,AQUITAINE,HASTINGUES,6012,2385,8397,
Musée Despiau-Wlérick,2009,AQUITAINE,MONT-DE-MARSAN,0,13834,13834,
Musée des Beaux-Arts,2009,AQUITAINE,AGEN,8406,14417,22823,
Musée du Liège et du Bouchon,2009,AQUITAINE,MEZIN,4588,729,5317,
Musée du Château Henri IV,2009,AQUITAINE,NERAC,17868,5180,23048,
Musée Edmond Rostand,2009,AQUITAINE,CAMBO-LES-BAINS,59757,2155,61912,
Musée Rural de la Sologne Bourbonnaise,2009,AUVERGNE,BEAULON,50,120,170,
Musée Anne de Beaujeu,2009,AUVERGNE,MOULINS,11072,3784,14856,
Musée Rieckotter,2009,AUVERGNE,NERIS-LES-BAINS,649,719,1368,
Ecomusée de Margeride-Haute-Auvergne,2009,AUVERGNE,RUYNES-EN-MARGERIDE,6752,4675,11427,
Musée des Arts et Traditions Populaires de Haute Loire,2009,AUVERGNE,LAVAUDIEU,11023,740,11763,
Musée des Manufactures de Dentelles,2009,AUVERGNE,RETOURNAC,4412,4192,8604,
Musée de la Dentelle,2009,AUVERGNE,ARLANC,1255,187,1442,
Musée Lapidaire,2009,AUVERGNE,MOZAC,354,439,793,
Musée Bonaparte,2009,BOURGOGNE,AUXONNE,0,3003,3003,
Musée du Pays Châtillonnais - Trésor de Vix,2009,BOURGOGNE,CHATILLON-SUR-SEINE,12981,9468,22449,
Musée François Rude,2009,BOURGOGNE,DIJON,0,34512,34512,
Musée des Beaux-Arts,2009,BOURGOGNE,DIJON,32133,152801,184934,
Musée Municipal,2009,BOURGOGNE,SEMUR-EN-AUXOIS,1133,3900,5033,
Musée du Septennat,2009,BOURGOGNE,CHATEAU-CHINON,12530,2447,14977,
Musée de la Mine,2009,BOURGOGNE,BLANZY,10655,1307,11962,
Musée d'Art et d'Archéologie,2009,BOURGOGNE,CLUNY,82017,23657,105674,
Musée des Ursulines,2009,BOURGOGNE,MACON,1797,15626,17423,
Musée Eucharistique du Hiéron,2009,BOURGOGNE,PARAY-LE-MONIAL,4323,3079,7402,
Hôtel Dieu - Musée Greuze,2009,BOURGOGNE,TOURNUS,8119,2248,10367,
Musée Colette,2009,BOURGOGNE,SAINT-SAUVEUR-EN-PUISAYE,7517,314,7831,
Musée d'Art et d'Histoire,2009,BRETAGNE,SAINT-BRIEUC,0,43668,43668,
Musée de Morlaix,2009,BRETAGNE,MORLAIX,10038,8819,18857,
Musée National de la Marine,2009,BRETAGNE,PORT-LOUIS,43431,30738,74169,
Musée Estève,2009,CENTRE,BOURGES,0,16402,16402,
Musée Emile Chénon,2009,CENTRE,CHATEAUMEILLANT,485,665,1150,
Musée de l'Histoire du Perche,2009,CENTRE,NOGENT-LE-ROTROU,11072,7880,18952,
Musée de l'Hôtel des Communes,2009,CENTRE,AMBOISE,0,5627,5627,
Musée Lansyer,2009,CENTRE,LOCHES,2314,1768,4082,
Muséum d'Histoire Naturelle,2009,CENTRE,TOURS,10961,15254,26215,
Musée des Beaux-Arts,2009,CENTRE,TOURS,30574,40231,70805,
Musée de Vendôme,2009,CENTRE,VENDOME,1513,7695,9208,
Musée de l'Ardenne,2009,CHAMPAGNE-ARDENNES,CHARLEVILLE-MEZIERES,4654,47349,52003,
Musée du Feutre,2009,CHAMPAGNE-ARDENNES,MOUZON,3616,1560,5176,
Musée Napoléon Ier,2009,CHAMPAGNE-ARDENNES,BRIENNE-LE-CHATEAU,3391,1688,5079,
Maison de l'Outil  et de la Pensée Ouvrière,2009,CHAMPAGNE-ARDENNES,TROYES,11312,2912,14224,
Musée Municipal,2009,CHAMPAGNE-ARDENNES,SAINT-DIZIER,0,32524,32524,
Musée Saint-Rémi,2009,CHAMPAGNE-ARDENNES,REIMS,4643,44002,48645,
Musée du Château des Ducs de Wurtemberg,2009,FRANCHE-COMTE,MONTBELIARD,6043,14845,20888,
Musée de Pontarlier,2009,FRANCHE-COMTE,PONTARLIER,1974,9639,11613,
Musée Sarret de Grozon,2009,FRANCHE-COMTE,ARBOIS,310,1059,1369,
Musée des Beaux-Arts,2009,FRANCHE-COMTE,DOLE,0,19299,19299,
Musée des Beaux-Arts,2009,FRANCHE-COMTE,LONS-LE-SAUNIER,1038,3326,4364,
Viséum-Musée de la Lunette,2009,FRANCHE-COMTE,MOREZ HAUTS DE BIENNE,9584,5795,15379,
Musée des Salines,2009,FRANCHE-COMTE,SALINS-LES-BAINS,59439,9494,68933,
Forge-Musée,2009,FRANCHE-COMTE,ETUEFFONT,1082,483,1565,
Musée Français de la Photographie,2009,ILE-DE-FRANCE,BIEVRES,4699,1050,5749,
Musée du Château,2009,ILE-DE-FRANCE,DOURDAN,8084,6690,14774,
Musée Roybet Fould,2009,ILE-DE-FRANCE,COURBEVOIE,0,9351,9351,
Musée Municipal de Saint-Cloud,2009,ILE-DE-FRANCE,SAINT-CLOUD,635,15179,15814,
Grande Galerie de l'Evolution (Muséum National d'Histoire Naturelle),2009,ILE-DE-FRANCE,PARIS,287258,308422,595680,
Musée de l'Homme (Muséum National d'Histoire Naturelle),2009,ILE-DE-FRANCE,PARIS,29575,25500,55075,
Musée National Eugène Delacroix,2009,ILE-DE-FRANCE,PARIS,33368,13562,46930,
Musée de l'Assistance Publique - Hôpitaux de Paris,2009,ILE-DE-FRANCE,PARIS,19311,0,19311,
Musée National Auguste Rodin,2009,ILE-DE-FRANCE,PARIS,434927,257654,692581,
Musée de la Chasse et de la Nature,2009,ILE-DE-FRANCE,PARIS,18646,21303,39949,
"Musée Cernuschi, Musée des Arts de l'Asie de la ville de Paris",2009,ILE-DE-FRANCE,PARIS,59326,45315,104641,
Musée du Quai Branly,2009,ILE-DE-FRANCE,PARIS,797493,698946,1496439,
Musée de Provins et du Provinois,2009,ILE-DE-FRANCE,PROVINS,17021,4200,21221,
Musée des Pays de Seine-et-Marne,2009,ILE-DE-FRANCE,SAINT-CYR-SUR-MORIN,3055,7350,10405,
Musée de Saint-Maur - Villa Médicis,2009,ILE-DE-FRANCE,LA VARENNE-SAINT-HILAIRE,38,6789,6827,
Musée Emile Jean,2009,ILE-DE-FRANCE,VILLIERS-SUR-MARNE,0,1200,1200,
Musée Camille Pissarro,2009,ILE-DE-FRANCE,PONTOISE,0,3981,3981,
Musée Promenade Marly/Louveciennes,2009,ILE-DE-FRANCE,LOUVECIENNES,6665,2362,9027,
Musée Zola-Dreyfus,2009,ILE-DE-FRANCE,MEDAN,6028,410,6438,
Musée Rambolitrain,2009,ILE-DE-FRANCE,RAMBOUILLET,15270,2191,17461,
Muséum d'Histoire Naturelle,2009,LA REUNION,SAINT-DENIS,9354,51412,60766,
Musée Historique de Villèle,2009,LA REUNION,SAINT-GILLES-LES-HAUTS,12914,19022,31936,
Musée des Arts Décoratifs de l’Océan indien (MADOI),2009,LA REUNION,SAINT-LOUIS,0,11909,11909,
Musée Petiet,2009,LANGUEDOC-ROUSSILLON,LIMOUX,1840,3005,4845,
Musée Archéologique,2009,LANGUEDOC-ROUSSILLON,SALLELES D'AUDE,5075,297,5372,
Musée Léon Alègre,2009,LANGUEDOC-ROUSSILLON,BAGNOLS-SUR-CEZE,0,1176,1176,
Musée Cévenol,2009,LANGUEDOC-ROUSSILLON,LE VIGAN,2225,1746,3971,
Musée d'Histoire Naturelle et de Préhistoire,2009,LANGUEDOC-ROUSSILLON,NIMES,0,58591,58591,
Musée Paul Raymond,2009,LANGUEDOC-ROUSSILLON,PONT-SAINT-ESPRIT,0,1198,1198,
Musée de la Maison Romane,2009,LANGUEDOC-ROUSSILLON,SAINT-GILLES-DU-GARD,0,6274,6274,
Site Archéologique Lattara - Musée Henri Prades de Montpellier Agglomération,2009,LANGUEDOC-ROUSSILLON,LATTES,6401,10387,16788,
Musée de la Préhistoire des Matelles,2009,LANGUEDOC-ROUSSILLON,LES MATELLES,1439,2605,4044,
Agropolis-Muséum,2009,LANGUEDOC-ROUSSILLON,MONTPELLIER,13166,0,13166,
Musée départemental d'Art Moderne,2009,LANGUEDOC-ROUSSILLON,CERET,74335,21751,96086,
Musée Départemental de la Tapisserie,2009,LIMOUSIN,AUBUSSON,16542,3315,19857,
Les Sources d'Hercule,2009,LORRAINE,DENEUVRE,2357,497,2854,
Musée des Beaux-Arts de Nancy,2009,LORRAINE,NANCY,37478,64642,102120,
Musée d'Art et d'Histoire de Toul,2009,LORRAINE,TOUL,1436,4904,6340,
Musée Jules Bastien-Lepage - Musée de la Fortification,2009,LORRAINE,MONTMEDY,12597,1338,13935,
Musée de la Princerie,2009,LORRAINE,VERDUN,2185,2546,4731,
Musées de la Cour d'Or,2009,LORRAINE,METZ,9224,41024,50248,
Musée des Mines de fer de Lorraine,2009,LORRAINE,NEUFCHEF,17177,790,17967,
La Tour aux Puces - Musée du Pays Thionvillois,2009,LORRAINE,THIONVILLE,2617,7954,10571,
Musée Charles Friry,2009,LORRAINE,REMIREMONT,522,2397,2919,
Musée Charles de Bruyères,2009,LORRAINE,REMIREMONT,711,3462,4173,
Musée Fenaille,2009,MIDI-PYRENEES,RODEZ,7432,13823,21255,
Musée Municipal Urbain Cabrol,2009,MIDI-PYRENEES,VILLEFRANCHE-DE-ROUERGUE,0,4804,4804,
Musée Campanaire,2009,MIDI-PYRENEES,L'ISLE JOURDAIN,5589,6390,11979,
Musée Municipal,2009,MIDI-PYRENEES,MARTRES-TOLOSANE,0,7976,7976,
Muséum d'Histoire Naturelle,2009,MIDI-PYRENEES,TOULOUSE,127267,83165,210432,
Musée Paul Dupuy,2009,MIDI-PYRENEES,TOULOUSE,5836,9409,15245,
Musée Georges Labit,2009,MIDI-PYRENEES,TOULOUSE,5521,13052,18573,
Musée Saint-Raymond,2009,MIDI-PYRENEES,TOULOUSE,23070,52622,75692,
Muséum d'Histoire Naturelle,2009,MIDI-PYRENEES,BAGNERES-DE-BIGORRE,405,378,783,
Musée Toulouse Lautrec,2009,MIDI-PYRENEES,ALBI,110117,29093,139210,
Musée du Protestantisme en Haut-Languedoc,2009,MIDI-PYRENEES,FERRIERES,1105,841,1946,
Musée du Château,2017,PAYS DE LA LOIRE,NOIRMOUTIER-EN-L'ILE,38435,5246,43681,
Musée Gassendi,2017,PROVENCE-ALPES-CÔTE D'AZUR,DIGNE-LES-BAINS,3170,15470,18640,
Musée archéologique,2017,PROVENCE-ALPES-CÔTE D'AZUR,VACHERES,502,110,612,
Musée Picasso,2017,PROVENCE-ALPES-CÔTE D'AZUR,ANTIBES,84208,38980,123188,
Musée d'Histoire Locale,2017,PROVENCE-ALPES-CÔTE D'AZUR,BIOT,2438,0,2438,
Musée d'Art et d'Histoire de Provence,2017,PROVENCE-ALPES-CÔTE D'AZUR,GRASSE,2431,9465,11896,
Musée des Beaux-Arts Jules Chéret,2017,PROVENCE-ALPES-CÔTE D'AZUR,NICE,10764,10522,21286,
Musée d'Art Moderne et d'Art Contemporain,2017,PROVENCE-ALPES-CÔTE D'AZUR,NICE,67713,72547,140260,
Musée du Pavillon de Vendôme,2017,PROVENCE-ALPES-CÔTE D'AZUR,AIX-EN-PROVENCE,5488,16006,21494,
Muséum d'Histoire Naturelle,2017,PROVENCE-ALPES-CÔTE D'AZUR,AIX-EN-PROVENCE,3140,9957,13097,
Musée Granet,2017,PROVENCE-ALPES-CÔTE D'AZUR,AIX-EN-PROVENCE,81946,59132,141078,
Musée Camarguais,2017,PROVENCE-ALPES-CÔTE D'AZUR,ARLES,15727,5444,21171,
Musée Ciotaden,2017,PROVENCE-ALPES-CÔTE D'AZUR,LA CIOTAT,2252,3611,5863,
Musée Frédéric Mistral,2017,PROVENCE-ALPES-CÔTE D'AZUR,MAILLANE,577,49,626,
Musée Borély,2017,PROVENCE-ALPES-CÔTE D'AZUR,MARSEILLE,9676,21273,30949,
Musée du Pays Brignolais,2017,PROVENCE-ALPES-CÔTE D'AZUR,BRIGNOLES,3741,1931,5672,
Musée Archéologique Gallo-Romaine du Var,2017,PROVENCE-ALPES-CÔTE D'AZUR,FREJUS,4640,1002,5642,
Muséum d'Histoire Naturelle de Toulon et du Var,2017,PROVENCE-ALPES-CÔTE D'AZUR,TOULON,0,49705,49705,
Muséum d'Histoire Naturelle Esprit Requien,2017,PROVENCE-ALPES-CÔTE D'AZUR,AVIGNON,0,15055,15055,
Synagogue Musée Juif Comtadin,2017,PROVENCE-ALPES-CÔTE D'AZUR,CAVAILLON,3063,2070,5133,
Musée Municipal,2017,PROVENCE-ALPES-CÔTE D'AZUR,SAULT,0,737,737,
Musée de la Bresse - Domaine des Planons,2018,AUVERGNE-RHONE-ALPES,SAINT-CYR-SUR-MENTHON,10693,7504,18197,
Musée Charles-Louis Philippe,2018,AUVERGNE-RHONE-ALPES,CERILLY,97,71,168,
MuséAL - Musée Archéologique d'Alba,2018,AUVERGNE-RHONE-ALPES,ALBA-LA-ROMAINE,11953,2094,14047,
Musée de la Batellerie du Rhône,2018,AUVERGNE-RHONE-ALPES,SERRIERES,705,100,805,
Musée et Site Archéologiques,2018,AUVERGNE-RHONE-ALPES,SOYONS,12670,2040,14710,
Musée des Sciences,2018,AUVERGNE-RHONE-ALPES,AURILLAC,3224,6611,9835,
Musée d'art et d'histoire Alfred Douët,2018,AUVERGNE-RHONE-ALPES,SAINT-FLOUR,1328,2749,4077,
Musée d'Histoire et d'Archéologie,2018,AUVERGNE-RHONE-ALPES,DIE,1011,5670,6681,
Musée d'Archéologie Tricastine,2018,AUVERGNE-RHONE-ALPES,SAINT-PAUL-TROIS-CHATEAUX,2309,6286,8595,
Musée du site Préhistorique,2018,AUVERGNE-RHONE-ALPES,VASSIEUX-EN-VERCORS,10867,854,11721,
Musée-château d'Annecy,2018,AUVERGNE-RHONE-ALPES,ANNECY,73141,67369,140510,
Musée Alpin et musée des Cristaux,2018,AUVERGNE-RHONE-ALPES,CHAMONIX,23920,11781,35701,
Musée Jadis Allevard,2018,AUVERGNE-RHONE-ALPES,ALLEVARD-LES-BAINS,1485,1119,2604,
Musée Stendhal,2018,AUVERGNE-RHONE-ALPES,GRENOBLE,451,4112,4563,
Musée de Grenoble,2018,AUVERGNE-RHONE-ALPES,GRENOBLE,77021,128092,205113,
Musée Hébert,2018,AUVERGNE-RHONE-ALPES,LA TRONCHE,1418,27952,29370,
Musée des Beaux-Arts et d'Archéologie,2018,AUVERGNE-RHONE-ALPES,VIENNE,2108,3542,5650,
Musée Alice Taverne,2018,AUVERGNE-RHONE-ALPES,AMBIERLE,3952,1133,5085,
Musée d'Allard,2018,AUVERGNE-RHONE-ALPES,MONTBRISON,2869,6747,9616,
Musée du Vieux Pommiers,2018,AUVERGNE-RHONE-ALPES,POMMIERS-EN-FOREZ,0,30,30,
Musée d'Art Moderne et Contemporain de Saint-Etienne Métropole,2018,AUVERGNE-RHONE-ALPES,SAINT-PRIEST-EN-JAREZ,29735,30927,60662,
Muséum d'Histoire Naturelle Henri-Lecoq,2018,AUVERGNE-RHONE-ALPES,CLERMONT-FERRAND,4480,25135,29615,
Musée des Beaux-Arts,2018,AUVERGNE-RHONE-ALPES,LYON,143458,156772,300230,
Musée Henri Malartre,2018,AUVERGNE-RHONE-ALPES,ROCHETAILLEE-SUR-SAONE,14378,16811,31189,
Musée archéologique et minéralogique Pierre Borrione,2018,AUVERGNE-RHONE-ALPES,AIME-EN-TARENTAISE,220,255,475,
Musée du docteur Faure,2018,AUVERGNE-RHONE-ALPES,AIX-LES-BAINS,6712,6446,13158,
Muséum d'histoire naturelle,2018,AUVERGNE-RHONE-ALPES,CHAMBERY,0,3786,3786,
Musée de l'Académie de La Val d'Isère,2018,AUVERGNE-RHONE-ALPES,MOÛTIERS,23,86,109,
Musée Archéologique,2018,BOURGOGNE-FRANCHE-COMTE,DIJON,0,38942,38942,
Musée Auguste Grasset,2018,BOURGOGNE-FRANCHE-COMTE,VARZY,1050,200,1250,
Musée Lapidaire Saint-Nicolas,2018,BOURGOGNE-FRANCHE-COMTE,AUTUN,0,500,500,
Musée de la Mine,2018,BOURGOGNE-FRANCHE-COMTE,BLANZY,10257,1953,12210,
Musée Denon,2018,BOURGOGNE-FRANCHE-COMTE,CHALON-SUR-SAONE,0,10715,10715,
Musée Nicéphore Niepce,2018,BOURGOGNE-FRANCHE-COMTE,CHALON-SUR-SAONE,0,26585,26585,
Musée du Prieuré de Charolles,2018,BOURGOGNE-FRANCHE-COMTE,CHAROLLES,1343,1616,2959,
Musée de Bibracte,2018,BOURGOGNE-FRANCHE-COMTE,SAINT-LEGER-SOUS BEUVRAY,36635,7128,43763,
Musée Départemental de Préhistoire de Solutré,2018,BOURGOGNE-FRANCHE-COMTE,SOLUTRE-POUILLY,14277,10482,24759,
Musée Frédéric Japy,2018,BOURGOGNE-FRANCHE-COMTE,BEAUCOURT,916,804,1720,
Musée d'Art et d'Histoire,2018,BOURGOGNE-FRANCHE-COMTE,AUXERRE,0,31269,31269,
Musée des Phares et Balises,2018,BRETAGNE,OUESSANT,15883,2521,18404,
Musée de la Carte Postale,2018,BRETAGNE,BAUD,1838,996,2834,
Musée de Préhistoire J. Miln- Z. Le-Rouzic,2018,BRETAGNE,CARNAC,28439,5894,34333,
"La Cohue, Musée des Beaux-Arts de vannes",2018,BRETAGNE,VANNES,5923,170396,176319,
Muséum des Sciences Naturelles et de Préhistoire,2018,CENTRE-VAL DE LOIRE,CHARTRES,0,10000,10000,
"""Maison Musée"" René Descartes",2018,CENTRE-VAL DE LOIRE,DESCARTES,1136,573,1709,
Musée de l'Hôtel de Ville,2018,CENTRE-VAL DE LOIRE,RICHELIEU,4376,419,4795,
Musée des Beaux-Arts,2018,CENTRE-VAL DE LOIRE,TOURS,16471,46145,62616,
Musée d'Art et d'Archéologie,2018,CENTRE-VAL DE LOIRE,CHATILLON-COLIGNY,0,250,250,
Musée Girodet,2018,CENTRE-VAL DE LOIRE,MONTARGIS,0,2282,2282,
Musée de l'Alta Rocca,2018,CORSE,LEVIE,5207,4867,10074,
Musée de Préhistoire Corse,2018,CORSE,SARTENE,5101,4191,9292,
Musée Arthur Rimbaud,2018,GRAND EST,CHARLEVILLE-MEZIERES,6455,12117,18572,
Musée Napoléon Ier,2018,GRAND EST,BRIENNE-LE-CHATEAU,7684,3001,10685,
Musée de la Résistance,2018,GRAND EST,MUSSY-SUR-SEINE,140,0,140,
Musée de la Chartreuse,2018,GRAND EST,MOLSHEIM,5367,1596,6963,
Musée du Château des Rohan,2018,GRAND EST,SAVERNE,3968,3678,7646,
Musée Sundgauvien d'Altkirch,2018,GRAND EST,ALTKIRCH,382,4962,5344,
Musée d'Unterlinden,2018,GRAND EST,COLMAR,141055,41709,182764,
Musée d'Histoire Naturelle et d'Ethnographie de Colmar,2018,GRAND EST,COLMAR,9836,5028,14864,
Musée Théodore Deck et des Pays du Florival,2018,GRAND EST,GUEBWILLER,1442,3649,5091,
Musée Historique et Militaire de Huningue,2018,GRAND EST,HUNINGE,256,70,326,
Musée Historique,2018,GRAND EST,MULHOUSE,0,37006,37006,
Palais des ducs de Lorraine - Musée Historique Lorrain,2018,GRAND EST,NANCY,4193,97759,101952,
Musée d'Art et d'Histoire de Toul,2018,GRAND EST,TOUL,0,11548,11548,
Musée de la Céramique et de l'Ivoire,2018,GRAND EST,COMMERCY,830,1746,2576,
Musée d'Argonne,2018,GRAND EST,VARENNES-EN-ARGONNE,1282,0,1282,
Maison du Verre et du Cristal,2018,GRAND EST,MEISENTHAL,14225,3209,17434,
Centre Pompidou de Metz (collections nationales decentralisées),2018,GRAND EST,METZ,138546,193639,332185,
Musée Départemental Georges de la Tour,2018,GRAND EST,VIC-SUR-SEILLE,3809,3367,7176,
Musée Charles de Bruyères,2018,GRAND EST,REMIREMONT,445,1399,1844,
Musée Pierre Noël - Musée de la Vie dans les Hautes-Vosges,2018,GRAND EST,SAINT-DIE-DES-VOSGES,2883,13550,16433,
Musée des Cultures Guyanaises,2018,GUYANE,CAYENNE,973,4643,5616,
Musée Territorial Alexandre Franconie,2018,GUYANE,CAYENNE,2720,6966,9686,
Musée Franco-Américain du Château de Blérancourt,2018,HAUTS-DE-FRANCE,BLERANCOURT,5849,6442,12291,
Forum Antique de Bavay,2018,HAUTS-DE-FRANCE,BAVAY,22674,7559,30233,
Musée de l'Ostrevant,2018,HAUTS-DE-FRANCE,BOUCHAIN,113,990,1103,
Musée de la Chartreuse,2018,HAUTS-DE-FRANCE,DOUAI,4195,22383,26578,
Musée Municipal d'Escaudain,2018,HAUTS-DE-FRANCE,ESCAUDAIN,0,479,479,
Ecomusée de la Région,2018,HAUTS-DE-FRANCE,FOURMIES,19002,12872,31874,
Musée du Dessin et de l'Estampe Originale,2018,HAUTS-DE-FRANCE,GRAVELINES,2360,7011,9371,
Musée de la Tour Abbatiale,2018,HAUTS-DE-FRANCE,SAINT-AMAND-LES-EAUX,0,8536,8536,
Musée du Château de Compiègne,2018,HAUTS-DE-FRANCE,COMPIEGNE,32004,54444,86448,
Musée Jean Calvin,2018,HAUTS-DE-FRANCE,NOYON,2014,1006,3020,
Musée d'Art et d'Archéologie,2018,HAUTS-DE-FRANCE,SENLIS,3679,7287,10966,
Musée de Boulogne-sur-Mer,2018,HAUTS-DE-FRANCE,BOULOGNE-SUR-MER,13931,19595,33526,
Musée du Touquet Paris-Plage,2018,HAUTS-DE-FRANCE,LE TOUQUET-PARIS-PLAGE,7012,8485,15497,
Musée Français de la Photographie,2018,ILE-DE-FRANCE,BIEVRES,3849,2758,6607,
Musée Dunoyer de Segonzac,2018,ILE-DE-FRANCE,BOUSSY-SAINT-ANTOINE,0,231,231,
Musée du Château,2018,ILE-DE-FRANCE,DOURDAN,6371,9190,15561,
"Albert-Kahn, Musée et Jardin Départementaux",2018,ILE-DE-FRANCE,BOULOGNE-BILLANCOURT,1704,1096,2800,
Musée des Années Trente,2018,ILE-DE-FRANCE,BOULOGNE-BILLANCOURT,6802,10733,17535,
Musée Belmondo et de la Sculpture Figurative du XXè siècle,2018,ILE-DE-FRANCE,BOULOGNE-BILLANCOURT,2298,4874,7172,
Musée d'Histoire Locale - Mémoire de la Ville,2018,ILE-DE-FRANCE,RUEIL-MALMAISON,0,5639,5639,
Musée National des Châteaux de Malmaison et de Bois-Préau,2018,ILE-DE-FRANCE,RUEIL-MALMAISON,48873,32372,81245,
Cité de la céramique - Sèvres & Limoges,2018,ILE-DE-FRANCE,SEVRES,38873,27520,66393,
Galerie d'Anatomie Comparée et de Paléontologie (Muséum d'Histoire Naturelle),2018,ILE-DE-FRANCE,PARIS,101280,160425,261705,
Galerie de Botanique (Muséum National National d'Histoire Naturelle),2018,ILE-DE-FRANCE,PARIS,8036,2428,10464,
Maison de Victor Hugo,2018,ILE-DE-FRANCE,PARIS,42429,133246,175675,
Crypte Archéologique du Parvis Notre-Dame,2018,ILE-DE-FRANCE,PARIS,39069,117206,156275,
Musée National Eugène Delacroix,2018,ILE-DE-FRANCE,PARIS,44311,35988,80299,
Musée de l'Armée,2018,ILE-DE-FRANCE,PARIS,655058,553141,1208199,
Musée de l'Assistance Publique - Hôpitaux de Paris,2018,ILE-DE-FRANCE,PARIS,549,50,599,
Etablissement public du musée d'Orsay et de l'Orangerie - Musée d'Orsay,2018,ILE-DE-FRANCE,PARIS,1850092,1436132,3286224,
Musée de la Vie Romantique,2018,ILE-DE-FRANCE,PARIS,0,62132,62132,
Musée Bourdelle,2018,ILE-DE-FRANCE,PARIS,18500,39322,57822,
Musée de la Franc-Maçonnerie,2018,ILE-DE-FRANCE,PARIS,11392,7405,18797,
Musée Zadkine,2018,ILE-DE-FRANCE,PARIS,32835,0,32835,
"Musée Cognacq-Jay, Musée du XVIIIe siècle de la ville de Paris",2018,ILE-DE-FRANCE,PARIS,23107,44463,67570,
Musée d'Art Moderne de la ville de Paris,2018,ILE-DE-FRANCE,PARIS,282253,254831,537084,
Musée de la Chasse et de la Nature,2018,ILE-DE-FRANCE,PARIS,56110,70929,127039,
Musée des Arts Décoratifs (MAD),2018,ILE-DE-FRANCE,PARIS,153185,133882,287067,
Musée d'Art et d'Histoire du Judaïsme,2018,ILE-DE-FRANCE,PARIS,69157,43361,112518,
Musée de l'Ecole Nationale Supérieure des Beaux-Arts,2018,ILE-DE-FRANCE,PARIS,18222,48641,66863,
Musée des Arts et Métiers,2018,ILE-DE-FRANCE,PARIS,59165,129934,189099,
Musée du Quai Branly - Jacques Chirac,2018,ILE-DE-FRANCE,PARIS,564215,697602,1261817,
L'Adresse Musée de la Poste,2018,ILE-DE-FRANCE,PARIS,11745,0,11745,
Musée Henri Chapu,2018,ILE-DE-FRANCE,LE MEE-SUR-SEINE,0,1370,1370,
Musée Bossuet,2018,ILE-DE-FRANCE,MEAUX,3526,8634,12160,
Ecomusée du Val de Bièvre,2018,ILE-DE-FRANCE,FRESNES,0,4171,4171,
Musée Fragonard,2018,ILE-DE-FRANCE,MAISONS-ALFORT,4273,4630,8903,
Musée du Vieil Argenteuil,2018,ILE-DE-FRANCE,ARGENTEUIL,0,3955,3955,
Musée de la Batellerie et des Voies Navigables,2018,ILE-DE-FRANCE,CONFLANS-SAINTE-HONORINE,8594,2518,11112,
Musée Rambolitrain,2018,ILE-DE-FRANCE,RAMBOUILLET,14566,2414,16980,
Musée Municipal - Collections Paul et André Véra,2018,ILE-DE-FRANCE,SAINT-GERMAIN-EN-LAYE,3413,5778,9191,
Musée Lambinet,2018,ILE-DE-FRANCE,VERSAILLES,9071,6946,16017,
Muséum Agricole et Industriel Stella Matutina,2018,LA REUNION,PITON-SAINT-LEU,85897,7058,92955,
Mémorial de Caen,2018,NORMANDIE,CAEN,334917,54521,389438,
Musée Eugène Boudin,2018,NORMANDIE,HONFLEUR,31330,5482,36812,
Musée Municipal,2018,NORMANDIE,ORBEC,0,978,978,
Musée du Château,2018,NORMANDIE,PONTECOULANT,2564,2705,5269,
Château de Saint-Germain de Livet,2018,NORMANDIE,SAINT-GERMAIN DE LIVET,9104,6868,15972,
Musée et Sites archéologiques de Vieux-la-Romaine,2018,NORMANDIE,VIEUX,6245,17558,23803,
Musée du Verre et de la Pierre,2018,NORMANDIE,CONCHES-EN-OUCHE,2586,1714,4300,
Musée Municipal,2018,NORMANDIE,LOUVIERS Cedex,0,6929,6929,
Musée Quesnel-Morinière,2018,NORMANDIE,COUTANCES,279,5811,6090,
Musée Richard Anacréon,2018,NORMANDIE,GRANVILLE,6711,7250,13961,
Ferme-Musée du Cotentin,2018,NORMANDIE,SAINTE-MERE-EGLISE,7929,1702,9631,
Musée du Château,2018,NORMANDIE,TORIGNI-SUR-VIRE,0,575,575,
Musée Régional du Cidre et du Calvados,2018,NORMANDIE,VALOGNES,1507,927,2434,
Musée des Beaux-Arts et de la Dentelle,2018,NORMANDIE,ALENCON,7719,6992,14711,
Musée du Château de Flers,2018,NORMANDIE,FLERS,1326,5339,6665,
Musée du Prieuré,2018,NORMANDIE,HARFLEUR,182,1990,2172,
Musée de l'Hôtel Dubocage de Bléville,2018,NORMANDIE,LE HAVRE,0,8134,8134,
Musée Départemental Pierre Corneille,2018,NORMANDIE,LE PETIT-COURONNE,0,2700,2700,
Musée Industriel de la Corderie Vallois,2018,NORMANDIE,NOTRE-DAME-DE-BONDEVILLE,0,11329,11329,
Association de l'Horlogerie Aliermontaise,2018,NORMANDIE,SAINT-NICOLAS-D'ALIERMONT,3532,1309,4841,
Cité International de la Bande Dessinée et de l'Image - Musée de la Bande Dessinée,2018,NOUVELLE-AQUITAINE,ANGOULEME,18666,51830,70496,
Musée des Arts du Cognac (Annexe musée municipal),2018,NOUVELLE-AQUITAINE,COGNAC,5979,2693,8672,
Musée de la Mytiliculture,2018,NOUVELLE-AQUITAINE,ESNANDES,4022,1932,5954,
Ancienne École de médecine navale - Musée national de la Marine,2018,NOUVELLE-AQUITAINE,ROCHEFORT,5445,5108,10553,
Musée Archéologique,2018,NOUVELLE-AQUITAINE,SAINTES,510,3335,3845,
Musée Municipal des Cordeliers,2018,NOUVELLE-AQUITAINE,SAINT-JEAN-D'ANGELY,319,7802,8121,
Musée Ernest Cognacq,2018,NOUVELLE-AQUITAINE,SAINT-MARTIN-DE-RE,9047,4500,13547,
Musée Labenche d'Art et d'Histoire,2018,NOUVELLE-AQUITAINE,BRIVE-LA-GAILLARDE,1493,23348,24841,
Musée du Président Jacques Chirac,2018,NOUVELLE-AQUITAINE,SARRAN,11649,3479,15128,
Musée du Cloître de Tulle André Mazeyrie,2018,NOUVELLE-AQUITAINE,TULLE,0,5715,5715,
Musée des Tumulus de Bougon,2018,NOUVELLE-AQUITAINE,BOUGON,13965,2711,16676,
Musée ethnographique et archéologique du Donjon,2018,NOUVELLE-AQUITAINE,NIORT,9006,9733,18739,
Musée Bernard d’Agesci,2018,NOUVELLE-AQUITAINE,NIORT,5756,10476,16232,
Musée du Tabac,2018,NOUVELLE-AQUITAINE,BERGERAC,3681,1455,5136,
Musée Fernand Desmoulin,2018,NOUVELLE-AQUITAINE,BRANTOME EN PERIGORD,31538,4300,35838,
Musée National de la Préhistoire,2018,NOUVELLE-AQUITAINE,LES EYZIES-DE-TAYAC,36445,34867,71312,
Musée Militaire - Souvenir du Périgord,2018,NOUVELLE-AQUITAINE,PERIGUEUX,2218,1000,3218,
Musée des Beaux-Arts et d'Archéologie,2018,NOUVELLE-AQUITAINE,LIBOURNE,0,19213,19213,
Ecomusée de la Grande Lande,2018,NOUVELLE-AQUITAINE,SABRES,73617,14121,87738,
Muséum d'Histoire Naturelle,2018,NOUVELLE-AQUITAINE,BAYONNE,0,27400,27400,
Musée de Préhistoire Raymond Touchard,2018,NOUVELLE-AQUITAINE,LUSSAC-LES-CHATEAUX,2114,3836,5950,
Musée Sainte-Croix,2018,NOUVELLE-AQUITAINE,POITIERS,7997,28767,36764,
Musée des Beaux-Arts,2018,OCCITANIE,CARCASSONNE,0,25110,25110,
Musée du Charroi Rural et de l'Artisanat Traditionnel,2018,OCCITANIE,SALMIECH,0,950,950,
Musée du Colombier,2018,OCCITANIE,ALES,1360,9322,10682,
Musée Paul Dupuy,2018,OCCITANIE,TOULOUSE,3842,15225,19067,
Musée Saint-Raymond,2018,OCCITANIE,TOULOUSE,12023,40253,52276,
Musée Municipal - Musée Trésor,2018,OCCITANIE,LUZ-SAINT-SAUVEUR,0,234,234,
Musée du Vieux Montpellier,2018,OCCITANIE,MONTPELLIER,599,5110,5709,
Musée Fabre,2018,OCCITANIE,MONTPELLIER,226223,68054,294277,
Ecomusée du Mont Lozère,2018,OCCITANIE,LE PONT DE MONTVERT,0,850,850,
Musée des Monnaies et Médailles Joseph Puig,2018,OCCITANIE,PERPIGNAN,0,1824,1824,
Musée des Beaux-Arts,2018,OCCITANIE,GAILLAC,16499,1241,17740,
Musée Départemental du Textile,2018,OCCITANIE,LA-BASTIDE-ROUAIROUX,3961,2011,5972,
Musée du Pays Rabastinois,2018,OCCITANIE,RABASTENS,399,4451,4850,
Musée du Pays de Guérande et de la Porte Saint Michel,2018,PAYS DE LA LOIRE,GUERANDE,25875,11749,37624,
Muséum d'Histoire Naturelle de Nantes,2018,PAYS DE LA LOIRE,NANTES,47681,96819,144500,
Ecomusée de Saint-Nazaire,2018,PAYS DE LA LOIRE,SAINT-NAZAIRE,38043,8795,46838,
Musée des Beaux-Arts,2018,PAYS DE LA LOIRE,ANGERS,30625,95971,126596,
Musée d'Art et d'Histoire,2018,PAYS DE LA LOIRE,CHOLET,1777,14300,16077,
Musée Communal Robert Tatin,2018,PAYS DE LA LOIRE,COSSE-LE-VIVIEN,22285,5568,27853,
Musée Espace Faïence de Malicorne,2018,PAYS DE LA LOIRE,MALICORNE-SUR-SARTHE,5437,5523,10960,
Musée Municipal,2018,PAYS DE LA LOIRE,LA ROCHE-SUR-YON,0,21157,21157,
Musée Picasso,2018,PROVENCE-ALPES-CÔTE D'AZUR,ANTIBES,71844,42985,114829,
Musée Jean Cocteau Collection Séverin Wunderman,2018,PROVENCE-ALPES-CÔTE D'AZUR,MENTON,13752,25787,39539,
Musée Matisse,2018,PROVENCE-ALPES-CÔTE D'AZUR,NICE,85877,73195,159072,
Musée d'Art Moderne et d'Art Contemporain,2018,PROVENCE-ALPES-CÔTE D'AZUR,NICE,48932,83836,132768,
Ecomusée du Pays de la Roudoule,2018,PROVENCE-ALPES-CÔTE D'AZUR,PUGET-ROSTANG,1513,4306,5819,
Musée Granet,2018,PROVENCE-ALPES-CÔTE D'AZUR,AIX-EN-PROVENCE,108111,68951,177062,
Musée Alphonse Daudet,2018,PROVENCE-ALPES-CÔTE D'AZUR,FONTVIEILLE,2034,320,2354,
Musée Ciotaden,2018,PROVENCE-ALPES-CÔTE D'AZUR,LA CIOTAT,1621,1864,3485,
Musée d'Art Contemporain - Galeries Contemporaines,2018,PROVENCE-ALPES-CÔTE D'AZUR,MARSEILLE,7920,16428,24348,
Musée du Vêtement Provençal (Jean Aicard),2018,PROVENCE-ALPES-CÔTE D'AZUR,SOLLIES-VILLE,0,6097,6097,
Muséum d'Histoire Naturelle Esprit Requien,2018,PROVENCE-ALPES-CÔTE D'AZUR,AVIGNON,0,16705,16705,
Synagogue Musée Juif Comtadin,2018,PROVENCE-ALPES-CÔTE D'AZUR,CAVAILLON,3491,1644,5135,
Musée Jean Garcin 39-45 : L'appel de la Liberté,2018,PROVENCE-ALPES-CÔTE D'AZUR,FONTAINE-DE-VAUCLUSE,7060,3154,10214,
Musée Archéologique Théo Desplans,2018,PROVENCE-ALPES-CÔTE D'AZUR,VAISON-LA-ROMAINE,59378,9957,69335,
Musée de l'Arche,2018,ST PIERRE ET MIQUELON,SAINT-PIERRE ET MIQUELON,3054,515,3569,
Musée du Brou,2019,AUVERGNE-RHONE-ALPES,BOURG-EN-BRESSE,61957,36153,98110,M0963
Musée Archéologique,2019,AUVERGNE-RHONE-ALPES,IZERNORE,1703,2820,4523,M0966
Musée Charles-Louis Philippe,2019,AUVERGNE-RHONE-ALPES,CERILLY,25,27,52,M0102
Musée des Sciences,2019,AUVERGNE-RHONE-ALPES,AURILLAC,3009,6229,9238,M7018
Musée d'Art et d'Archéologie,2019,AUVERGNE-RHONE-ALPES,AURILLAC,1491,7683,9174,M0110
Musée de la Haute Auvergne,2019,AUVERGNE-RHONE-ALPES,SAINT-FLOUR,2761,3451,6212,M0113
Musée d'Histoire et d'Archéologie,2019,AUVERGNE-RHONE-ALPES,DIE,890,4673,5563,M0982
Château de Grignan,2019,AUVERGNE-RHONE-ALPES,GRIGNAN,129631,26568,156199,M0983
Musée d'Art Sacré,2019,AUVERGNE-RHONE-ALPES,MOURS SAINT-EUSEBE,0,200,200,M0985
Musée de Bourgoin-Jallieu,2019,AUVERGNE-RHONE-ALPES,BOURGOIN-JALLIEU,0,14053,14053,M0991
Musée de la Résistance de la Déportation de l'Isère,2019,AUVERGNE-RHONE-ALPES,GRENOBLE,0,35345,35345,M0998
Muséum d'Histoire Naturelle,2019,AUVERGNE-RHONE-ALPES,GRENOBLE,11922,70345,82267,M7038
Maison du Patrimoine de Hières-sur-Amby,2019,AUVERGNE-RHONE-ALPES,HIERES-SUR-AMBY,5209,966,6175,M0999
Musée du Pays Matheysin,2019,AUVERGNE-RHONE-ALPES,LA MURE,869,1635,2504,M1002
Musée du Cloître Saint-André-Le-Bas,2019,AUVERGNE-RHONE-ALPES,VIENNE,3497,4967,8464,M1007
Musée de la Soierie,2019,AUVERGNE-RHONE-ALPES,CHARLIEU,4621,1736,6357,M1010
Musée d'Histoire du  20ème Siècle - Résistance et Déportation,2019,AUVERGNE-RHONE-ALPES,ESTIVAREILLES,2324,1129,3453,M1013
Musée d'Art et d'Industrie,2019,AUVERGNE-RHONE-ALPES,SAINT-ETIENNE,22159,16538,38697,M1023
Musée Rural,2019,AUVERGNE-RHONE-ALPES,USSON-EN-FOREZ,3620,805,4425,M1029
Musée d'Archéologie Bargoin,2019,AUVERGNE-RHONE-ALPES,CLERMONT-FERRAND,3457,14434,17891,M0120
Musée Régional d'Auvergne,2019,AUVERGNE-RHONE-ALPES,RIOM,0,3012,3012,M0128
Musées Gadagne,2019,AUVERGNE-RHONE-ALPES,LYON,32536,42043,74579,M1032
Centre d'Histoire de la Résistance et de la Déportation,2019,AUVERGNE-RHONE-ALPES,LYON,40458,24272,64730,M1034
Musée du docteur Faure,2019,AUVERGNE-RHONE-ALPES,AIX-LES-BAINS,6769,10293,17062,M1045
Musée des Beaux-Arts,2019,AUVERGNE-RHONE-ALPES,CHAMBERY,5817,22125,27942,M1048
Musée de l'Académie de La Val d'Isère,2019,AUVERGNE-RHONE-ALPES,MOÛTIERS,27,120,147,M1051
Musée National Magnin,2019,BOURGOGNE-FRANCHE-COMTE,DIJON,7174,10075,17249,M5011
Musée Buffon,2019,BOURGOGNE-FRANCHE-COMTE,MONTBARD,966,8973,9939,M0143
Musée de la résistance et de la Déportation,2019,BOURGOGNE-FRANCHE-COMTE,BESANCON,56260,0,56260,M0335
Musée du Château des Ducs de Wurtemberg,2019,BOURGOGNE-FRANCHE-COMTE,MONTBELIARD,5335,12837,18172,M0337
Musée Départemental de la Montagne Albert Demard,2019,BOURGOGNE-FRANCHE-COMTE,LE HAUT-DU-THEM-CHÂTEAU-LAMBERT,3996,4314,8310,M0355
Musée de la Tour des Echevins,2019,BOURGOGNE-FRANCHE-COMTE,LUXEUIL-LES-BAINS,4019,13424,17443,M0358
Musée Georges Garret,2019,BOURGOGNE-FRANCHE-COMTE,VESOUL,0,4141,4141,M0359
Musée de la Vigne et du Vin,2019,BOURGOGNE-FRANCHE-COMTE,ARBOIS,3044,1207,4251,M0342
Musée du Jouet,2019,BOURGOGNE-FRANCHE-COMTE,MOIRANS-EN-MONTAGNE,38599,10165,48764,M0348
Musée de l'Abbaye/Donations Guy Bardone - René Genis,2019,BOURGOGNE-FRANCHE-COMTE,SAINT-CLAUDE,5412,4644,10056,M1169
Musée du Costume,2019,BOURGOGNE-FRANCHE-COMTE,CHATEAU-CHINON (Ville),2071,691,2762,M0148
Musée Auguste Grasset,2019,BOURGOGNE-FRANCHE-COMTE,VARZY,2219,400,2619,M0159
Musée Saint-Nazaire,2019,BOURGOGNE-FRANCHE-COMTE,BOURBON-LANCY,0,904,904,M0164
Musée Nicéphore Niepce,2019,BOURGOGNE-FRANCHE-COMTE,CHALON-SUR-SAONE,0,25757,25757,M0166
Ecomusée de la Communauté Le Creusot-Monceau-Les-Mines,2019,BOURGOGNE-FRANCHE-COMTE,LE CREUSOT,10310,8670,18980,M0170
Musée des Ursulines,2019,BOURGOGNE-FRANCHE-COMTE,MACON,4089,9430,13519,M0172
Musée de l'Ecole Rurale en Bretagne,2019,BRETAGNE,TREGARVAN,8539,2207,10746,M0209
Musée des Rochers de Sévigné,2019,BRETAGNE,VITRE,1696,450,2146,M0218
Musée du Château de Vitré,2019,BRETAGNE,VITRE,22395,4604,26999,M0216
Ecomusée de l'Île de Groix,2019,BRETAGNE,ILE DE GROIX,4669,1349,6018,M0222
Musée du Faouët,2019,BRETAGNE,LE FAOUET,15433,3050,18483,M1179
Musée du Berry,2019,CENTRE-VAL DE LOIRE,BOURGES,5248,2255,7503,M0230
Musée des Meilleurs Ouvriers de France,2019,CENTRE-VAL DE LOIRE,BOURGES,6233,1779,8012,M0232
Musée Municipal,2019,CENTRE-VAL DE LOIRE,VIERZON,866,7218,8084,M0236
Conservatoire du Machinisme et des Pratiques Agricoles,2019,CENTRE-VAL DE LOIRE,CHARTRES-MAINVILLIERS,7965,15578,23543,M0239
Musée de l'Histoire du Perche,2019,CENTRE-VAL DE LOIRE,NOGENT-LE-ROTROU,9739,9072,18811,M0243
Musée de la Chemiserie et de l'Elégance Masculine,2019,CENTRE-VAL DE LOIRE,ARGENTON-SUR-CREUSE,3368,2945,6313,M0245
Musée Archéologique d'Argentomagus,2019,CENTRE-VAL DE LOIRE,SAINT-MARCEL,6392,4822,11214,M0252
Musée Balzac,2019,CENTRE-VAL DE LOIRE,SACHE,14768,5819,20587,M0262
Musée dU Vin de Touraine,2019,CENTRE-VAL DE LOIRE,TOURS,0,0,0,M0267
Musée des Beaux-Arts,2019,CENTRE-VAL DE LOIRE,TOURS,19226,43578,62804,M0265
Musée Archéologique,2019,CENTRE-VAL DE LOIRE,THESEE,984,0,984,M0276
Musée des Beaux-Arts,2019,CENTRE-VAL DE LOIRE,ORLEANS,9309,30641,39950,M0286
Musée Palais Fesch,2019,CORSE,AJACCIO,25203,19277,44480,M0324
Musée National de la Maison Bonaparte,2019,CORSE,AJACCIO,60363,33602,93965,M5046
Musée de Préhistoire Corse,2019,CORSE,SARTENE,4497,5897,10394,M0327
Musée d'Histoire de Bastia,2019,CORSE,BASTIA,18927,15105,34032,M0329
Musée de la Corse,2019,CORSE,CORTE,56807,11001,67808,M0330
Musée du Château-Fort,2019,GRAND EST,SEDAN,52279,7574,59853,M0296
Maison de l'Outil  et de la Pensée Ouvrière,2019,GRAND EST,TROYES,17643,5280,22923,M0306
Musée du Fer,2019,GRAND EST,REICHSHOFFEN,712,1517,2229,M0011
Musée Historique,2019,GRAND EST,STRASBOURG,30714,35380,66094,M0020
Musée Archéologique,2019,GRAND EST,STRASBOURG,26173,29223,55396,M0015
Musée des Arts Décoratifs,2019,GRAND EST,STRASBOURG,38732,40801,79533,M0018
Musée d'Art et d'Histoire,2019,GRAND EST,LANGRES,6029,3917,9946,M0321
Musée Municipal,2019,GRAND EST,SAINT-DIZIER,0,4390,4390,M0323
Musée des Beaux-Arts,2019,GRAND EST,MULHOUSE,0,19743,19743,M0033
Musée des Amis de Thann,2019,GRAND EST,THANN,459,1393,1852,M0047
Musée Saint-Rémi,2019,GRAND EST,REIMS,7009,18273,25282,M0312
Musée Les Sources d'Hercule,2019,GRAND EST,DENEUVRE,1602,873,2475,M0507
Musée de l'Histoire du Fer,2019,GRAND EST,JARVILLE-LA-MALGRANGE,5427,10200,15627,M0509
Musée des Beaux-Arts de Nancy,2019,GRAND EST,NANCY,41567,79567,121134,M0512
Musée Départemental Raymond Poincaré,2019,GRAND EST,SAMPIGNY,0,4731,4731,M0521
Musée d'Argonne,2019,GRAND EST,VARENNES-EN-ARGONNE,1189,0,1189,M0523
Musée Militaire et Erckmann-Chatrian,2019,GRAND EST,PHALSBOURG,350,0,350,M0531
Moulin de la Blies - Musée des Techniques Faïencières,2019,GRAND EST,SARREGUEMINES,12563,18653,31216,M0533
Musée de la Lutherie et de l'Archèterie Française,2019,GRAND EST,MIRECOURT,5302,3185,8487,M0538
Ecomusée de Marie-Galante,2019,GUADELOUPE,GRAND-BOURG de MARIE-GALANTE,0,44787,44787,M1059
Musée Départemental Matisse,2019,HAUTS-DE-France,LE CATEAU-CAMBRESIS,38520,15530,54050,M0627
"Centre Historique Minier, Musée de la Mine, Centre d'Archives, Centre de Culture Scientifique de l'Energie",2019,HAUTS-DE-France,LEWARDE,150264,7496,157760,M0628
La Piscine - Musée d'Art et d'Industrie André Diligent de Roubaix,2019,HAUTS-DE-France,ROUBAIX,168999,111485,280484,M0634
Musée de la Tour Abbatiale,2019,HAUTS-DE-France,SAINT-AMAND-LES-EAUX,0,10534,10534,M0635
Musée du Noyonnais,2019,HAUTS-DE-France,NOYON,817,1257,2074,M0807
Musée de la Vénerie,2019,HAUTS-DE-France,SENLIS,1651,3091,4742,M0810
Musée du Touquet Paris-Plage,2019,HAUTS-DE-France,LE TOUQUET-PARIS-PLAGE,7765,7087,14852,M0648
Musée Dunoyer de Segonzac,2019,ILE-DE-France,BOUSSY-SAINT-ANTOINE,0,172,172,M0402
Musée du Château,2019,ILE-DE-France,DOURDAN,4476,6384,10860,M0404
Musée Municipal d'Art et d'Histoire,2019,ILE-DE-France,COLOMBES,0,3342,3342,M0409
Musée de la Libération de Paris - Musée du Général Leclerc - Musée Jean Moulin,2019,ILE-DE-France,PARIS,0,49570,49570,M1109
Etablissement public du musée d'Orsay et de l'Orangerie - Musée d'Orsay,2019,ILE-DE-France,PARIS,2010889,1640727,3651616,M5060
Musée du Service de Santé des Armées du Val-de-Grâce,2019,ILE-DE-France,PARIS,9508,4475,13983,M9024
Musée National Jean-Jacques Henner,2019,ILE-DE-France,PARIS,22468,17120,39588,M5039
Musée de l'Armée,2019,ILE-DE-France,PARIS,672810,579285,1252095,M5025
Crypte Archéologique du Parvis Notre-Dame,2019,ILE-DE-France,PARIS,18359,7058,25417,
Les Catacombes,2019,ILE-DE-France,PARIS,537503,64397,601900,
Maison de Victor Hugo,2019,ILE-DE-France,PARIS,6726,64418,71144,M1114
Musée National de la Légion d'Honneur et des Ordres de Chevalerie,2019,ILE-DE-France,PARIS,0,46619,46619,M5059
Musée des Arts et Métiers,2019,ILE-DE-France,PARIS,81371,138969,220340,M5065
Institut du Monde Arabe,2019,ILE-DE-France,PARIS,238591,1191,239782,M0365
Maison Natale de Louis Braille,2019,ILE-DE-France,COUPVRAY,4928,1078,6006,M0373
Château-musée de Nemours,2019,ILE-DE-France,NEMOURS,5346,4992,10338,M0381
Musée de Provins et du Provinois,2019,ILE-DE-France,PROVINS,14994,4797,19791,M0383
Musée de l'Air et de l'Espace,2019,ILE-DE-France,LE BOURGET,177794,137993,315787,M5024
Musée Fragonard,2019,ILE-DE-France,MAISONS-ALFORT,4725,4952,9677,M5064
Musée du Jouet Pierre Pinel,2019,ILE-DE-France,POISSY,7625,7190,14815,M0394
Musée du Père Pinchon,2019,MARTINIQUE,FORT-DE-FRANCE,0,7179,7179,M1181
Mémorial de Caen,2019,NORMANDIE,CAEN,473000,77000,550000,M0659
Musée de la Meunerie - Moulin de Marcy,2019,NORMANDIE,LE MOLAY-LITTRY,1883,599,2482,M0664
Musée d'Art et d'Histoire de Lisieux,2019,NORMANDIE,LISIEUX,104,8008,8112,M0665
Musée du Château,2019,NORMANDIE,PONTECOULANT,2859,2716,5575,M0667
Château de Saint-Germain de Livet,2019,NORMANDIE,SAINT-GERMAIN-DE-LIVET,9098,9676,18774,M0668
Paléospace,2019,NORMANDIE,VILLERS-SUR-MER,57314,7281,64595,M7063
Musée Municipal,2019,NORMANDIE,BERNAY,1517,6186,7703,M0701
Musée Municipal d'Avranches,2019,NORMANDIE,AVRANCHES,2621,3115,5736,M0673
"Musée du Bocage Normand, ferme du bois Jugan",2019,NORMANDIE,SAINT-LÔ,1386,3391,4777,M0686
Musée des Beaux-Arts et de la Dentelle,2019,NORMANDIE,ALENCON,4915,7832,12747,M0694
Musée des Traditions et Arts Normands,2019,NORMANDIE,MARTAINVILLE-EPREVILLE,13070,12064,25134,M0725
Musée Régional de Fouras,2019,NOUVELLE-AQUITAINE,FOURAS,8487,1639,10126,M0824
Musée Municipal des Cordeliers,2019,NOUVELLE-AQUITAINE,SAINT-JEAN-D'ANGELY,740,8774,9514,M0832
Musée de la Mémoire et des Industries Tullistes,2019,NOUVELLE-AQUITAINE,TULLE,0,2189,2189,M1191
Musée ethnographique et archéologique du Donjon,2019,NOUVELLE-AQUITAINE,NIORT,10264,10003,20267,M0842
Musée Henri Barré,2019,NOUVELLE-AQUITAINE,THOUARS,489,2007,2496,M0845
Musée de la Voiture à Cheval. Au temps des calèches,2019,NOUVELLE-AQUITAINE,BOURG-SUR-GIRONDE,3941,1378,5319,M0070
Musée Départemental d'Histoire et d'Archéologie,2019,NOUVELLE-AQUITAINE,HASTINGUES,4692,4271,8963,M0078
Ecomusée de la Grande Lande,2019,NOUVELLE-AQUITAINE,SABRES,71701,13327,85028,M0080
Musée d'Art et d'Histoire du Cap de Gascogne,2019,NOUVELLE-AQUITAINE,SAINT-SEVER,791,1809,2600,M0084
Musée du Château Henri IV,2019,NOUVELLE-AQUITAINE,NERAC,10774,4090,14864,M0089
Musée Municipal de Guéthary,2019,NOUVELLE-AQUITAINE,GUETHARY,0,2591,2591,M0096
Musée National du Château,2019,NOUVELLE-AQUITAINE,PAU,56528,60636,117164,M5017
Musée d'Art et d'Histoire de Montmorillon,2019,NOUVELLE-AQUITAINE,MONTMORILLON,38,4000,4038,M0851
Musée Sainte-Croix,2019,NOUVELLE-AQUITAINE,POITIERS,4905,34155,39060,M0852
Musée Départemental de l'Ariège,2019,OCCITANIE,FOIX,76977,5488,82465,M0543
Palais-Musée des Archevêques de Narbonne,2019,OCCITANIE,NARBONNE,28749,26132,54881,M0445
Musée des Corbières,2019,OCCITANIE,SIGEAN,189,1030,1219,M0447
Musée Fenaille,2019,OCCITANIE,RODEZ,22088,9208,31296,M0551
Musée des Beaux-Arts Denys Puech,2019,OCCITANIE,RODEZ,0,10866,10866,M0550
Musée Léon Alègre,2019,OCCITANIE,BAGNOLS-SUR-CEZE,0,1396,1396,M0450
Musée Municipal de la Vignasse,2019,OCCITANIE,BEAUCAIRE,557,2240,2797,M0451
Musée de la Romanité,2019,OCCITANIE,NÎMES,156458,65470,221928,M0455
Musée de l'Armagnac,2019,OCCITANIE,CONDOM,724,265,989,M0570
Musée Archéologique,2019,OCCITANIE,SAINT-BERTRAND-DE-COMMINGES,0,14216,14216,M0560
"Les Abattoirs, Musée d'Art Moderne et Contemporain",2019,OCCITANIE,TOULOUSE,87343,125410,212753,M0566
Musée Agathois,2019,OCCITANIE,AGDE,2344,2176,4520,M0466
Musée de l'Ephèbe,2019,OCCITANIE,LE CAP D'AGDE,14790,7210,22000,M0465
Muséum d'Histoire Naturelle,2019,OCCITANIE,BEZIERS,20,0,20,M7023
Musée des Beaux-Arts de Béziers,2019,OCCITANIE,BEZIERS,1211,1254,2465,M0467
Musée Municipal,2019,OCCITANIE,FRONTIGNAN-LA-PEYRADE,0,3038,3038,M0470
Site Archéologique Lattara - Musée Henri Prades de Montpellier Agglomération,2019,OCCITANIE,LATTES,11812,9776,21588,M0472
Musée Louis Médard,2019,OCCITANIE,LUNEL,0,9322,9322,M1205
Musée Archéologique Paul Soyris,2019,OCCITANIE,MURVIEL-LES-MONTPELLIER,325,723,1048,M0481
Musée de Préhistoire Amédée Lémozi,2019,OCCITANIE,CABRERETS,76956,0,76956,M0575
Musée Gallo-Romain d'Uxellodunum,2019,OCCITANIE,MARTEL,302,475,777,M0581
Musée de l'Automate,2019,OCCITANIE,SOUILLAC,12631,1907,14538,M0584
Musée d'Art Moderne - Fonds Peskè,2019,OCCITANIE,COLLIOURE,7753,1777,9530,M0489
Musée de Tautavel,2019,OCCITANIE,TAUTAVEL,50175,5575,55750,M0498
Musée Jean Jaurès,2019,OCCITANIE,CASTRES,2102,6974,9076,M0595
Musée Goya,2019,OCCITANIE,CASTRES,17915,5950,23865,M0594
Archéosite de Montans,2019,OCCITANIE,MONTANS,6325,1904,8229,M1210
Musée du Vieil Auvillar,2019,OCCITANIE,AUVILLAR,2366,851,3217,M0604
Musée des arts et traditions populaires (Abbaye),2019,OCCITANIE,MOISSAC,54660,11254,65914,M0606
Musée des Marais Salant,2019,PAYS DE LA LOIRE,BATZ-SUR-MER,14270,7220,21490,M1124
Musée du Château des Ducs de Bretagne,2019,PAYS DE LA LOIRE,NANTES,123384,185479,308863,M0744
Musée Joseph Denais,2019,PAYS DE LA LOIRE,BEAUFORT-EN-VALLEE,5058,2883,7941,M0753
Musée de la Vigne et du Vin d'Anjou,2019,PAYS DE LA LOIRE,SAINT LAMBERT-DU-LATTAY - VAL-DU-LAYON,4329,629,4958,M0758
Musée de Tessé,2019,PAYS DE LA LOIRE,LE MANS,20755,16321,37076,M0770
Musée ornithologique Charles-Payraudeau,2019,PAYS DE LA LOIRE,LA CHAIZE-LE-VICOMTE,286,656,942,M7039
Musée d'Art et d'Histoire de Provence,2019,PROVENCE-ALPES-CÔTE D'AZUR,GRASSE,3198,14345,17543,M0875
Musée Matisse,2019,PROVENCE-ALPES-CÔTE D'AZUR,NICE,76397,64782,141179,M0884
"Musée Magnelli, Musée de la Céramique",2019,PROVENCE-ALPES-CÔTE D'AZUR,VALLAURIS,15950,12387,28337,M0892
Musée National de Vallauris (la Guerre et la Paix de Picasso),2019,PROVENCE-ALPES-CÔTE D'AZUR,VALLAURIS,15950,6876,22826,M5047
Muséum d'Histoire Naturelle,2019,PROVENCE-ALPES-CÔTE D'AZUR,AIX-EN-PROVENCE,214,11054,11268,M7064
Musée de la Légion Etrangère,2019,PROVENCE-ALPES-CÔTE D'AZUR,AUBAGNE & PUYLOUBIER,0,27000,27000,M9003
Musée d'Histoire de Marseille,2019,PROVENCE-ALPES-CÔTE D'AZUR,MARSEILLE,23496,58760,82256,M0918
Musée des Beaux-Arts de Marseille,2019,PROVENCE-ALPES-CÔTE D'AZUR,MARSEILLE,10921,41643,52564,M0913
Musée d'Art Contemporain - Galeries Contemporaines,2019,PROVENCE-ALPES-CÔTE D'AZUR,MARSEILLE,629,5970,6599,M1094
"Musée des Arts décoratifs, de la Faïence et de la Mode",2019,PROVENCE-ALPES-CÔTE D'AZUR,MARSEILLE,8499,28344,36843,M0914
Musée Municipal Paul Lafran,2019,PROVENCE-ALPES-CÔTE D'AZUR,SAINT-CHAMAS,0,4414,4414,M0925
Musée de l'Artillerie,2019,PROVENCE-ALPES-CÔTE D'AZUR,DRAGUIGNAN,0,13339,13339,M9007
Musée de l'Annonciade,2019,PROVENCE-ALPES-CÔTE D'AZUR,SAINT-TROPEZ,33477,7639,41116,M0941
Musée Comtadin-Duplessis,2019,PROVENCE-ALPES-CÔTE D'AZUR,CARPENTRAS,0,4032,4032,M0949
Domaine des Saveurs - Les Planons,2020,AUVERGNE-RHONE-ALPES,SAINT-CYR-SUR-MENTHON,2919,4800,7719,M0972
Musée Gallo-Romain,2020,AUVERGNE-RHONE-ALPES,NERIS-LES-BAINS,201,350,551,M0107
Musée des Vans,2020,AUVERGNE-RHONE-ALPES,LES VANS,108,389,497,M0977
Musée et Site Archéologiques,2020,AUVERGNE-RHONE-ALPES,SOYONS,9805,1419,11224,M0980
Musée du Château des Adhémars,2020,AUVERGNE-RHONE-ALPES,MONTELIMAR,14403,627,15030,M0984
Musée des Vallées de Thônes,2020,AUVERGNE-RHONE-ALPES,THONES,307,183,490,M1056
Musée Jadis Allevard,2020,AUVERGNE-RHONE-ALPES,ALLEVARD-LES-BAINS,1286,0,1286,M1123
Musée Stendhal,2020,AUVERGNE-RHONE-ALPES,GRENOBLE,260,532,792,M0995
Maison du Patrimoine de Hières-sur-Amby,2020,AUVERGNE-RHONE-ALPES,HIERES-SUR-AMBY,1206,0,1206,M0999
Musée Hector Berlioz,2020,AUVERGNE-RHONE-ALPES,LA CÔTE-SAINT-ANDRE,0,5367,5367,M1001
Musée des Beaux-Arts et d'Archéologie,2020,AUVERGNE-RHONE-ALPES,VIENNE,766,0,766,M1005
Musée d'Histoire du  20ème Siècle - Résistance et Déportation,2020,AUVERGNE-RHONE-ALPES,ESTIVAREILLES,901,233,1134,M1013
Musée des Civilisations : Daniel Pouget,2020,AUVERGNE-RHONE-ALPES,SAINT-JUST-SAINT-RAMBERT,581,1348,1929,M1028
Musée Rural,2020,AUVERGNE-RHONE-ALPES,USSON-EN-FOREZ,1412,445,1857,M1029
Muséum d'Histoire Naturelle Henri-Lecoq,2020,AUVERGNE-RHONE-ALPES,CLERMONT-FERRAND,2841,8621,11462,M7032
Musée Départemental de la Céramique Gallo-Romaine,2020,AUVERGNE-RHONE-ALPES,LEZOUX,1611,3276,4887,M0123
Musée Municipal de la Coutellerie,2020,AUVERGNE-RHONE-ALPES,THIERS,5810,2015,7825,M0129
Centre d'Histoire de la Résistance et de la Déportation,2020,AUVERGNE-RHONE-ALPES,LYON,9694,12541,22235,M1034
Musée archéologique et minéralogique Pierre Borrione,2020,AUVERGNE-RHONE-ALPES,AIME-EN-TARENTAISE Cedex,193,366,559,M1043
Musée Alésia - Centre d'Interprétation,2020,BOURGOGNE-FRANCHE-COMTE,ALISE-SAINTE-REINE,30658,9846,40504,M0131
Musée du Vin de Bourgogne,2020,BOURGOGNE-FRANCHE-COMTE,BEAUNE,5210,1064,6274,M0133
Musée des Beaux-Arts,2020,BOURGOGNE-FRANCHE-COMTE,BEAUNE,2865,865,3730,M0134
Musée du Pays Châtillonnais - Trésor de Vix,2020,BOURGOGNE-FRANCHE-COMTE,CHATILLON-SUR-SEINE,6433,1293,7726,M0136
Musée-Maison Natale Gustave Courbet,2020,BOURGOGNE-FRANCHE-COMTE,ORNANS,13681,9468,23149,M0339
Musée René Davoine,2020,BOURGOGNE-FRANCHE-COMTE,CHAROLLES,0,42,42,M0167
Ecomusée de la Communauté Le Creusot-Monceau-Les-Mines,2020,BOURGOGNE-FRANCHE-COMTE,LE CREUSOT Cedex,2174,10521,12695,M0170
Cabinet d'un Amateur - Donation Maurice Jardot,2020,BOURGOGNE-FRANCHE-COMTE,BELFORT Cedex,733,3284,4017,M1075
Forge-Musée,2020,BOURGOGNE-FRANCHE-COMTE,ETUEFFONT,359,131,490,M0362
Musée de l'Aventure du Son,2020,BOURGOGNE-FRANCHE-COMTE,SAINT-FARGEAU,648,59,707,M1189
Musée Villeneuvien,2020,BOURGOGNE-FRANCHE-COMTE,VILLENEUVE-SUR-YONNE,0,2091,2091,M0192
Musée National de la Marine,2020,BRETAGNE,BREST,15806,15483,31289,M5026
Musée de la Pêche,2020,BRETAGNE,CONCARNEAU,13390,9191,22581,M0199
Le Port-Musée,2020,BRETAGNE,DOUARNENEZ,200,17715,17915,M0200
Musée de l'Ancienne Abbaye de Landévennec,2020,BRETAGNE,LANDEVENNEC,17126,2274,19400,M1200
Ecomusée d'Ouessant - Vivre sur une Ile,2020,BRETAGNE,OUESSANT,4398,370,4768,M0203
Ecomusée de la Bintinais,2020,BRETAGNE,RENNES,2684,33926,36610,M0213
Musée du Faouët,2020,BRETAGNE,LE FAOUET,9916,2090,12006,M1179
Musée National de la Marine,2020,BRETAGNE,PORT-LOUIS,26660,18533,45193,M5026
Musée d'Histoire Naturelle Gabriel Foucher,2020,CENTRE-VAL DE LOIRE,BOURGES,11847,12802,24649,M7028
Musée des Beaux-Arts et d'Histoire Naturelle,2020,CENTRE-VAL DE LOIRE,CHATEAUDUN,1366,1332,2698,M0240
Musée Marcel Proust,2020,CENTRE-VAL DE LOIRE,ILLIERS-COMBRAY,3730,578,4308,M0242
Musée de l'Histoire du Perche,2020,CENTRE-VAL DE LOIRE,NOGENT-LE-ROTROU,8085,3781,11866,M0243
Musée George Sand et de la Vallée Noire,2020,CENTRE-VAL DE LOIRE,LA CHATRE,890,340,1230,M0250
Musée Balzac,2020,CENTRE-VAL DE LOIRE,SACHE,8274,2859,11133,M0262
Musée de Vendôme,2020,CENTRE-VAL DE LOIRE,VENDOME,0,6768,6768,M0277
"Château-Musée de Gien : chasse, histoire et nature en Val de Loire",2020,CENTRE-VAL DE LOIRE,GIEN Cedex,7555,1065,8620,M0282
Musée de la Maison de la Dernière Cartouche,2020,GRAND EST,BAZEILLES,905,720,1625,M0290
Musée du Fer,2020,GRAND EST,REICHSHOFFEN,0,397,397,M0011
Musée d'Art Moderne et Contemporain de Strasbourg,2020,GRAND EST,STRASBOURG,28504,36156,64660,M0016
Musée de la Bataille du 6 Août 1870,2020,GRAND EST,WŒRTH,1232,629,1861,M0023
Musée de la Coutellerie,2020,GRAND EST,NOGENT,1915,406,2321,M0322
Cité du Train,2020,GRAND EST,MULHOUSE,33955,9751,43706,M0036
Musée du Dolder,2020,GRAND EST,RIQUEWIHR,1793,413,2206,M0043
Musée du Papier Peint,2020,GRAND EST,RIXHEIM Cedex,3125,360,3485,M0044
Musée Garinet,2020,GRAND EST,CHÂLONS-EN-CHAMPAGNE,153,287,440,M0308
Musée des Beaux-Arts de Nancy,2020,GRAND EST,NANCY,20506,39276,59782,M0512
Palais des ducs de Lorraine - Musée Historique Lorrain,2020,GRAND EST,NANCY,0,41956,41956,M0514
Musée Barrois,2020,GRAND EST,BAR-LE-DUC,1741,2400,4141,M0517
Musée d'Art Sacré de la Meuse,2020,GRAND EST,SAINT-MIHIEL,674,530,1204,M0520
Musée du Pays de Sarrebourg,2020,GRAND EST,SARREBOURG,3631,3434,7065,M0532
La Tour aux Puces - Musée du Pays Thionvillois,2020,GRAND EST,THIONVILLE Cedex,856,4487,5343,M0534
Musée des Cultures Guyanaises,2020,GUYANE,CAYENNE,184,1729,1913,M1064
Familistère de Guise,2020,HAUTS-DE-France,GUISE,19055,3175,22230,M0787
Musée Alexandre Dumas,2020,HAUTS-DE-France,VILLERS COTTERETS,319,542,861,M0796
Musée Benoît de Puydt,2020,HAUTS-DE-France,BAILLEUL,521,2790,3311,M0611
Musée Municipal de Cambrai,2020,HAUTS-DE-France,CAMBRAI,569,3275,3844,M0615
Musée Gallé-Juillet,2020,HAUTS-DE-France,CREIL,2288,793,3081,M0805
Musée de la Nacre et de la Tabletterie,2020,HAUTS-DE-France,MERU,5260,2502,7762,M1117
Musée Français de la Carte à Jouer,2020,ILE-DE-France,ISSY-LES-MOULINEAUX,3503,8005,11508,M0411
Musée National Gustave Moreau,2020,ILE-DE-France,PARIS,7977,10485,18462,M5041
Musée d'Art Moderne de la ville de Paris,2020,ILE-DE-France,PARIS,93935,195084,289019,M1101
Musée Nissim de Camondo (Les Arts Décoratifs),2020,ILE-DE-France,PARIS,11019,7667,18686,M5073
Musée Carnavalet-Histoire de Paris,2020,ILE-DE-France,PARIS,0,1324,1324,M1104
"Petit Palais, Musée des Beaux-Arts de la ville de Paris",2020,ILE-DE-France,PARIS,87594,262947,350541,M1111
Musée de la Franc-Maçonnerie,2020,ILE-DE-France,PARIS,4269,2027,6296,M0366
Musée du Quai Branly - Jacques Chirac,2020,ILE-DE-France,PARIS,265767,173037,438804,M5055
Musée de la Poste,2020,ILE-DE-France,PARIS,15967,5240,21207,M1116
Musée Henri Chapu,2020,ILE-DE-France,LE MEE-SUR-SEINE,0,850,850,M0377
Musée de Provins et du Provinois,2020,ILE-DE-France,PROVINS,10795,774,11569,M0383
Musée de Nogent-Sur-Marne,2020,ILE-DE-France,NOGENT-SUR-MARNE,295,2095,2390,M0427
ARCHEA - Archéologie en Pays de France,2020,ILE-DE-France,LOUVRES,3824,2417,6241,M0436
Musée National de Port Royal des Champs,2020,ILE-DE-France,MAGNY-LES-HAMEAUX,2437,16349,18786,M5045
Musée du Domaine Royal de Marly,2020,ILE-DE-France,MARLY-LE-ROI,6207,2324,8531,M0390
Musée Rambolitrain,2020,ILE-DE-France,RAMBOUILLET,6259,642,6901,M0395
Musée Municipal - Collections Paul et André Véra,2020,ILE-DE-France,SAINT-GERMAIN-EN-LAYE,935,1744,2679,M0397
Musée Lambinet,2020,ILE-DE-France,VERSAILLES,5506,2611,8117,M0400
Mémorial de Caen,2020,NORMANDIE,CAEN,172973,0,172973,M0659
Musée et Sites archéologiques de Vieux-la-Romaine,2020,NORMANDIE,VIEUX,3321,3941,7262,M1077
Musée du Verre et de la Pierre,2020,NORMANDIE,CONCHES-EN-OUCHE,0,1727,1727,M0702
Musée Municipal Nicolas Poussin,2020,NORMANDIE,LES ANDELYS,905,987,1892,M0705
Musée Alfred Canel,2020,NORMANDIE,PONT-AUDEMER,182,3841,4023,M0707
Musée du Poiré,2020,NORMANDIE,BARENTON,170,2856,3026,M0674
Musée du Vieux Château,2020,NORMANDIE,BRICQUEBEC-EN-COTENTIN,630,246,876,M0675
Musée Quesnel-Morinière,2020,NORMANDIE,COUTANCES,31,3677,3708,M0680
Musée Municipal - Musée du Jouet,2020,NORMANDIE,LA FERTE-MACE,524,77,601,M0697
"Les Pêcheries, Musée de Fécamp",2020,NORMANDIE,FECAMP,20105,11587,31692,M0715
Musée Industriel de la Corderie Vallois,2020,NORMANDIE,NOTRE-DAME-DE-BONDEVILLE,1429,5520,6949,M0728
Musée Victor Hugo,2020,NORMANDIE,RIVES-EN-SEINE,2951,2097,5048,M0736
Musée des Antiquités de la Seine-Maritime,2020,NORMANDIE,ROUEN,5418,19968,25386,M0733
Association de l'Horlogerie Aliermontaise,2020,NORMANDIE,SAINT-NICOLAS-D'ALIERMONT,1426,954,2380,M0735
Cité International de la Bande Dessinée et de l'Image - Musée de la Bande Dessinée,2020,NOUVELLE-AQUITAINE,ANGOULEME,14532,12223,26755,M0820
Musée Régional de Fouras,2020,NOUVELLE-AQUITAINE,FOURAS,4670,1430,6100,M0824
Musée de l'Echevinage,2020,NOUVELLE-AQUITAINE,SAINTES,567,725,1292,M0837
Musée Ernest Cognacq,2020,NOUVELLE-AQUITAINE,SAINT-MARTIN-DE-RE,5330,3028,8358,M0833
Musée de l'Ile d'Oléron,2020,NOUVELLE-AQUITAINE,SAINT-PIERRE D'OLERON,5680,1296,6976,M0834
Musée du Pays d'Ussel,2020,NOUVELLE-AQUITAINE,USSEL,277,1605,1882,M0501
Musée de Bressuire,2020,NOUVELLE-AQUITAINE,BRESSUIRE,0,718,718,M0840
Musée d'Art et d'Archéologie du Périgord (MAAP),2020,NOUVELLE-AQUITAINE,PERIGUEUX,4355,5055,9410,M0057
Musée Despiau-Wlérick,2020,NOUVELLE-AQUITAINE,MONT-DE-MARSAN,3697,0,3697,M0081
Musée de la Chalosse,2020,NOUVELLE-AQUITAINE,MONTFORT-EN-CHALOSSE,410,142,552,M0082
Musée Municipal Albert Marzelles,2020,NOUVELLE-AQUITAINE,MARMANDE,0,2437,2437,M0088
Musée Bonnat-Helleu - Musée des Beaux-Arts de Bayonne,2020,NOUVELLE-AQUITAINE,BAYONNE,0,3769,3769,M0094
Musée Bernadotte,2020,NOUVELLE-AQUITAINE,PAU,14,2634,2648,M0099
"Le Grand Atelier : Musée d'Art et d'Industrie ex Musée de la Moto, de l'Automobile et du Vélo",2020,NOUVELLE-AQUITAINE,CHATELLERAULT,3700,3776,7476,M0847
Musée de la Forge,2020,OCCITANIE,MONTGAILHARD,11899,0,11899,M1091
Musée Archéologique du Lauragais,2020,OCCITANIE,CASTELNAUDARY,0,1079,1079,M0441
Musée Régional de Géologie Pierre Vetter,2020,OCCITANIE,DECAZEVILLE,0,286,286,M7066
Musée des Arts et Métiers Traditionnels,2020,OCCITANIE,SALLES-LA-SOURCE,245,2156,2401,M0553
Musée du Charroi Rural et de l'Artisanat Traditionnel,2020,OCCITANIE,SALMIECH,0,400,400,M0554
Musée du Colombier,2020,OCCITANIE,ALES,234,3320,3554,M0449
Carré d'Art Musée d'Art Contemporain de Nîmes,2020,OCCITANIE,NÎMES,5150,5817,10967,M0459
Musée Départemental d'Art Sacré du Gard,2020,OCCITANIE,PONT-SAINT-ESPRIT,24,3939,3963,M0461
Musée des Amériques - Auch,2020,OCCITANIE,AUCH,4759,3019,7778,M0569
Musée de l'Armagnac,2020,OCCITANIE,CONDOM,0,154,154,M0570
Musée Campanaire,2020,OCCITANIE,L'ISLE-JOURDAIN,1635,698,2333,M0573
Musée des Beaux-Arts et des Arts Décoratifs,2020,OCCITANIE,MIRANDE,0,1508,1508,M0574
Musée des Augustins,2020,OCCITANIE,TOULOUSE,0,2023,2023,M0562
Musée Georges Labit,2020,OCCITANIE,TOULOUSE,4741,11312,16053,M0564
"Les Abattoirs, Musée d'Art Moderne et Contemporain",2020,OCCITANIE,TOULOUSE,23480,25267,48747,M0566
Musée des Beaux-Arts de Béziers,2020,OCCITANIE,BEZIERS,778,689,1467,M0467
Musée Louis Médard,2020,OCCITANIE,LUNEL,0,4118,4118,M1205
Musée Fabre,2020,OCCITANIE,MONTPELLIER,39806,50876,90682,M0476
Musée de Préhistoire Amédée Lémozi,2020,OCCITANIE,CABRERETS,0,52752,52752,M0575
Musée de l'Automate,2020,OCCITANIE,SOUILLAC,7669,773,8442,M0584
Musée d'Art Moderne - Fonds Peskè,2020,OCCITANIE,COLLIOURE,6397,1738,8135,M0489
Musée du Castillet Casa Pairal,2020,OCCITANIE,PERPIGNAN,7965,8123,16088,M0494
Musée Départemental du Textile,2020,OCCITANIE,LA-BASTIDE-ROUAIROUX,0,1944,1944,M0600
Musée du Pays de Cocagne,2020,OCCITANIE,LAVAUR,1094,2405,3499,M0601
Musée Pincé,2020,PAYS DE LA LOIRE,ANGERS,0,9400,9400,M0749
Château-Musée de Saumur,2020,PAYS DE LA LOIRE,SAUMUR,53653,9139,62792,M0759
Musée des Tisserands Mayennais,2020,PAYS DE LA LOIRE,AMBRIERES-LES-VALLEES,108,5,113,M0761
Musée d'Art et d'Archéologie Hôtel Fouquet,2020,PAYS DE LA LOIRE,CHATEAU-GONTIER,68,744,812,M0762
Musée Archéologique Départemental de Jublains,2020,PAYS DE LA LOIRE,JUBLAINS,8055,1788,9843,M0765
Musée du Vieux Château,2020,PAYS DE LA LOIRE,LAVAL,3606,12007,15613,M0766
Ecomusée du Marais Breton Vendéen,2020,PAYS DE LA LOIRE,LA BARRE-DE-MONTS,8002,1192,9194,M0774
Musée de l'Abbaye de Sainte-Croix,2020,PAYS DE LA LOIRE,LES SABLES-D'OLONNE,3590,11632,15222,M0778
Musée La Bourrine du Bois-Juquaud,2020,PAYS DE LA LOIRE,SAINT-HILAIRE-DE-RIEZ,2529,919,3448,M1132
Musée du masque de Fer et du Fort Royal,2020,PROVENCE-ALPES-CÔTE D'AZUR,CANNES,24627,17549,42176,M0873
Musée International de la Parfumerie,2020,PROVENCE-ALPES-CÔTE D'AZUR,GRASSE,34212,15799,50011,M0877
Musée Jean Cocteau Collection Séverin Wunderman,2020,PROVENCE-ALPES-CÔTE D'AZUR,MENTON,6623,0,6623,M0879
Musée des Beaux-Arts Jules Chéret,2020,PROVENCE-ALPES-CÔTE D'AZUR,NICE,1319,4228,5547,M0880
Musée d'Art Naïf Anatole Jakovsky,2020,PROVENCE-ALPES-CÔTE D'AZUR,NICE,1260,3140,4400,M0886
Musée d'Art Moderne et d'Art Contemporain,2020,PROVENCE-ALPES-CÔTE D'AZUR,NICE,18846,29210,48056,M0888
Ecomusée du Pays de la Roudoule,2020,PROVENCE-ALPES-CÔTE D'AZUR,PUGET-ROSTANG,705,0,705,M0890
Musée Départemental des Merveilles,2020,PROVENCE-ALPES-CÔTE D'AZUR,TENDE,1331,11528,12859,M0891
Musée National de Vallauris (la Guerre et la Paix de Picasso),2020,PROVENCE-ALPES-CÔTE D'AZUR,VALLAURIS,5378,2984,8362,M5047
Musée de l'Artillerie,2020,PROVENCE-ALPES-CÔTE D'AZUR,DRAGUIGNAN,0,6970,6970,M9007
Musée Archéologique,2020,PROVENCE-ALPES-CÔTE D'AZUR,SAINT-RAPHAËL,0,10001,10001,M0940
Musée de l'Annonciade,2020,PROVENCE-ALPES-CÔTE D'AZUR,SAINT-TROPEZ,9166,1993,11159,M0941
Musée Calvet (et musée Lapidaire),2020,PROVENCE-ALPES-CÔTE D'AZUR,AVIGNON,0,42041,42041,M0946
Musée Comtadin-Duplessis,2020,PROVENCE-ALPES-CÔTE D'AZUR,CARPENTRAS,0,588,588,M0949
Musée Marc Deydier,2020,PROVENCE-ALPES-CÔTE D'AZUR,CUCURON,0,360,360,M0955
Muséum d'histoire naturelle Philadelphe Thomas,2009,MIDI-PYRENEES,GAILLAC,789,3683,4472,
Musée Départemental du Textile,2009,MIDI-PYRENEES,LA-BASTIDE-ROUAIROUX,2608,3139,5747,
Musée du Vieil Auvillar,2009,MIDI-PYRENEES,AUVILLAR,2892,1778,4670,
Musée des arts et traditions populaires,2009,MIDI-PYRENEES,MOISSAC,4082,0,4082,
Musée de Préhistoire,2009,MIDI-PYRENEES,SAINT-ANTONIN-NOBLE-VAL,674,0,674,
Musée de l'Ostrevant,2009,NORD-PAS-DE-CALAIS,BOUCHAIN,217,568,785,
Musée de la Chartreuse,2009,NORD-PAS-DE-CALAIS,DOUAI,6424,54625,61049,
Musée du Dessin et de l'Estampe Originale,2009,NORD-PAS-DE-CALAIS,GRAVELINES,2213,7938,10151,
Musée d'Histoire Naturelle et de Géologie,2009,NORD-PAS-DE-CALAIS,LILLE,80368,0,80368,
Musée du Verre,2009,NORD-PAS-DE-CALAIS,SARS-POTERIES,3760,6998,10758,
Musée d'Art et d'Industrie,2009,NORD-PAS-DE-CALAIS,TOURCOING,0,39900,39900,
Musée des Beaux-Arts,2009,NORD-PAS-DE-CALAIS,VALENCIENNES,39238,0,39238,
Musée Régional d'Ethnologie,2009,NORD-PAS-DE-CALAIS,BETHUNE,0,1850,1850,
Musée Quentovic,2009,NORD-PAS-DE-CALAIS,ETAPLES-SUR-MER,2277,464,2741,
Musée Municipal Bruno Danvin,2009,NORD-PAS-DE-CALAIS,SAINT-POL-SUR-TERNOISE,0,2961,2961,
Musée Jean-Charles Cazin,2009,NORD-PAS-DE-CALAIS,SAMER,0,633,633,
Mémorial de Caen,2009,BASSE-NORMANDIE,CAEN,324000,66000,390000,
Musée d'Initiation à la Nature,2009,BASSE-NORMANDIE,CAEN,0,3751,3751,
Musée Municipal,2009,BASSE-NORMANDIE,ORBEC,645,1409,2054,
Musée Municipal,2009,BASSE-NORMANDIE,EQUEURDREVILLLE-HAINNEVILLE,0,2920,2920,
Musée du Vieux Granville,2009,BASSE-NORMANDIE,GRANVILLE,5208,6034,11242,
Musée de la Poeslerie,2009,BASSE-NORMANDIE,VILLEDIEU-LES-POELES-ROUFFIGNY,10397,676,11073,
Musée Départemental d'Art Sacré,2009,BASSE-NORMANDIE,SEES,768,0,768,
Musée Artisanal et Industriel d'Instruments à Vent,2009,HAUTE-NORMANDIE,LA COUTURE-BOUSSEY,3488,1221,4709,
Musée Municipal Nicolas Poussin,2009,HAUTE-NORMANDIE,LES ANDELYS,954,1984,2938,
Musée des Sapeurs-Pompiers de France,2009,HAUTE-NORMANDIE,MONTVILLE,6537,1458,7995,
MUNAE - Musée National de l'Education,2009,HAUTE-NORMANDIE,ROUEN,2587,10627,13214,
Musée des Beaux-Arts,2009,HAUTE-NORMANDIE,ROUEN,35875,57925,93800,
Musée du Pays de Guérande et de la Porte Saint Michel,2009,PAYS DE LA LOIRE,GUERANDE Cedex,17200,7635,24835,
Muséum d'Histoire Naturelle de Nantes,2009,PAYS DE LA LOIRE,NANTES,26067,48718,74785,
Musée d'Art de Nantes,2009,PAYS DE LA LOIRE,NANTES,45746,108733,154479,
Musées du Parc Naturel Régional de Brière,2009,PAYS DE LA LOIRE,SAINT-JOACHIM,3165,368,3533,
Musée Jean Lurcat et de la Tapisserie Contemporaine,2009,PAYS DE LA LOIRE,ANGERS,16982,42214,59196,
Musée Archéologique Départemental de Jublains,2009,PAYS DE LA LOIRE,JUBLAINS,8232,19769,28001,
Musée du Château de Mayenne,2009,PAYS DE LA LOIRE,MAYENNE,11742,10736,22478,
Bibliothèque-musée,2009,PAYS DE LA LOIRE,SAINT-CALAIS,100,3500,3600,
Musée de Fontenay-le-Comte,2009,PAYS DE LA LOIRE,FONTENAY-LE-COMTE,2365,3590,5955,
Historial de la Vendée,2009,PAYS DE LA LOIRE,LES LUCS-SUR-BOULOGNE,36502,28595,65097,
Musée Clemenceau et de Lattre-de-Tassigny,2009,PAYS DE LA LOIRE,MOUILLERON-EN-PAREDS,1546,4235,5781,
Musée Jean de la Fontaine,2009,PICARDIE,CHATEAU-THIERRY,12481,0,12481,
Familistère de Guise,2009,PICARDIE,GUISE,32201,4390,36591,
Musée Entomologique,2009,PICARDIE,SAINT-QUENTIN,4073,5175,9248,
Musée des Beaux-Arts Antoine Lecuyer,2009,PICARDIE,SAINT-QUENTIN,6317,6110,12427,
Musée Départemental de l'Oise,2009,PICARDIE,BEAUVAIS,0,31981,31981,
Musée de la Figurine Historique,2009,PICARDIE,COMPIEGNE,4816,2646,7462,
Musée Alfred Danicourt,2009,PICARDIE,PERONNE,0,2147,2147,
Musée des Beaux-Arts,2009,POITOU-CHARENTES,ANGOULEME,0,44798,44798,
Cité International de la Bande Dessinée et de l'Image - Musée de la Bande Dessinée,2009,POITOU-CHARENTES,ANGOULEME,11885,36077,47962,
Musée de la Mytiliculture,2009,POITOU-CHARENTES,ESNANDES,4523,63,4586,
Hôtel Hèbre de Saint-Clément - Musée d'Art et d'Histoire,2009,POITOU-CHARENTES,ROCHEFORT,3183,17200,20383,
Musée Archéologique,2009,POITOU-CHARENTES,SAINTES,2277,35858,38135,
Musée Dupuy-Mestreau,2009,POITOU-CHARENTES,SAINTES,1138,2550,3688,
Musée Municipal des Cordeliers,2009,POITOU-CHARENTES,SAINT-JEAN-D'ANGELY,1101,2396,3497,
Musée Bernard d’Agesci,2009,POITOU-CHARENTES,NIORT,3500,13581,17081,
Musée d'Art et d'Histoire Georges Turpin,2009,POITOU-CHARENTES,PARTHENAY,276,6942,7218,
Musée Charbonneau-Lassay,2009,POITOU-CHARENTES,LOUDUN,0,340,340,
Musée Sainte-Croix,2009,POITOU-CHARENTES,POITIERS,3270,16983,20253,
Collection d'Histoire Naturelle,2009,POITOU-CHARENTES,POITIERS,55000,0,55000,
Musée Fernand Léger,2009,PROVENCE-ALPES-CÔTE D'AZUR,BIOT,21379,15733,37112,
Villa-Musée Jean-Honoré Fragonard,2009,PROVENCE-ALPES-CÔTE D'AZUR,GRASSE,475,2855,3330,
Musée Archéologique - Site de  Cimiez,2009,PROVENCE-ALPES-CÔTE D'AZUR,NICE,0,39634,39634,
Musée d'Art Naïf Anatole Jakovsky,2009,PROVENCE-ALPES-CÔTE D'AZUR,NICE,0,18705,18705,
Musée du Vieux-Logis de Nice,2009,PROVENCE-ALPES-CÔTE D'AZUR,NICE,0,361,361,
Musée du Palais Lascaris,2009,PROVENCE-ALPES-CÔTE D'AZUR,NICE,0,83750,83750,
Musée d'Art et d'Histoire,2009,PROVENCE-ALPES-CÔTE D'AZUR,NICE,0,71042,71042,
Musées de la Citadelle,2009,PROVENCE-ALPES-CÔTE D'AZUR,VILLEFRANCHE-SUR-MER,0,36172,36172,
Musée de la Mode,2009,PROVENCE-ALPES-CÔTE D'AZUR,MARSEILLE,6757,20889,27646,
Musée de la Faïence,2009,PROVENCE-ALPES-CÔTE D'AZUR,MARSEILLE,2185,7432,9617,
Musée Baroncelli,2009,PROVENCE-ALPES-CÔTE D'AZUR,SAINTES-MARIES-DE-LA-MER,658,0,658,
Musée Estrine - Présence Van Gogh,2009,PROVENCE-ALPES-CÔTE D'AZUR,SAINT-REMY-DE-PROVENCE,9589,5042,14631,
Musée Archéologique Gallo-Romaine du Var,2009,PROVENCE-ALPES-CÔTE D'AZUR,FREJUS,4228,5047,9275,
Musée Calvet (et musée Lapidaire),2009,PROVENCE-ALPES-CÔTE D'AZUR,AVIGNON,12941,6627,19568,
Musée Comtadin-Duplessis,2009,PROVENCE-ALPES-CÔTE D'AZUR,CARPENTRAS,340,1865,2205,
Musée Marc Deydier,2009,PROVENCE-ALPES-CÔTE D'AZUR,CUCURON,0,6472,6472,
Musée Municipal Camille Pautet,2009,PROVENCE-ALPES-CÔTE D'AZUR,MAZAN,0,2754,2754,
Musée Archéologique Théo Desplans,2009,PROVENCE-ALPES-CÔTE D'AZUR,VAISON-LA-ROMAINE,63466,4638,68104,
Musée Archéologique,2009,RHONE-ALPES,IZERNORE,354,176,530,
Musée Départemental du Revermont,2009,RHONE-ALPES,VAL-REVERMONT,4537,7885,12422,
Musée Vivarois César Filhol,2009,RHONE-ALPES,ANNONAY,441,1133,1574,
Musée des Vans,2009,RHONE-ALPES,LES VANS,259,941,1200,
Musée de la Batellerie du Rhône,2009,RHONE-ALPES,SERRIERES,750,406,1156,
Musée du Château des Adhémars,2009,RHONE-ALPES,MONTELIMAR,13307,0,13307,
Musée-château d'Annecy,2009,RHONE-ALPES,ANNECY,53201,46672,99873,
Musée Léon Marès,2009,RHONE-ALPES,LOVAGNY,18327,5707,24034,
Musée du Chablais,2009,RHONE-ALPES,THONON-LES-BAINS,2800,3127,5927,
Musée Gallo-Romain,2009,RHONE-ALPES,AOSTE,4793,5628,10421,
Musée - Parc Archéologique du Lac de Paladru,2009,RHONE-ALPES,CHARAVINES,10170,1901,12071,
Musée Matheysin,2009,RHONE-ALPES,LA MURE,1215,980,2195,
Musée de la Grande Chartreuse,2009,RHONE-ALPES,SAINT-PIERRE-DE-CHARTREUSE,50965,3404,54369,
Musée Lucien Mainssieux,2009,RHONE-ALPES,VOIRON,0,5396,5396,
Musée Alice Taverne,2009,RHONE-ALPES,AMBIERLE,3830,895,4725,
Musée de la Soierie,2009,RHONE-ALPES,CHARLIEU,5077,1789,6866,
Musée d'Histoire du  20ème Siècle - Résistance et Déportation,2009,RHONE-ALPES,ESTIVAREILLES,2255,950,3205,
Musée d'Archéologie,2009,RHONE-ALPES,FEURS,1379,4647,6026,
Musée des Civilisations : Daniel Pouget,2009,RHONE-ALPES,SAINT-JUST-SAINT-RAMBERT,3421,4614,8035,
Musée Folklorique et Traditions Populaires Marius Audin,2009,RHONE-ALPES,BEAUJEU,1967,759,2726,
Musée des Hospices Civils de Lyon,2009,RHONE-ALPES,LYON,6136,4057,10193,
Musée des Beaux-Arts,2009,RHONE-ALPES,LYON,115531,179079,294610,
Musée Paul Dini,2009,RHONE-ALPES,VILLEFRANCHE-SUR-SAONE,13629,7842,21471,
Musée archéologique et minéralogique Pierre Borrione,2009,RHONE-ALPES,AIME-EN-TARENTAISE Cedex,512,494,1006,
Musée Municipal d'Albertville-Conflans,2009,RHONE-ALPES,ALBERTVILLE,3001,3045,6046,
Musée Municipal,2009,ST PIERRE ET MIQUELON,SAINT-PIERRE ET MIQUELON,1206,234,1440,
Musée de la Folie Marco,2010,ALSACE,BARR,2553,2236,4789,
Musée de l'Image Populaire de Pfaffenhoffen,2010,ALSACE,PFAFFENHOFFEN,1688,1157,2845,
Musée du Château des Rohan,2010,ALSACE,SAVERNE,5373,4039,9412,
Cabinet des Estampes et des Dessins,2010,ALSACE,STRASBOURG,0,259,259,
Musée J.F. Oberlin,2010,ALSACE,WALDERSBACH,18863,7603,26466,
Musée du Vignoble et des Vins d'Alsace,2010,ALSACE,KAYSERSBERG VIGNOBLE,4307,100,4407,
Musée des Beaux-Arts,2010,ALSACE,MULHOUSE,0,20609,20609,
Musée National de l'Automobile - Collection Schlumpf,2010,ALSACE,MULHOUSE,170707,27535,198242,
Ecomusée d'Alsace,2010,ALSACE,UNGERSHEIM,157087,8939,166026,
Musée Fernand Desmoulin,2010,AQUITAINE,BRANTOME,17428,888,18316,
Musée National de la Préhistoire,2010,AQUITAINE,LES EYZIES-DE-TAYAC,52245,40392,92637,
Musée Militaire - Souvenir du Périgord,2010,AQUITAINE,PERIGUEUX,1736,675,2411,
Musée Gallo-Romain de Vesunna,2010,AQUITAINE,PERIGUEUX,18005,10770,28775,
CAPC Musée d'Art Contemporain de Bordeaux,2010,AQUITAINE,BORDEAUX,37606,88356,125962,
Musée des Beaux-Arts,2010,AQUITAINE,BORDEAUX,14615,69863,84478,
Musée de la Voiture à Cheval,2010,AQUITAINE,BOURG-SUR-GIRONDE,2182,1122,3304,
Musée de Borda,2010,AQUITAINE,DAX,2760,5909,8669,
Musée d'Art et d'Histoire du Cap de Gascogne,2010,AQUITAINE,SAINT-SEVER,0,1800,1800,
Musée Municipal du Lac,2010,AQUITAINE,SANGUINET,1739,55,1794,
Musée Bonnat,2010,AQUITAINE,BAYONNE,11015,14457,25472,
Musée de la Haute Auvergne,2010,AUVERGNE,SAINT-FLOUR,2145,2519,4664,
Musée des Manufactures de Dentelles,2010,AUVERGNE,RETOURNAC,3313,832,4145,
Musée Lapidaire,2010,AUVERGNE,MOZAC,36,736,772,
Musée d'Art Sacré,2010,BOURGOGNE,DIJON,0,5560,5560,
Musée Magnin,2010,BOURGOGNE,DIJON,6962,10036,16998,
Musée Municipal François Pompon,2010,BOURGOGNE,SAULIEU,2668,3192,5860,
Musée du Costume,2010,BOURGOGNE,CHATEAU-CHINON,4807,1368,6175,
Musée d'Art et d'Histoire Romain Rolland,2010,BOURGOGNE,CLAMECY,1990,2720,4710,
Musée de la Loire,2010,BOURGOGNE,COSNE-SUR-LOIRE,2288,4086,6374,
Musée du Grès de Puisaye,2010,BOURGOGNE,SAINT-AMAND-EN-PUISAYE,2985,304,3289,
Musée Denon,2010,BOURGOGNE,CHALON-SUR-SAONE,0,15151,15151,
Musée Nicéphore Niepce,2010,BOURGOGNE,CHALON-SUR-SAONE,0,27592,27592,
"L'Atelier d'un Journal"" de Louhans - Musée Municipal",2010,BOURGOGNE,LOUHANS,2029,3550,5579,
Hôtel Dieu - Musée Greuze,2010,BOURGOGNE,TOURNUS,11058,2185,13243,
Muséum - Maison de l'Eau,2010,BOURGOGNE,AUXERRE,0,17207,17207,
Musée de l'Avallonnais Jean Després,2010,BOURGOGNE,AVALLON,0,6875,6875,
Musée Muncipal,2010,BOURGOGNE,SENS,4530,37114,41644,
Musée Zervos - Maison Romain Rolland,2010,BOURGOGNE,VEZELAY,6566,2143,8709,
Musée d'Art et d'Histoire du Puisaye,2010,BOURGOGNE,VILLIERS-SAINT-BENOIT,954,1456,2410,
Musée du Château de Dinan,2010,BRETAGNE,DINAN,47859,15677,63536,
Musée National de la Marine,2010,BRETAGNE,BREST,30387,31472,61859,
Musée de Morlaix,2010,BRETAGNE,MORLAIX,8091,11701,19792,
Musée de l'Ecole Rurale en Bretagne,2010,BRETAGNE,TREGARVAN,10524,2239,12763,
Musée International du Long-Cours Cap-Hornier,2010,BRETAGNE,SAINT-MALO,7020,3651,10671,
Musée des Rochers-Sévigné,2010,BRETAGNE,VITRE,3801,5422,9223,
Ecomusée de Saint-Dégan,2010,BRETAGNE,BREC'H,10716,2346,13062,
Musée Estève,2010,CENTRE,BOURGES,0,14375,14375,
Musée des Arts Décoratifs,2010,CENTRE,BOURGES,0,16237,16237,
Musée Saint-Vic,2010,CENTRE,SAINT-AMAND-MONTROND,898,2010,2908,
Musée Municipal,2010,CENTRE,VIERZON,0,1330,1330,
Musée des Beaux-Arts et d'Histoire Naturelle,2010,CENTRE,CHATEAUDUN,3757,4537,8294,
Musée Marcel Proust,2010,CENTRE,ILLIERS-COMBRAY,4657,517,5174,
Musée Archéologique d'Argentomagus,2010,CENTRE,SAINT-MARCEL,7903,5097,13000,
"""Maison Musée"" René Descartes",2010,CENTRE,DESCARTES,1526,1014,2540,
Musée Lansyer,2010,CENTRE,LOCHES,0,22026,22026,
Musée du Savignéen,2010,CENTRE,SAVIGNE-SUR-LATHAN,1320,174,1494,
Musée Archéologique,2010,CENTRE,THESEE,652,214,866,
Musée des Sciences Naturelles,2010,CENTRE,ORLEANS,10551,53785,64336,
Musée de la Maison de la Dernière Cartouche,2010,CHAMPAGNE-ARDENNES,BAZEILLES,1598,746,2344,
Musée Napoléon Ier,2010,CHAMPAGNE-ARDENNES,BRIENNE-LE-CHATEAU,3138,1131,4269,
Musée Vauluisant - Musée de la Bonneterie,2010,CHAMPAGNE-ARDENNES,TROYES,2380,2095,4475,
Maison de l'Outil  et de la Pensée Ouvrière,2010,CHAMPAGNE-ARDENNES,TROYES,12145,4017,16162,
Musée d'Art Moderne,2010,CHAMPAGNE-ARDENNES,TROYES,11074,19069,30143,
Musée de la Coutellerie,2010,CHAMPAGNE-ARDENNES,NOGENT,3282,2080,5362,
Musée Garinet,2010,CHAMPAGNE-ARDENNES,CHALONS-EN-CHAMPAGNE,177,442,619,
Musée Napoléonien,2010,CORSE,AJACCIO,7636,4223,11859,
Musée Palais Fesch,2010,CORSE,AJACCIO,26749,12142,38891,
Musée Baron Martin,2010,FRANCHE-COMTE,GRAY,5807,4893,10700,
Musée des Salines,2010,FRANCHE-COMTE,SALINS-LES-BAINS,68104,8146,76250,
Musée de l'Artisanat Jurassien,2010,FRANCHE-COMTE,VOITEUR,0,19762,19762,
Musée Municipal Saint-John Perse,2010,GUADELOUPE,POINTE-A-PITRE,1939,400,2339,
Musée Territorial Alexandre Franconie,2010,GUYANE,CAYENNE,3096,5107,8203,
Musée-Jardin Paul Landowski,2010,ILE-DE-FRANCE,BOULOGNE-BILLANCOURT,187,540,727,
Musée National des Châteaux de Malmaison et de Bois-Préau,2010,ILE-DE-FRANCE,RUEIL-MALMAISON,35650,31840,67490,
Musée de l'Île-de-France,2010,ILE-DE-FRANCE,SCEAUX,0,48252,48252,
Grande Galerie de l'Evolution (Muséum National d'Histoire Naturelle),2010,ILE-DE-FRANCE,PARIS,411345,319733,731078,
Galerie de Minéralogie et de Géologie (Muséum d'Histoire Naturelle),2010,ILE-DE-FRANCE,PARIS,1826,584,2410,
Etablissement public du musée d'Orsay et de l'Orangerie - Musée de l'Orangerie,2010,ILE-DE-FRANCE,PARIS,466926,224032,690958,
Musée Carnavalet-Histoire de Paris (+ Crypte et les Catacombes),2010,ILE-DE-FRANCE,PARIS,377007,714098,1091105,
Maison de Balzac,2010,ILE-DE-FRANCE,PARIS,8553,39129,47682,
Musée de la Musique,2010,ILE-DE-FRANCE,PARIS,100913,46762,147675,
Musée Nissim de Camondo (UCAD),2010,ILE-DE-FRANCE,PARIS,41524,14579,56103,
Musée National d'Art Moderne (Centre National d'Art et de Culture Georges Pompidou),2010,ILE-DE-FRANCE,PARIS,3255080,0,3255080,
Musée des Monnaies et des Médailles,2010,ILE-DE-FRANCE,PARIS,7018,33745,40763,
Musée Municipal de Chelles Alfred Bonno,2010,ILE-DE-FRANCE,CHELLES,0,2350,2350,
Musée d'Art et d'Histoire de Melun,2010,ILE-DE-FRANCE,MELUN,6600,0,6600,
Château-musée de Nemours,2010,ILE-DE-FRANCE,NEMOURS,2471,3708,6179,
Musée départemental Stéphane Mallarmé,2010,ILE-DE-FRANCE,VULAINES-SUR-SEINE,3535,1801,5336,
Musée de l'Histoire Vivante,2010,ILE-DE-FRANCE,MONTREUIL-SOUS-BOIS,925,2088,3013,
Musée Tavet Delacour,2010,ILE-DE-FRANCE,PONTOISE,1561,4713,6274,
Musée de la Toile de Jouy,2010,ILE-DE-FRANCE,JOUY-EN-JOSAS,8315,1930,10245,
Musée National de Port Royal des Champs,2010,ILE-DE-FRANCE,MAGNY-LES-HAMEAUX,5066,13061,18127,
Etablissement Public du Musée et du Domaine National de Versailles,2010,ILE-DE-FRANCE,VERSAILLES,4403869,1683687,6087556,
Muséum d'Histoire Naturelle,2010,LA REUNION,SAINT-DENIS DE LA REUNION,9110,34161,43271,
Musée des Arts Décoratifs de l’Océan indien (MADOI),2010,LA REUNION,SAINT-LOUIS,0,17637,17637,
Musée Archéologique du Lauragais,2010,LANGUEDOC-ROUSSILLON,CASTELNAUDARY,0,1771,1771,
Musée Petiet,2010,LANGUEDOC-ROUSSILLON,LIMOUX,831,2568,3399,
Musée des Corbières,2010,LANGUEDOC-ROUSSILLON,SIGEAN,590,191,781,
Musée Municipal de la Vignasse,2010,LANGUEDOC-ROUSSILLON,BEAUCAIRE,1002,2889,3891,
Musée des Cultures Taurines (Annexe du Vieux Nîmes),2010,LANGUEDOC-ROUSSILLON,NIMES,639,14086,14725,
Musée Fabre,2010,LANGUEDOC-ROUSSILLON,MONTPELLIER,236996,54500,291496,
Musée départemental d'Art Moderne,2010,LANGUEDOC-ROUSSILLON,CERET,45296,30724,76020,
Musée Labenche d'Art et d'Histoire,2010,LIMOUSIN,BRIVE-LA-GAILLARDE,2866,8998,11864,
Musée du Cloître de Tulle André Mazeyrie,2010,LIMOUSIN,TULLE,0,313,313,
Musée Départemental de la Tapisserie,2010,LIMOUSIN,AUBUSSON,14974,3379,18353,
Les Sources d'Hercule,2010,LORRAINE,DENEUVRE,3400,567,3967,
Muséum- Aquarium de Nancy,2010,LORRAINE,NANCY,24184,48747,72931,
"Musée ""au Fil du Papier""",2010,LORRAINE,PONT-A-MOUSSON,2626,1893,4519,
Musée Barrois,2010,LORRAINE,BAR-LE-DUC,2198,7869,10067,
Musée d'Art Sacré de la Meuse,2010,LORRAINE,SAINT-MIHIEL,1052,795,1847,
Centre Pompidou de Metz (collections nationales decentralisées),2010,LORRAINE,METZ,332548,283282,615830,
Musée des Mines de fer de Lorraine,2010,LORRAINE,NEUFCHEF,16539,639,17178,
Musée de la Mine - Carreau Wendel,2010,LORRAINE,PETITE-ROSSELLE,20294,1687,21981,
Musée de l'Image,2010,LORRAINE,EPINAL,22379,6989,29368,
Musée de la Forge,2010,MIDI-PYRENEES,MONTGAILHARD,27714,2396,30110,
Musée Joseph Vaylet,2010,MIDI-PYRENEES,ESPALION,4936,0,4936,
Muséum d'Histoire Naturelle,2010,MIDI-PYRENEES,TOULOUSE,99910,101954,201864,
Musée du Vieux Toulouse,2010,MIDI-PYRENEES,TOULOUSE,4795,1208,6003,
Musée des Augustins,2010,MIDI-PYRENEES,TOULOUSE,41956,67605,109561,
Musée Gallo-Romain d'Uxellodunum,2010,MIDI-PYRENEES,MARTEL,418,133,551,
Musée Eugénie et Maurice Guérin,2010,MIDI-PYRENEES,ANDILLAC,1898,2596,4494,
Musée de Préhistoire,2010,MIDI-PYRENEES,SAINT-ANTONIN-NOBLE-VAL,579,0,579,
"Forum Antique de Bavay, Musée Archéologique du Département du Nord",2010,NORD-PAS-DE-CALAIS,BAVAY,20824,4587,25411,
Musée Départemental de Flandre,2010,NORD-PAS-DE-CALAIS,CASSEL,14838,6644,21482,
Musée des Beaux-Arts,2010,BASSE-NORMANDIE,CAEN,73050,78527,151577,
Mémorial de Caen,2010,BASSE-NORMANDIE,CAEN,340000,50000,390000,
Musée Municipal,2010,BASSE-NORMANDIE,EQUEURDREVILLLE-HAINNEVILLE,0,2970,2970,
Musée Régional du Cidre et du Calvados,2010,BASSE-NORMANDIE,VALOGNES,6037,1285,7322,
Musée Départemental des Arts et Traditions Populaires du Perche,2010,BASSE-NORMANDIE,SAINT-CYR LA ROSIERE,13035,10059,23094,
Musée du Verre et de la Pierre,2010,HAUTE-NORMANDIE,CONCHES-EN-OUCHE,1895,2683,4578,
Musée Artisanal et Industriel d'Instruments à Vent,2010,HAUTE-NORMANDIE,LA COUTURE-BOUSSEY,3927,1497,5424,
Musée du Prieuré,2010,HAUTE-NORMANDIE,HARFLEUR,220,2369,2589,
Musée d'Art Moderne André Malraux - MuMa,2010,HAUTE-NORMANDIE,LE HAVRE,53137,24948,78085,
Musée Départemental Pierre Corneille,2010,HAUTE-NORMANDIE,LE PETIT-COURONNE,691,3648,4339,
Musée Industriel de la Corderie Vallois,2010,HAUTE-NORMANDIE,NOTRE-DAME-DE-BONDEVILLE,2186,6310,8496,
Musée Le Secq des Tournelles,2010,HAUTE-NORMANDIE,ROUEN,5996,9860,15856,
Musée des Marais Salant,2010,PAYS DE LA LOIRE,BATZ-SUR-MER,10556,1096,11652,
Musée Jean Lurcat et de la Tapisserie Contemporaine,2010,PAYS DE LA LOIRE,ANGERS,13805,37714,51519,
Musée d'Art et d'Histoire,2010,PAYS DE LA LOIRE,BAUGE,779,107,886,
Musée Jules-Desbois,2010,PAYS DE LA LOIRE,PARCAY-LES-PINS,2734,3546,6280,
Château-Musée,2010,PAYS DE LA LOIRE,SAUMUR,55838,10880,66718,
Musée de l'Ardoise,2010,PAYS DE LA LOIRE,TRELAZE,10012,3515,13527,
Musée des Sciences - CCSTI,2010,PAYS DE LA LOIRE,LAVAL,5916,54118,60034,
Historial de la Vendée,2010,PAYS DE LA LOIRE,LES LUCS-SUR-BOULOGNE,45979,34153,80132,
Musée Jean de la Fontaine,2010,PICARDIE,CHATEAU-THIERRY,15963,0,15963,
Familistère de Guise,2010,PICARDIE,GUISE,38789,4006,42795,
Musée - Centre de Documentation Alfred Desmasures,2010,PICARDIE,HIRSON,0,1500,1500,
Musée Départemental de l'Oise,2010,PICARDIE,BEAUVAIS,0,31153,31153,
Musée Antoine Vivenel,2010,PICARDIE,COMPIEGNE,1428,12158,13586,
Musée de l'Archerie et de l'Art Sacré,2010,PICARDIE,CREPY-EN-VALOIS,2937,2953,5890,
Musée Lombart,2010,PICARDIE,DOULLENS,369,5337,5706,
Musée des Beaux-Arts,2010,POITOU-CHARENTES,ANGOULEME,7928,32711,40639,
Musée Protestant,2010,POITOU-CHARENTES,LA ROCHELLE,1049,905,1954,
Musée de la Maison de Pierre Loti,2010,POITOU-CHARENTES,ROCHEFORT,18561,2396,20957,
Musée National de la Marine,2010,POITOU-CHARENTES,ROCHEFORT,22732,18461,41193,
Musée de l'Echevinage,2010,POITOU-CHARENTES,SAINTES,868,2385,3253,
Musée de l'Ile d'Oléron,2010,POITOU-CHARENTES,ST-PIERRE D'OLERON,9533,2789,12322,
Musée des Traditions Populaires et d'Archéologie,2010,POITOU-CHARENTES,CHAUVIGNY,11109,394,11503,
Musée Gassendi,2010,PROVENCE-ALPES-CÔTE D'AZUR,DIGNE-LES-BAINS,2249,5704,7953,
Musée Archéologique - Site de  Cimiez,2010,PROVENCE-ALPES-CÔTE D'AZUR,NICE,0,42452,42452,
Musée Matisse,2010,PROVENCE-ALPES-CÔTE D'AZUR,NICE,0,135715,135715,
Ecomusée du Pays de la Roudoule,2010,PROVENCE-ALPES-CÔTE D'AZUR,PUGET-ROSTANG,768,0,768,
Musée Départemental des Merveilles,2010,PROVENCE-ALPES-CÔTE D'AZUR,TENDE,0,30194,30194,
Musées de la Citadelle,2010,PROVENCE-ALPES-CÔTE D'AZUR,VILLEFRANCHE-SUR-MER,0,35133,35133,
Musée du Pavillon de Vendôme,2010,PROVENCE-ALPES-CÔTE D'AZUR,AIX-EN-PROVENCE,2622,10164,12786,
Musée Alphonse Daudet,2010,PROVENCE-ALPES-CÔTE D'AZUR,FONTVIEILLE,19498,0,19498,
Musée Ziem,2010,PROVENCE-ALPES-CÔTE D'AZUR,MARTIGUES,0,12463,12463,
Musée Suffren et du Vieux Saint-Cannat,2010,PROVENCE-ALPES-CÔTE D'AZUR,SAINT-CANNAT,0,3973,3973,
Musée Municipal Paul Lafran,2010,PROVENCE-ALPES-CÔTE D'AZUR,SAINT-CHAMAS,0,2687,2687,
Musée Baroncelli,2010,PROVENCE-ALPES-CÔTE D'AZUR,SAINTES-MARIES-DE-LA-MER,673,0,673,
Musée de l'Empéri de Salon et de la Crau,2010,PROVENCE-ALPES-CÔTE D'AZUR,SALON-DE-PROVENCE,4649,9180,13829,
Musée des Arts et d’Histoire,2010,PROVENCE-ALPES-CÔTE D'AZUR,BORMES-LES-MIMOSAS,0,6662,6662,
Musée de l'Artillerie,2010,PROVENCE-ALPES-CÔTE D'AZUR,DRAGUIGNAN,0,17493,17493,
Musée Archéologique Gallo-Romaine du Var,2010,PROVENCE-ALPES-CÔTE D'AZUR,FREJUS,4503,2083,6586,
Musée du Petit Palais,2010,PROVENCE-ALPES-CÔTE D'AZUR,AVIGNON,20141,27488,47629,
Musée Comtadin-Duplessis,2010,PROVENCE-ALPES-CÔTE D'AZUR,CARPENTRAS,303,2089,2392,
Musée Municipal,2010,PROVENCE-ALPES-CÔTE D'AZUR,ORANGE,59147,0,59147,
Musée Vivarois César Filhol,2010,RHONE-ALPES,ANNONAY,546,2034,2580,
Musée des Vans,2010,RHONE-ALPES,LES VANS,359,903,1262,
Musée - Parc Archéologique du Lac de Paladru,2010,RHONE-ALPES,CHARAVINES,10839,1292,12131,
Musée-Cloître Saint-André-Le-Bas,2010,RHONE-ALPES,VIENNE,1082,2688,3770,
Musée de la Soierie,2010,RHONE-ALPES,CHARLIEU,4716,1700,6416,
Musée d'Histoire du  20ème Siècle - Résistance et Déportation,2010,RHONE-ALPES,ESTIVAREILLES,2301,840,3141,
Musée d'Allard,2010,RHONE-ALPES,MONTBRISON,3648,6755,10403,
Musée des Sapeurs-Pompiers de Lyon,2010,RHONE-ALPES,LYON,3107,2701,5808,
Musée Archéologique,2010,RHONE-ALPES,SAINT-ROMAIN-EN-GAL,21975,53737,75712,
Ecomusée du Haut Beaujolais,2010,RHONE-ALPES,THIZY-LES-BOURGS,0,370,370,
Musée Paul Dini,2010,RHONE-ALPES,VILLEFRANCHE-SUR-SAONE,7945,10977,18922,
Musée Municipal d'Albertville-Conflans,2010,RHONE-ALPES,ALBERTVILLE,3099,2999,6098,
Musée Historique,2011,ALSACE,HAGUENAU,1988,6821,8809,
Musée de la Chartreuse,2011,ALSACE,MOLSHEIM,3464,890,4354,
Musée du Fer,2011,ALSACE,REICHSHOFFEN,572,512,1084,
Musée EDF Electropolis,2011,ALSACE,MULHOUSE,27062,12142,39204,
Musée des Arts et Traditions Populaires du Périgord,2011,AQUITAINE,MUSSIDAN,1062,613,1675,
Musée d'Aquitaine,2011,AQUITAINE,BORDEAUX,13121,128484,141605,
Muséum d'Histoire Naturelle de Bordeaux,2011,AQUITAINE,BORDEAUX,0,12260,12260,
Musée des Beaux-Arts,2011,AQUITAINE,BORDEAUX,12302,90674,102976,
Musée de la Voiture à Cheval,2011,AQUITAINE,BOURG-SUR-GIRONDE,2347,799,3146,
Musée de la Chalosse,2011,AQUITAINE,MONTFORT-EN-CHALOSSE,7856,2612,10468,
Ecomusée de la Grande Lande,2011,AQUITAINE,SABRES,69884,13092,82976,
Musée d'Art et d'Histoire du Cap de Gascogne,2011,AQUITAINE,SAINT-SEVER,0,800,800,
Musée de la Faïence et des arts de la table,2011,AQUITAINE,SAMADET,2402,4076,6478,
Musée de Préhistoire Mésolithique Laurent Coulonges,2011,AQUITAINE,SAUVETERRE-LA-LEMANCE,873,449,1322,
Musée Municipal,2011,AQUITAINE,ARUDY,1211,492,1703,
Musée Basque et de l'Histoire de Bayonne,2011,AQUITAINE,BAYONNE,18114,17455,35569,
Musée des Musiques Populaires - MuPop,2011,AUVERGNE,MONTLUCON,1463,2447,3910,
Musée d'Art Roger-Quillot,2011,AUVERGNE,CLERMONT-FERRAND,6227,23879,30106,
Musée Lapidaire,2011,AUVERGNE,MOZAC,188,126,314,
Muséum - Jardin des Sciences,2011,BOURGOGNE,DIJON,5751,111259,117010,
Musée Municipal,2011,BOURGOGNE,NUITS-SAINT-GEORGES,539,2689,3228,
Musée de la Mine,2011,BOURGOGNE,LA MACHINE,6317,1087,7404,
Musée Archéologique du Nivernais (Porte du Croux),2011,BOURGOGNE,NEVERS,0,621,621,
Musée Nicéphore Niepce,2011,BOURGOGNE,CHALON-SUR-SAONE,0,27180,27180,
"L'Atelier d'un Journal"" de Louhans - Musée Municipal",2011,BOURGOGNE,LOUHANS,1806,3657,5463,
Musée de la Tour du Moulin,2011,BOURGOGNE,MARCIGNY,2460,122,2582,
Ecomusée de la Bresse Bourguignonne,2011,BOURGOGNE,PIERRE-DE-BRESSE,28682,13351,42033,
Musée d'Art et d'Histoire,2011,BOURGOGNE,AUXERRE,0,22802,22802,
Musée des Arts Naïfs et Populaires de Noyers sur Serein,2011,BOURGOGNE,NOYERS-SUR-SEREIN,2026,1599,3625,
Musée d'Art et d'Histoire,2011,BRETAGNE,SAINT-BRIEUC,0,34845,34845,
Musée National de la Marine,2011,BRETAGNE,BREST,27924,32804,60728,
Le Port-Musée,2011,BRETAGNE,DOUARNENEZ,33101,12471,45572,
Ecomusée d'Ouessant - Vivre sur une Ile,2011,BRETAGNE,OUESSANT,6390,3833,10223,
Musée Départemental Breton,2011,BRETAGNE,QUIMPER,25230,11882,37112,
Musée d'Histoire de la Ville de Saint-Malo,2011,BRETAGNE,SAINT-MALO,20170,7096,27266,
Ecomusée de Saint-Dégan,2011,BRETAGNE,BREC'H,10598,2734,13332,
Musée National de la Marine,2011,BRETAGNE,PORT-LOUIS,41351,26464,67815,
Muséum des Sciences Naturelles et de Préhistoire,2011,CENTRE,CHARTRES,682,16359,17041,
Musée d'Art et d'Histoire de Dreux,2011,CENTRE,DREUX,4837,5049,9886,
Musée de l'Histoire du Perche,2011,CENTRE,NOGENT-LE-ROTROU,11044,6812,17856,
Musée Lansyer,2011,CENTRE,LOCHES,0,25460,25460,
Muséum d'Histoire Naturelle,2011,CENTRE,BLOIS,5393,7748,13141,
Musée de la Corbillière,2011,CENTRE,MER,0,1833,1833,
Atelier Musée Louis Leygue,2011,CENTRE,NAVEIL,0,51,51,
Musée du Feutre,2011,CHAMPAGNE-ARDENNES,MOUZON,3180,632,3812,
Musée des Beaux-Arts (Musée Pic Saint-Loup),2011,CHAMPAGNE-ARDENNES,TROYES,6785,8908,15693,
Musée Municipal,2011,CHAMPAGNE-ARDENNES,BOURBONNE-LES-BAINS,0,2219,2219,
Musée Municipal,2011,CHAMPAGNE-ARDENNES,CHALONS-EN-CHAMPAGNE,881,11542,12423,
Musée Saint-Rémi,2011,CHAMPAGNE-ARDENNES,REIMS,6003,29512,35515,
Musée de l'Alta Rocca,2011,CORSE,LEVIE,6584,8669,15253,
Musée d'archéologie d'Aleria - Jérôme Carcopino,2011,CORSE,ALERIA,29569,24519,54088,
Musée Départemental Pascal Paoli,2011,CORSE,MOROSAGLIA,4300,2907,7207,
Musée du Temps,2011,FRANCHE-COMTE,BESANCON,6435,30410,36845,
Musée Beurnier-Rossel,2011,FRANCHE-COMTE,MONTBELIARD,462,2953,3415,
Musée-Maison Natale Gustave Courbet,2011,FRANCHE-COMTE,ORNANS,41393,19163,60556,
Musée Georges Garret,2011,FRANCHE-COMTE,VESOUL,0,4269,4269,
Musée de la Vigne et du Vin,2011,FRANCHE-COMTE,ARBOIS,3741,1878,5619,
Musée des Beaux-Arts,2011,FRANCHE-COMTE,DOLE,0,22149,22149,
Musée Frédéric Japy,2011,FRANCHE-COMTE,BEAUCOURT,759,1916,2675,
Donation Maurice Jardot,2011,FRANCHE-COMTE,BELFORT,921,2494,3415,
Musée Précolombien Edgar Clerc,2011,GUADELOUPE,LE MOULE,0,8907,8907,
Musée Départemental Victor Schoelcher,2011,GUADELOUPE,POINTE-A-PITRE,4555,2673,7228,
Musée Municipal Robert Dubois-Corneau,2011,ILE-DE-FRANCE,BRUNOY,43,3204,3247,
Musée du Château,2011,ILE-DE-FRANCE,DOURDAN,8707,7692,16399,
Musée des Années Trente,2011,ILE-DE-FRANCE,BOULOGNE-BILLANCOURT,36292,12446,48738,
Musée Municipal d'Art et d'Histoire,2011,ILE-DE-FRANCE,COLOMBES,0,6635,6635,
Musée Français de la Carte à Jouer,2011,ILE-DE-FRANCE,ISSY-LES-MOULINEAUX,7310,15524,22834,
Galerie d'Anatomie Comparée et de Paléontologie (Muséum d'Histoire Naturelle),2011,ILE-DE-FRANCE,PARIS,107221,177942,285163,
Musée Carnavalet-Histoire de Paris,2011,ILE-DE-FRANCE,PARIS,57374,548049,605423,
Musée de l'Assistance Publique - Hôpitaux de Paris,2011,ILE-DE-FRANCE,PARIS,11904,1112,13016,
Maison de Balzac,2011,ILE-DE-FRANCE,PARIS,17376,35938,53314,
Musée de la Franc-Maçonnerie,2011,ILE-DE-FRANCE,PARIS,12387,2868,15255,
"Musée Cognacq-Jay, Musée du XVIIIe siècle de la ville de Paris",2011,ILE-DE-FRANCE,PARIS,10312,56231,66543,
Musée d'Art Moderne de la ville de Paris,2011,ILE-DE-FRANCE,PARIS,326182,275435,601617,
Établissement Public de la Porte Dorée - Cité Nationale de l’Histoire de l’Immigration,2011,ILE-DE-FRANCE,PARIS,13214,51557,64771,
Musée de la Chasse et de la Nature,2011,ILE-DE-FRANCE,PARIS,25680,24323,50003,
Musée d'Art et d'Histoire du Judaïsme,2011,ILE-DE-FRANCE,PARIS,98731,51648,150379,
Musée National des Techniques,2011,ILE-DE-FRANCE,PARIS,225192,0,225192,
Musée du Quai Branly - Jacques Chirac,2011,ILE-DE-FRANCE,PARIS,780886,676142,1457028,
L'Adresse Musée de la Poste,2011,ILE-DE-FRANCE,PARIS,55680,56599,112279,
Musée Municipal des Capucins,2011,ILE-DE-FRANCE,COULOMMIERS,1656,3364,5020,
Musée Gatien Bonnet,2011,ILE-DE-FRANCE,LAGNY-SUR-MARNE,299,1682,1981,
Musée Henri Chapu,2011,ILE-DE-FRANCE,LE MEE-SUR-SEINE,0,727,727,
Musée de Provins et du Provinois,2011,ILE-DE-FRANCE,PROVINS,17624,2648,20272,
Ecomusée,2011,ILE-DE-FRANCE,SAVIGNY-LE-TEMPLE,0,6583,6583,
Musée départemental Stéphane Mallarmé,2011,ILE-DE-FRANCE,VULAINES-SUR-SEINE,4300,1862,6162,
Musée Archéologique du Val d'Oise,2011,ILE-DE-FRANCE,GUIRY-EN-VEXIN,0,13145,13145,
Musée jean-Jacques Rousseau,2011,ILE-DE-FRANCE,MONTMORENCY,683,517,1200,
Musée de la Batellerie et des Voies Navigables,2011,ILE-DE-FRANCE,CONFLANS-SAINTE-HONORINE,9947,2288,12235,
Musée de la Toile de Jouy,2011,ILE-DE-FRANCE,JOUY-EN-JOSAS,12349,2052,14401,
Musée-Maison Maurice Ravel,2011,ILE-DE-FRANCE,MONTFORT-L'AMAURY,1646,4,1650,
Musée du Jouet Pierre Pinel,2011,ILE-DE-FRANCE,POISSY,13505,4707,18212,
Collections de la Fondation de Coubertin,2011,ILE-DE-FRANCE,SAINT-REMY-LES-CHEVREUSE,792,2392,3184,
Musée d'Art et d'Histoire - Ensemble monumental de Narbonne,2011,LANGUEDOC-ROUSSILLON,NARBONNE,38271,242945,281216,
Musée Archéologique,2011,LANGUEDOC-ROUSSILLON,SALLELES D'AUDE,6052,223,6275,
Musée Albert André,2011,LANGUEDOC-ROUSSILLON,BAGNOLS-SUR-CEZE,115,4083,4198,
Musée du Biterrois,2011,LANGUEDOC-ROUSSILLON,BEZIERS,3530,15619,19149,
Musée de l'Etang de Thau,2011,LANGUEDOC-ROUSSILLON,BOUZIGUES,14337,785,15122,
Musée du Vieux Montpellier,2011,LANGUEDOC-ROUSSILLON,MONTPELLIER,546,1529,2075,
Musée Hyacinthe Rigaud,2011,LANGUEDOC-ROUSSILLON,PERPIGNAN,5154,6096,11250,
Musée du Pays d'Ussel,2011,LIMOUSIN,USSEL,0,4381,4381,
Musée d'Art et d'Archéologie,2011,LIMOUSIN,GUERET,4840,5747,10587,
Musée de l'Histoire du Fer,2011,LORRAINE,JARVILLE-LA-MALGRANGE,2902,6335,9237,
Musée Municipal des Emaux et Faïences,2011,LORRAINE,LONGWY,4334,2084,6418,
Musée du Château de Lunéville,2011,LORRAINE,LUNEVILLE,0,148513,148513,
Palais des ducs de Lorraine - Musée Historique Lorrain,2011,LORRAINE,NANCY,20235,36846,57081,
Musée Départemental Raymond Poincaré,2011,LORRAINE,SAMPIGNY,0,4126,4126,
Musée de la Princerie,2011,LORRAINE,VERDUN,1885,2266,4151,
Musée des Mines de fer de Lorraine,2011,LORRAINE,NEUFCHEF,16539,667,17206,
"Jardin d'Hiver, Musée de La Faïence",2011,LORRAINE,SARREGUEMINES,4509,6075,10584,
Musée Charles Friry,2011,LORRAINE,REMIREMONT,504,1711,2215,
Musée Charles de Bruyères,2011,LORRAINE,REMIREMONT,641,2579,3220,
Musée Départemental de l'Ariège,2011,MIDI-PYRENEES,FOIX,84884,6185,91069,
Musée de la Préhistoire,2011,MIDI-PYRENEES,LE MAS D'AZIL,9711,342,10053,
"Musée des Mœurs et Coutumes, Musée du Rouergue",2011,MIDI-PYRENEES,ESPALION,1695,329,2024,
Musée Municipal Urbain Cabrol,2011,MIDI-PYRENEES,VILLEFRANCHE-DE-ROUERGUE,0,5082,5082,
Musée de l'Armagnac,2011,MIDI-PYRENEES,CONDOM,3217,625,3842,
Musée des Beaux-Arts et des Arts Décoratifs,2011,MIDI-PYRENEES,MIRANDE,475,263,738,
Muséum d'Histoire Naturelle,2011,MIDI-PYRENEES,TOULOUSE,109131,86196,195327,
Musée Georges Labit,2011,MIDI-PYRENEES,TOULOUSE,6180,13642,19822,
Musée Saint-Raymond,2011,MIDI-PYRENEES,TOULOUSE,16338,48987,65325,
Musée Pyrénéen,2011,MIDI-PYRENEES,LOURDES,71759,3843,75602,
Musée de Préhistoire Amédée Lémozi,2011,MIDI-PYRENEES,CABRERETS,76600,0,76600,
Musée d'Histoire Naturelle Victor Brun,2011,MIDI-PYRENEES,MONTAUBAN,1167,7185,8352,
Ecomusée de la Région,2011,NORD-PAS-DE-CALAIS,FOURMIES,32317,20662,52979,
Musée Municipal d'Hazebrouck,2011,NORD-PAS-DE-CALAIS,HAZEBROUCK,778,3105,3883,
Musée de l'Hospice Comtesse,2011,NORD-PAS-DE-CALAIS,LILLE,29800,24800,54600,
Château musée,2011,NORD-PAS-DE-CALAIS,BOULOGNE-SUR-MER,14433,17701,32134,
Musée des Beaux-Arts et de la Dentelle,2011,NORD-PAS-DE-CALAIS,CALAIS,6234,9133,15367,
Musée Quentovic,2011,NORD-PAS-DE-CALAIS,ETAPLES-SUR-MER,2949,856,3805,
Musée Municipal,2011,NORD-PAS-DE-CALAIS,LE TOUQUET-PARIS-PLAGE,8004,4198,12202,
Musée d'Art et d'Histoire Roger Rodière,2011,NORD-PAS-DE-CALAIS,MONTREUIL-SUR-MER,4856,4376,9232,
Musée de Trouville - Villa Montebello,2011,BASSE-NORMANDIE,TROUVILLE-SUR-MER,15580,0,15580,
Musée Municipal d'Avranches,2011,BASSE-NORMANDIE,AVRANCHES,915,806,1721,
Musée de l'Abbaye,2011,BASSE-NORMANDIE,CERISY-LA-FORET,6640,0,6640,
Musée Quesnel-Morinière,2011,BASSE-NORMANDIE,COUTANCES,151,8527,8678,
Musée Christian Dior,2011,BASSE-NORMANDIE,GRANVILLE,26620,5479,32099,
"Musée du Bocage Normand, ferme du bois Jugan",2011,BASSE-NORMANDIE,SAINT-LO,1785,2593,4378,
Musée Barbey d'Aurevilly,2011,BASSE-NORMANDIE,SAINT-SAUVEUR-LE-VICOMTE,1125,530,1655,
Musée des Beaux-Arts et de la Dentelle,2011,BASSE-NORMANDIE,ALENCON,8095,5452,13547,
Pavillon Flaubert,2011,HAUTE-NORMANDIE,CANTELEU,0,493,493,
Musée d'Elbeuf,2011,HAUTE-NORMANDIE,ELBEUF,0,17547,17547,
La Maison de l'Armateur,2011,HAUTE-NORMANDIE,LE HAVRE,4906,5818,10724,
"Juliobona, Musée Gallo-Romain de Lillebonne",2011,HAUTE-NORMANDIE,LILLEBONNE,1669,184,1853,
Musée Flaubert et d'Histoire de la Médecine,2011,HAUTE-NORMANDIE,ROUEN,3061,5144,8205,
Musée des Marais Salant,2011,PAYS DE LA LOIRE,BATZ-SUR-MER,3751,387,4138,
Musée du Vignoble Nantais,2011,PAYS DE LA LOIRE,LE PALLET,3942,2613,6555,
Muséum des Sciences Naturelles,2011,PAYS DE LA LOIRE,ANGERS,2703,11048,13751,
Musée des Beaux-Arts,2011,PAYS DE LA LOIRE,ANGERS,23199,63477,86676,
Musée Jean Lurcat et de la Tapisserie Contemporaine,2011,PAYS DE LA LOIRE,ANGERS,15488,39781,55269,
Galerie David d'Angers,2011,PAYS DE LA LOIRE,ANGERS,6655,16036,22691,
Musée d'Art et d'Histoire,2011,PAYS DE LA LOIRE,CHOLET,2838,18742,21580,
Musée de l'Ardoise et de la Géologie,2011,PAYS DE LA LOIRE,RENAZE,1016,234,1250,
Musée Vert Véron-de-Forbonnais,2011,PAYS DE LA LOIRE,LE MANS,10183,12346,22529,
Musée Espace Faïence de Malicorne,2011,PAYS DE LA LOIRE,MALICORNE-SUR-SARTHE,11323,8500,19823,
Centre Minier de Faymoreau,2011,PAYS DE LA LOIRE,FAYMOREAU,15556,8706,24262,
Musée de Fontenay-le-Comte,2011,PAYS DE LA LOIRE,FONTENAY-LE-COMTE,1775,3894,5669,
Musée ornithologique Charles-Payraudeau,2011,PAYS DE LA LOIRE,LA-CHAIZE-LE-VICOMTE,284,766,1050,
Musée du Nord de la Vendée,2011,PAYS DE LA LOIRE,MONTAIGU,0,477,477,
Musée La Bourrine du Bois-Juquaud,2011,PAYS DE LA LOIRE,SAINT-HILAIRE-DE-RIEZ,12262,7442,19704,
Musée Milcendeau Jean-Yole,2011,PAYS DE LA LOIRE,SOULLANS,1568,1657,3225,
Musée Franco-Américain du Château de Blérancourt,2011,PICARDIE,BLERANCOURT,150,33,183,
Musée du Noyonnais,2011,PICARDIE,NOYON,892,2276,3168,
Musée Départemental de l'Abbaye de Saint-Riquier,2011,PICARDIE,ABBEVILLE,0,26833,26833,
Musée Alfred Danicourt,2011,PICARDIE,PERONNE,0,1971,1971,
Musée Municipal de Cognac,2011,POITOU-CHARENTES,COGNAC,1890,7237,9127,
Musée de la Mytiliculture,2011,POITOU-CHARENTES,ESNANDES,4425,376,4801,
Hôtel Hèbre de Saint-Clément - Musée d'Art et d'Histoire,2011,POITOU-CHARENTES,ROCHEFORT,7175,15571,22746,
Musée ethnographique et archéologique du Donjon,2011,POITOU-CHARENTES,NIORT,7155,9205,16360,
Musée Municipal de Civray,2011,POITOU-CHARENTES,CIVRAY,0,357,357,
Musée Charbonneau-Lassay,2011,POITOU-CHARENTES,LOUDUN,0,621,621,
Musée de Préhistoire Raymond Touchard,2011,POITOU-CHARENTES,LUSSAC-LES-CHATEAUX,1923,4857,6780,
Musée du baptistère Saint-Jean,2011,POITOU-CHARENTES,POITIERS,9704,4199,13903,
Musée de Salagon,2011,PROVENCE-ALPES-CÔTE D'AZUR,MANE,37960,0,37960,
Musée Bonnard,2011,PROVENCE-ALPES-CÔTE D'AZUR,LE CANNET,41300,18130,59430,
Musée de Préhistoire Régionale,2011,PROVENCE-ALPES-CÔTE D'AZUR,MENTON,0,9628,9628,
Musée Départemental des Arts Asiatiques,2011,PROVENCE-ALPES-CÔTE D'AZUR,NICE,0,61223,61223,
Musée d'Art Naïf Anatole Jakovsky,2011,PROVENCE-ALPES-CÔTE D'AZUR,NICE,0,23644,23644,
Musée National Marc Chagall,2011,PROVENCE-ALPES-CÔTE D'AZUR,NICE,103286,51621,154907,
Musée d'Art Moderne et d'Art Contemporain,2011,PROVENCE-ALPES-CÔTE D'AZUR,NICE,223,140740,140963,
Ecomusée du Pays de la Roudoule,2011,PROVENCE-ALPES-CÔTE D'AZUR,PUGET-ROSTANG,387,6795,7182,
Musée Départemental des Merveilles,2011,PROVENCE-ALPES-CÔTE D'AZUR,TENDE,0,32343,32343,
Musée Granet,2011,PROVENCE-ALPES-CÔTE D'AZUR,AIX-EN-PROVENCE,104256,73342,177598,
Musée de la Légion Etrangère,2011,PROVENCE-ALPES-CÔTE D'AZUR,AUBAGNE/PUYLOUBIER,0,25304,25304,
Musée Frédéric Mistral,2011,PROVENCE-ALPES-CÔTE D'AZUR,MAILLANE,1649,2764,4413,
"Musée d'Arts Africains, Océaniens, Amérindiens",2011,PROVENCE-ALPES-CÔTE D'AZUR,MARSEILLE,28782,0,28782,
Musée Estrine - Présence Van Gogh,2011,PROVENCE-ALPES-CÔTE D'AZUR,SAINT-REMY-DE-PROVENCE,8643,6323,14966,
Musée de Salon et de la Crau,2011,PROVENCE-ALPES-CÔTE D'AZUR,SALON-DE-PROVENCE,0,9754,9754,
Musée Marc Deydier,2011,PROVENCE-ALPES-CÔTE D'AZUR,CUCURON,0,4901,4901,
Musée du Brou,2011,RHONE-ALPES,BOURG-EN-BRESSE,45279,33816,79095,
Musée du Peigne et de la Plasturgie,2011,RHONE-ALPES,OYONNAX,851,3650,4501,
Musée Chintreuil,2011,RHONE-ALPES,PONT-DE-VAUX,6034,1303,7337,
Musée d'Histoire et d'Archéologie,2011,RHONE-ALPES,DIE,1142,1587,2729,
Château de Grignan,2011,RHONE-ALPES,GRIGNAN,89271,65294,154565,
Musée International de la Chaussure,2011,RHONE-ALPES,ROMANS,19097,14318,33415,
Musée du Chablais,2011,RHONE-ALPES,THONON-LES-BAINS,1761,1556,3317,
Musée de Grenoble,2011,RHONE-ALPES,GRENOBLE,158864,97290,256154,
Musée Dauphinois,2011,RHONE-ALPES,GRENOBLE,0,62378,62378,
Maison du Patrimoine de Hières-sur-Amby,2011,RHONE-ALPES,HIERES SUR AMBY,6182,1716,7898,
Musée-Cloître Saint-André-Le-Bas,2011,RHONE-ALPES,VIENNE,3486,4001,7487,
Musée de la Diana,2011,RHONE-ALPES,MONTBRISON,3715,428,4143,
Musée des Civilisations : Daniel Pouget,2011,RHONE-ALPES,SAINT-JUST-SAINT-RAMBERT,2483,6546,9029,
Musée Barthélemy-Thimonnier,2011,RHONE-ALPES,AMPLEPUIS,2604,2503,5107,
Musée Historique des Tissus,2011,RHONE-ALPES,LYON,47410,21886,69296,
Musée des Beaux-Arts,2011,RHONE-ALPES,LYON,81096,186470,267566,
Musée des Confluences,2011,RHONE-ALPES,LYON,0,59185,59185,
Musée Archéologique,2011,RHONE-ALPES,SAINT-ROMAIN-EN-GAL,27097,58353,85450,
Musée Paul Dini,2011,RHONE-ALPES,VILLEFRANCHE-SUR-SAONE,9736,12586,22322,
Musée de l'Académie de La Val d'Isère,2011,RHONE-ALPES,MOÛTIERS,290,294,584,
Musée Archéologique,2012,ALSACE,STRASBOURG,5602,33784,39386,
Musée des Arts Décoratifs,2012,ALSACE,STRASBOURG,17247,31491,48738,
Musée Alsacien,2012,ALSACE,STRASBOURG,23009,34451,57460,
Musée Westercamp,2012,ALSACE,WISSEMBOURG,0,425,425,
Musée d'Unterlinden,2012,ALSACE,COLMAR,150933,28207,179140,
Musée Historique et Militaire de Huningue,2012,ALSACE,HUNINGE,268,479,747,
Musée Historique,2012,ALSACE,MULHOUSE,0,34597,34597,
Maison du Sundgau - Musée Paysan,2012,ALSACE,OLTINGUE,1118,200,1318,
Musée du Tabac,2012,AQUITAINE,BERGERAC,2314,2776,5090,
Musée des Arts et Traditions Populaires du Périgord,2012,AQUITAINE,MUSSIDAN,1041,1423,2464,
Musée d'Aquitaine,2012,AQUITAINE,BORDEAUX,17126,135743,152869,
Centre National Jean Moulin,2012,AQUITAINE,BORDEAUX,0,28316,28316,
Musée de Borda,2012,AQUITAINE,DAX,1918,6191,8109,
Musée du Liège et du Bouchon,2012,AQUITAINE,MEZIN,4409,929,5338,
Musée Municipal,2012,AQUITAINE,ARUDY,1035,1042,2077,
Musée Charles-Louis Philippe,2012,AUVERGNE,CERILLY,222,117,339,
Muséum d'Histoire Naturelle Henri-Lecoq,2012,AUVERGNE,CLERMONT-FERRAND,4150,25968,30118,
Musée d'Art Sacré,2012,BOURGOGNE,DIJON,0,11582,11582,
Musée Noisot,2012,BOURGOGNE,FIXIN,329,91,420,
Musée René Davoine,2012,BOURGOGNE,CHAROLLES,0,88,88,
Musée du Prieuré de Charolles,2012,BOURGOGNE,CHAROLLES,1507,1399,2906,
Musée d'Art et d'Archéologie,2012,BOURGOGNE,CLUNY,18335,9219,27554,
Musée Lamartine,2012,BOURGOGNE,MACON,1262,3480,4742,
Hôtel Dieu - Musée Greuze,2012,BOURGOGNE,TOURNUS,8759,1906,10665,
Musée Muncipal,2012,BOURGOGNE,SENS,4196,27864,32060,
Ecomusée des Monts d'Arrée - Moulins de Kerouat,2012,BRETAGNE,COMMANA,7553,1827,9380,
Ecomusée d'Ouessant - Vivre sur une Ile,2012,BRETAGNE,OUESSANT,5162,3372,8534,
Ecomusée du Pays de Montfort,2012,BRETAGNE,MONTFORT-SUR-MEU,6224,0,6224,
Musée National de la Marine,2012,BRETAGNE,PORT-LOUIS,35342,23813,59155,
Musée d'Histoire et d'Archéologie de Vannes,2012,BRETAGNE,VANNES,3574,2674,6248,
Musée des Meilleurs Ouvriers de France,2012,CENTRE,BOURGES,0,17183,17183,
Musée Saint-Vic,2012,CENTRE,SAINT-AMAND-MONTROND,0,4217,4217,
Musée de l'Hôtel des Communes,2012,CENTRE,AMBOISE,0,10602,10602,
"""Maison Musée"" René Descartes",2012,CENTRE,DESCARTES,1531,630,2161,
Musée Balzac,2012,CENTRE,SACHE,13978,7710,21688,
Musée de Sologne,2012,CENTRE,ROMORANTIN-LANTHENAY,3825,10122,13947,
Musée de Vendôme,2012,CENTRE,VENDOME,1351,6882,8233,
Musée Municipal Théâtre Forain et Archéologique,2012,CENTRE,ARTENAY,6752,3687,10439,
Musée Gaston Couté,2012,CENTRE,MEUNG-SUR-LOIRE,0,2335,2335,
Musée des Beaux-Arts,2012,CENTRE,ORLEANS,6440,44891,51331,
Musée de l'Ardenne,2012,CHAMPAGNE-ARDENNES,CHARLEVILLE-MEZIERES,4493,31172,35665,
Musée du Feutre,2012,CHAMPAGNE-ARDENNES,MOUZON,4291,295,4586,
Musée de la Résistance,2012,CHAMPAGNE-ARDENNES,MUSSY-SUR-SEINE,93,29,122,
Musée Vauluisant - Musée de la Bonneterie,2012,CHAMPAGNE-ARDENNES,TROYES,1835,5490,7325,
Musée des Beaux-Arts (Musée Pic Saint-Loup),2012,CHAMPAGNE-ARDENNES,TROYES,15521,2309,17830,
Musée Garinet,2012,CHAMPAGNE-ARDENNES,CHALONS-EN-CHAMPAGNE,121,827,948,
Musée Palais Fesch,2012,CORSE,AJACCIO,25066,15958,41024,
Musée d'archéologie d'Aleria - Jérôme Carcopino,2012,CORSE,ALERIA,28942,25757,54699,
Musée du Temps,2012,FRANCHE-COMTE,BESANCON,6419,34272,40691,
Musée de Plein Air des Maisons Comtoises,2012,FRANCHE-COMTE,NANCRAY,29739,11609,41348,
Musée Baron Martin,2012,FRANCHE-COMTE,GRAY,3022,3348,6370,
Musée Départemental de la Montagne Albert Demard,2012,FRANCHE-COMTE,LE HAUT-DU-THEM,3597,3369,6966,
Musée de la Tour des Echevins,2012,FRANCHE-COMTE,LUXEUIL-LES-BAINS,1977,5351,7328,
Musée Municipal d'Archéologie,2012,FRANCHE-COMTE,CHAMPAGNOLE,246,310,556,
Musée des Beaux-Arts,2012,FRANCHE-COMTE,DOLE,0,19840,19840,
Viséum-Musée de la Lunette,2012,FRANCHE-COMTE,MOREZ HAUTS DE BIENNE,9682,4078,13760,
Musée des Salines,2012,FRANCHE-COMTE,SALINS-LES-BAINS,66022,5951,71973,
Musée Départemental Victor Schoelcher,2012,GUADELOUPE,POINTE-A-PITRE,4760,3118,7878,
Musée des Cultures Guyanaises,2012,GUYANE,CAYENNE,353,7299,7652,
Musée Municipal Robert Dubois-Corneau,2012,ILE-DE-FRANCE,BRUNOY,123,3572,3695,
Musée du Château,2012,ILE-DE-FRANCE,DOURDAN,9186,8198,17384,
Musée Intercommunal d'Etampes,2012,ILE-DE-FRANCE,ETAMPES,2776,16512,19288,
Musée des Avelines - Musée d'Art et d'Histoire,2012,ILE-DE-FRANCE,SAINT-CLOUD,686,18595,19281,
Musée National de la Marine,2012,ILE-DE-FRANCE,PARIS,122375,59310,181685,
Musée du Moyen Age-Thermes et Hôtel de Cluny,2012,ILE-DE-FRANCE,PARIS,155827,154236,310063,
Musée de la Vie Romantique,2012,ILE-DE-FRANCE,PARIS,17767,85500,103267,
Musée Bourdelle,2012,ILE-DE-FRANCE,PARIS,10700,53860,64560,
Musée Zadkine,2012,ILE-DE-FRANCE,PARIS,14,8696,8710,
Musée de la Musique,2012,ILE-DE-FRANCE,PARIS,138057,50126,188183,
Etablissement Public du Musée des Arts Asiatiques Guimet,2012,ILE-DE-FRANCE,PARIS,129778,135078,264856,
Musée d'Ennery,2012,ILE-DE-FRANCE,PARIS,0,732,732,
Musée Galliera - Musée de la Mode de la ville de Paris,2012,ILE-DE-FRANCE,PARIS,56314,19572,75886,
Mémorial du Maréchal Leclerc de Hauteclocque et de la Libération de Paris-musée Jean Moulin,2012,ILE-DE-FRANCE,PARIS,2717,12030,14747,
Musée National Auguste Rodin,2012,ILE-DE-FRANCE,PARIS,445457,273357,718814,
Établissement Public de la Porte Dorée - Cité Nationale de l’Histoire de l’Immigration,2012,ILE-DE-FRANCE,PARIS,11484,59155,70639,
"Musée Cernuschi, Musée des Arts de l'Asie de la ville de Paris",2012,ILE-DE-FRANCE,PARIS,23673,41425,65098,
Musée des Arts Décoratifs (Union Centrale des Arts Décoratifs),2012,ILE-DE-FRANCE,PARIS,325416,277682,603098,
Musée du Service de Santé des Armées du Val-de-Grâce,2012,ILE-DE-FRANCE,PARIS,8667,7546,16213,
Musée Municipal de Chelles Alfred Bonno,2012,ILE-DE-FRANCE,CHELLES,0,3544,3544,
Musée Municipal des Capucins,2012,ILE-DE-FRANCE,COULOMMIERS,2025,2458,4483,
Musée de la Grande Guerre du Pays de Meaux,2012,ILE-DE-FRANCE,MEAUX,95325,20675,116000,
Musée de l'Air et de l'Espace,2012,ILE-DE-FRANCE,LE BOURGET,140065,81817,221882,
Musée Adrien Mentienne,2012,ILE-DE-FRANCE,BRY-SUR-MARNE,0,4200,4200,
Musée Fragonard,2012,ILE-DE-FRANCE,MAISONS-ALFORT,4414,3393,7807,
Musée de Nogent-Sur-Marne,2012,ILE-DE-FRANCE,NOGENT-SUR-MARNE,0,8336,8336,
"MAC VAL, Musée d'Art Contemporain du Val-de-Marne",2012,ILE-DE-FRANCE,VITRY SUR SEINE,10059,58561,68620,
Musée Archéologique du Val d'Oise,2012,ILE-DE-FRANCE,GUIRY-EN-VEXIN,0,11488,11488,
Musée Tavet Delacour,2012,ILE-DE-FRANCE,PONTOISE,4988,5067,10055,
Musée Intercommunal d'Histoire et d'Archéologie de Louvres,2012,ILE-DE-FRANCE,ROISSY-EN-FRANCE,6318,3124,9442,
Musée de la Batellerie et des Voies Navigables,2012,ILE-DE-FRANCE,CONFLANS-SAINTE-HONORINE,9146,2652,11798,
Musée Promenade Marly/Louveciennes,2012,ILE-DE-FRANCE,LOUVECIENNES,7590,2718,10308,
Musée du Jouet Pierre Pinel,2012,ILE-DE-FRANCE,POISSY,12783,4433,17216,
Musée Rambolitrain,2012,ILE-DE-FRANCE,RAMBOUILLET,15051,2887,17938,
Musée Municipal - Collections Paul et André Véra,2012,ILE-DE-FRANCE,SAINT-GERMAIN-EN-LAYE,0,2305,2305,
Musée des Arts Décoratifs de l’Océan indien (MADOI),2012,LA REUNION,SAINT-LOUIS,0,10700,10700,
Musée d'Art et d'Histoire - Ensemble monumental de Narbonne,2012,LANGUEDOC-ROUSSILLON,NARBONNE,46899,617504,664403,
Musée du Vieux Nîmes,2012,LANGUEDOC-ROUSSILLON,NIMES,0,19673,19673,
Musée des Beaux-Arts,2012,LANGUEDOC-ROUSSILLON,NIMES,3763,13743,17506,
Musée Départemental d'Art Sacré du Gard,2012,LANGUEDOC-ROUSSILLON,PONT-SAINT-ESPRIT,305,8772,9077,
Musée des Vallées Cévenoles,2012,LANGUEDOC-ROUSSILLON,SAINT-JEAN DU GARD,8072,6220,14292,
Musée de l'Ephèbe,2012,LANGUEDOC-ROUSSILLON,LE CAP D'AGDE,9306,5123,14429,
Musée Archéologique Paul Soyris,2012,LANGUEDOC-ROUSSILLON,MURVIEL-LES-MONTPELLIER,77,442,519,
Muséum d'Histoire Naturelle,2012,LANGUEDOC-ROUSSILLON,PERPIGNAN,0,10018,10018,
Musée du Cloître de Tulle André Mazeyrie,2012,LIMOUSIN,TULLE,0,27093,27093,
Musée d'Art et d'Archéologie,2012,LIMOUSIN,GUERET,4840,6639,11479,
Musée Municipal des Beaux-Arts de Limoges - Palais de l'Evêché,2012,LIMOUSIN,LIMOGES,4943,48245,53188,
Les Sources d'Hercule,2012,LORRAINE,DENEUVRE,2503,553,3056,
Musée de l'Ecole de Nancy,2012,LORRAINE,NANCY,31914,22676,54590,
"Musée ""au Fil du Papier""",2012,LORRAINE,PONT-A-MOUSSON,2441,1474,3915,
Musée Départemental du Sel,2012,LORRAINE,MARSAL,3988,7448,11436,
Musée de la Mine - Carreau Wendel,2012,LORRAINE,PETITE-ROSSELLE,22329,8229,30558,
Moulin de la Blies - Musée des Techniques Faïencières,2012,LORRAINE,SARREGUEMINES,11475,13487,24962,
Musée Départemental d'Art Ancien et Contemporain,2012,LORRAINE,EPINAL,1989,9531,11520,
Musée de la Lutherie et de l'Archèterie Française,2012,LORRAINE,MIRECOURT,5866,5325,11191,
Musée Charles de Bruyères,2012,LORRAINE,REMIREMONT,551,2798,3349,
Musée Régional de Géologie Pierre Vetter,2012,MIDI-PYRENEES,DECAZEVILLE,2686,2138,4824,
Musée du Charroi Rural et de l'Artisanat Traditionnel,2012,MIDI-PYRENEES,SALMIECH,110,934,1044,
Musée des jacobins,2012,MIDI-PYRENEES,AUCH,4162,8806,12968,
Musée de l'Armagnac,2012,MIDI-PYRENEES,CONDOM,2654,453,3107,
Musée d'Archéologie,2012,MIDI-PYRENEES,LECTOURE,1344,1213,2557,
Musée du Pays de Luchon,2012,MIDI-PYRENEES,BAGNERES-DE-LUCHON,1528,369,1897,
Musée des Augustins,2012,MIDI-PYRENEES,TOULOUSE,103289,83491,186780,
Musée Salies,2012,MIDI-PYRENEES,BAGNERES-DE-BIGORRE,3511,625,4136,
Musée Goya,2012,MIDI-PYRENEES,CASTRES,13670,13716,27386,
Musée de l'Abbaye Saint-Michel,2012,MIDI-PYRENEES,GAILLAC,2053,867,2920,
Musée des arts et traditions populaires,2012,MIDI-PYRENEES,MOISSAC,4653,0,4653,
Musée Benoît de Puydt,2012,NORD-PAS-DE-CALAIS,BAILLEUL,1984,2481,4465,
Musée de l'Ostrevant,2012,NORD-PAS-DE-CALAIS,BOUCHAIN,133,458,591,
Musée Diocésain d'Art Sacré,2012,NORD-PAS-DE-CALAIS,CAMBRAI,0,635,635,
Lieu d'Art et Action Contemporaine de Dunkerque - LAAC,2012,NORD-PAS-DE-CALAIS,DUNKERQUE,17393,3607,21000,
Musée Municipal d'Escaudain,2012,NORD-PAS-DE-CALAIS,ESCAUDAIN,0,426,426,
"Musée de la Mine, Centre Historique Minier",2012,NORD-PAS-DE-CALAIS,LEWARDE,135614,16408,152022,
Musée de l'Hospice Comtesse,2012,NORD-PAS-DE-CALAIS,LILLE,142600,0,142600,
Musée d'Histoire Locale de Marchiennes,2012,NORD-PAS-DE-CALAIS,MARCHIENNES,128,380,508,
Musée du Verre,2012,NORD-PAS-DE-CALAIS,SARS-POTERIES,7392,8661,16053,
Château musée,2012,NORD-PAS-DE-CALAIS,BOULOGNE-SUR-MER,14078,24400,38478,
Musée des Beaux-Arts et de la Dentelle,2012,NORD-PAS-DE-CALAIS,CALAIS,5149,14035,19184,
Musée Municipal,2012,NORD-PAS-DE-CALAIS,LE TOUQUET-PARIS-PLAGE,5981,6440,12421,
Louvre-Lens (collections nationales decentralisées),2012,NORD-PAS-DE-CALAIS,LENS,20180,128090,148270,
Musée Municipal Bruno Danvin,2012,NORD-PAS-DE-CALAIS,SAINT-POL-SUR-TERNOISE,0,5201,5201,
Musée de Normandie,2012,BASSE-NORMANDIE,CAEN,26775,110007,136782,
Mémorial de Caen,2012,BASSE-NORMANDIE,CAEN,315000,50000,365000,
Musée d'Ethnographie et d'Arts Populaires et Musée de la Marine,2012,BASSE-NORMANDIE,HONFLEUR,16374,1449,17823,
Musée et Sites archéologiques de Vieux-la-Romaine,2012,BASSE-NORMANDIE,VIEUX,2868,12543,15411,
Musée de la Pomme et de la Poire,2012,BASSE-NORMANDIE,BARENTON,717,2847,3564,
Musée Christian Dior,2012,BASSE-NORMANDIE,GRANVILLE,30844,7905,38749,
"Musée du Bocage Normand, ferme du bois Jugan",2012,BASSE-NORMANDIE,SAINT-LO,1820,3181,5001,
Musée de la Poeslerie,2012,BASSE-NORMANDIE,VILLEDIEU-LES-POELES-ROUFFIGNY,7284,324,7608,
Musée des Beaux-Arts et de la Dentelle,2012,BASSE-NORMANDIE,ALENCON,9768,6102,15870,
Musée Municipal d'Archéologie,2012,BASSE-NORMANDIE,L'AIGLE,670,492,1162,
Musée Départemental d'Art Sacré,2012,BASSE-NORMANDIE,SEES,731,220,951,
Musée du Verre et de la Pierre,2012,HAUTE-NORMANDIE,CONCHES-EN-OUCHE,2666,3189,5855,
Maison des Templiers,2012,HAUTE-NORMANDIE,CAUDEBEC-EN-CAUX,0,158,158,
Musée du Prieuré,2012,HAUTE-NORMANDIE,HARFLEUR,110,3192,3302,
La Maison de l'Armateur,2012,HAUTE-NORMANDIE,LE HAVRE,4602,5535,10137,
"Juliobona, Musée Gallo-Romain de Lillebonne",2012,HAUTE-NORMANDIE,LILLEBONNE,669,830,1499,
Musée des Traditions et Arts Normands,2012,HAUTE-NORMANDIE,MARTAINVILLE-EPREVILLE,8464,13041,21505,
Ecomusée de la Basse-Seine,2012,HAUTE-NORMANDIE,NOTRE-DAME-DE-BLIQUETUIT,23769,5069,28838,
Musée Industriel de la Corderie Vallois,2012,HAUTE-NORMANDIE,NOTRE-DAME-DE-BONDEVILLE,1675,7376,9051,
Musée des Antiquités de la Seine-Maritime,2012,HAUTE-NORMANDIE,ROUEN,1942,25624,27566,
Musée-Maison Natale Pierre Corneille,2012,HAUTE-NORMANDIE,ROUEN,0,10214,10214,
Muséum d'Histoire Naturelle,2012,HAUTE-NORMANDIE,ROUEN,6081,28573,34654,
Musée des Beaux-Arts,2012,HAUTE-NORMANDIE,ROUEN,32760,65017,97777,
Musée des Beaux-Arts,2012,PAYS DE LA LOIRE,ANGERS,18649,52089,70738,
Musée Jean Lurcat et de la Tapisserie Contemporaine,2012,PAYS DE LA LOIRE,ANGERS,17329,47177,64506,
Galerie David d'Angers,2012,PAYS DE LA LOIRE,ANGERS,6860,16492,23352,
Musée Espace Faïence de Malicorne,2012,PAYS DE LA LOIRE,MALICORNE-SUR-SARTHE,22281,0,22281,
Musée des Traditions de l'Île,2012,PAYS DE LA LOIRE,LA GUERINIERE,2812,759,3571,
Musée de l'Abbaye de Sainte-Croix,2012,PAYS DE LA LOIRE,LES SABLES D'OLONNE,4153,15101,19254,
Musée La Bourrine du Bois-Juquaud,2012,PAYS DE LA LOIRE,SAINT-HILAIRE-DE-RIEZ,10718,7394,18112,
Musée Jeanne d'Aboville,2012,PICARDIE,LA FERE,58,77,135,
Musée Entomologique,2012,PICARDIE,SAINT-QUENTIN,3558,4422,7980,
Musée des Beaux-Arts Antoine Lecuyer,2012,PICARDIE,SAINT-QUENTIN,3303,5618,8921,
Musée de La Thiérache,2012,PICARDIE,VERVINS,0,2889,2889,
Musée de l'Archerie et de l'Art Sacré,2012,PICARDIE,CREPY-EN-VALOIS,3798,2499,6297,
Musée Archéologique de l'Oise,2012,PICARDIE,VENDEUIL-CAPLY,1937,2477,4414,
Musée de la Mytiliculture,2012,POITOU-CHARENTES,ESNANDES,2712,371,3083,
Musée des Tumulus de Bougon,2012,POITOU-CHARENTES,BOUGON,11395,4242,15637,
Musée ethnographique et archéologique du Donjon,2012,POITOU-CHARENTES,NIORT,6233,6627,12860,
Musée Bernard d’Agesci,2012,POITOU-CHARENTES,NIORT,4293,7267,11560,
Musée Sainte-Croix,2012,POITOU-CHARENTES,POITIERS,3814,20066,23880,
Musée Gassendi,2012,PROVENCE-ALPES-CÔTE D'AZUR,DIGNE-LES-BAINS,2490,5659,8149,
Musée du Vieux Sisteron,2012,PROVENCE-ALPES-CÔTE D'AZUR,SISTERON,0,419,419,
Musée d'Histoire Locale,2012,PROVENCE-ALPES-CÔTE D'AZUR,BIOT,1479,2058,3537,
Musée National Marc Chagall,2012,PROVENCE-ALPES-CÔTE D'AZUR,NICE,108323,55509,163832,
Musée Archéologique - Site de Terra Amata,2012,PROVENCE-ALPES-CÔTE D'AZUR,NICE,0,22599,22599,
Musée Estrine - Présence Van Gogh,2012,PROVENCE-ALPES-CÔTE D'AZUR,SAINT-REMY-DE-PROVENCE,1761,1165,2926,
Musée Jean Aicard,2012,PROVENCE-ALPES-CÔTE D'AZUR,LE POUVEREL LA GARDE,0,1373,1373,
Musée Archéologique,2012,PROVENCE-ALPES-CÔTE D'AZUR,SAINT-RAPHAËL,0,20026,20026,
Musée de l'Annonciade,2012,PROVENCE-ALPES-CÔTE D'AZUR,SAINT-TROPEZ,28586,6848,35434,
Musée de l'Hôtel Dieu,2012,PROVENCE-ALPES-CÔTE D'AZUR,CAVAILLON,110,607,717,
Musée du Vieux Pérouges,2012,RHONE-ALPES,PEROUGES,21900,1930,23830,
Musée du Château des Adhémars,2012,RHONE-ALPES,MONTELIMAR,15561,0,15561,
Musée Alpin,2012,RHONE-ALPES,CHAMONIX,11024,5327,16351,
Musée Jadis Allevard,2012,RHONE-ALPES,ALLEVARD-LES-BAINS,764,4970,5734,
Musée Dauphinois,2012,RHONE-ALPES,GRENOBLE,0,92997,92997,
Musée Hébert,2012,RHONE-ALPES,LA TRONCHE,0,33970,33970,
Musée Alice Taverne,2012,RHONE-ALPES,AMBIERLE,4037,549,4586,
Musée Hospitalier,2012,RHONE-ALPES,CHARLIEU,3009,1395,4404,
Château de la Bastie d'Urfé,2012,RHONE-ALPES,SAINT-ETIENNE-LE-MOLARD,16473,10326,26799,
Musée des Civilisations : Daniel Pouget,2012,RHONE-ALPES,SAINT-JUST-SAINT-RAMBERT,1500,4891,6391,
Musée Barthélemy-Thimonnier,2012,RHONE-ALPES,AMPLEPUIS,2399,2817,5216,
Musée Folklorique et Traditions Populaires Marius Audin,2012,RHONE-ALPES,BEAUJEU,1459,840,2299,
Lugdunum - Musée et Théâtres Romains,2012,RHONE-ALPES,LYON,27180,57898,85078,
Centre d'Histoire de la Résistance et de la Déportation,2012,RHONE-ALPES,LYON,2934,11079,14013,
Musée de l'Imprimerie et de la Communication Graphique,2012,RHONE-ALPES,LYON,17407,18071,35478,
Musée Henri Malartre,2012,RHONE-ALPES,ROCHETAILLEE-SUR-SAONE,15908,20337,36245,
Musée du docteur Faure,2012,RHONE-ALPES,AIX-LES-BAINS,6193,5960,12153,
Musée Savoisien,2012,RHONE-ALPES,CHAMBERY,1559,21010,22569,
Musée Alsacien,2013,ALSACE,HAGUENAU,1908,2654,4562,
Musée Historique,2013,ALSACE,HAGUENAU,2943,18272,21215,
Musée de la Porte de Thann,2013,ALSACE,CERNAY,228,68,296,
Musée National de l'Automobile - Collection Schlumpf,2013,ALSACE,MULHOUSE,163224,27996,191220,
Musée du Papier Peint,2013,ALSACE,RIXHEIM,7148,4857,12005,
Ecomusée d'Alsace,2013,ALSACE,UNGERSHEIM,158563,21390,179953,
Château de Bourdeilles,2013,AQUITAINE,BOURDEILLES,27353,308,27661,
Musée Fernand Desmoulin,2013,AQUITAINE,BRANTOME,19670,2670,22340,
Musée National de la Préhistoire,2013,AQUITAINE,LES EYZIES-DE-TAYAC,43630,35030,78660,
Musée Militaire - Souvenir du Périgord,2013,AQUITAINE,PERIGUEUX,1774,1124,2898,
Musée d'Art et d'Archéologie du Périgord (MAAP),2013,AQUITAINE,PERIGUEUX,7310,19132,26442,
Centre National Jean Moulin,2013,AQUITAINE,BORDEAUX,0,28971,28971,
Musée des Beaux-Arts,2013,AQUITAINE,BORDEAUX,8743,51923,60666,
Musée de Préhistoire Mésolithique Laurent Coulonges,2013,AQUITAINE,SAUVETERRE-LA-LEMANCE,2836,663,3499,
Musée Municipal,2013,AQUITAINE,ARUDY,1075,1071,2146,
Musée Municipal des Beaux-Arts,2013,AQUITAINE,PAU,7207,10219,17426,
Musée Municipal de Souvigny,2013,AUVERGNE,SOUVIGNY,6269,1755,8024,
Musée des Arts D'Afrique et D'Asie,2013,AUVERGNE,VICHY,2980,1895,4875,
Musée des Sciences,2013,AUVERGNE,AURILLAC,949,9711,10660,
Musée d'Art et d'Archéologie,2013,AUVERGNE,AURILLAC,1333,14747,16080,
Ecomusée de Margeride-Haute-Auvergne,2013,AUVERGNE,RUYNES-EN-MARGERIDE,7460,1467,8927,
Musée du Pays Châtillonnais - Trésor de Vix,2013,BOURGOGNE,CHATILLON-SUR-SEINE,14457,6192,20649,
"Musée de la Vie Bourguignonne, Perrin de Puycousin",2013,BOURGOGNE,DIJON,0,42904,42904,
Musée de la Mine,2013,BOURGOGNE,LA MACHINE,6503,1226,7729,
Musée Denon,2013,BOURGOGNE,CHALON-SUR-SAONE,0,9937,9937,
Musée du Terroir,2013,BOURGOGNE,ROMENAY,3036,1207,4243,
Maison du Blé et du Pain,2013,BOURGOGNE,VERDUN-SUR-LE-DOUBS,2297,1840,4137,
Musée Muncipal,2013,BOURGOGNE,SENS,4063,24297,28360,
Musée d'Art et d'Histoire,2013,BRETAGNE,SAINT-BRIEUC,0,33854,33854,
Ecomusée des Monts d'Arrée - Moulins de Kerouat,2013,BRETAGNE,COMMANA,7973,3689,11662,
Le Port-Musée,2013,BRETAGNE,DOUARNENEZ,30090,11509,41599,
Musée de Morlaix,2013,BRETAGNE,MORLAIX,8789,12266,21055,
Musée des Beaux-Arts,2013,BRETAGNE,QUIMPER,27600,17006,44606,
Ecomusée des Monts d'Arrée - Maison Cornec,2013,BRETAGNE,RIVOAL,2472,3987,6459,
Musée d'Histoire de la Ville de Saint-Malo,2013,BRETAGNE,SAINT-MALO,16296,10213,26509,
Musée de Préhistoire J. Miln- Z. Le-Rouzic,2013,BRETAGNE,CARNAC,26107,5730,31837,
Musée du Faouët,2013,BRETAGNE,LE FAOUET,14393,4166,18559,
"La Cohue, Musée des Beaux-Arts de vannes (+ espace d'expositions)",2013,BRETAGNE,VANNES,4625,210046,214671,
Musée des Arts Décoratifs,2013,CENTRE,BOURGES,0,21582,21582,
Musée Municipal,2013,CENTRE,VIERZON,0,7088,7088,
Muséum des Sciences Naturelles et de Préhistoire,2013,CENTRE,CHARTRES,779,16113,16892,
Conservatoire du Machinisme et des Pratiques Agricoles,2013,CENTRE,CHARTRES-MAINVILLIERS,5128,44280,49408,
Château Musée,2013,CENTRE,AZAY-LE-FERRON,12295,2739,15034,
Musée de l'Hospice Saint-Roch,2013,CENTRE,ISSOUDUN,133,14278,14411,
"""Maison Musée"" René Descartes",2013,CENTRE,DESCARTES,1524,526,2050,
Musée Municipal,2013,CENTRE,SAINTE-MAURE-DE-TOURAINE,0,256,256,
Musée François Rabelais,2013,CENTRE,SEUILLY,8913,3594,12507,
Maison de la Magie,2013,CENTRE,BLOIS,69711,22246,91957,
Musée de Vendôme,2013,CENTRE,VENDOME,483,11539,12022,
Musée des Sciences Naturelles,2013,CENTRE,ORLEANS,12997,55989,68986,
Musée des Beaux-Arts,2013,CENTRE,ORLEANS,6955,55716,62671,
Musée de la Maison de la Dernière Cartouche,2013,CHAMPAGNE-ARDENNES,BAZEILLES,1173,865,2038,
Maison des Ailleurs - Arthur Rimbaud (Annexe musée Rimbaud),2013,CHAMPAGNE-ARDENNES,CHARLEVILLE-MEZIERES,5195,2923,8118,
Musée Napoléon Ier,2013,CHAMPAGNE-ARDENNES,BRIENNE-LE-CHATEAU,3008,1388,4396,
Musée Vauluisant - Musée de la Bonneterie,2013,CHAMPAGNE-ARDENNES,TROYES,1948,2989,4937,
Musée des Beaux-Arts (Musée Pic Saint-Loup),2013,CHAMPAGNE-ARDENNES,TROYES,4543,11823,16366,
Pharmacie Musée de l'Hôtel-Dieu,2013,CHAMPAGNE-ARDENNES,TROYES,2834,6234,9068,
Musée des Beaux-Arts et d'Archéologie,2013,CHAMPAGNE-ARDENNES,CHAUMONT,588,2605,3193,
Musée du Breuil de Saint-Germain,2013,CHAMPAGNE-ARDENNES,LANGRES,2558,3536,6094,
Musée Municipal,2013,CHAMPAGNE-ARDENNES,SAINT-DIZIER,0,6210,6210,
Musée Municipal,2013,CHAMPAGNE-ARDENNES,CHALONS-EN-CHAMPAGNE,1295,16800,18095,
Musée Saint-Rémi,2013,CHAMPAGNE-ARDENNES,REIMS,4908,16854,21762,
Musée des Beaux-Arts de Saint-Denis,2013,CHAMPAGNE-ARDENNES,REIMS,21312,29699,51011,
Musée Palais Fesch,2013,CORSE,AJACCIO,23400,11984,35384,
Musée de l'Alta Rocca,2013,CORSE,LEVIE,6425,9659,16084,
Musée d'Histoire de Bastia,2013,CORSE,BASTIA,15462,5978,21440,
Musée de la résistance et de la Déportation,2013,FRANCHE-COMTE,BESANCON,51706,0,51706,
Musée Georges Garret,2013,FRANCHE-COMTE,VESOUL,0,5566,5566,
Musée du Jouet,2013,FRANCHE-COMTE,MOIRANS-EN-MONTAGNE,34391,8662,43053,
Musée de l'Artisanat Jurassien,2013,FRANCHE-COMTE,VOITEUR,0,18559,18559,
Musée Frédéric Japy,2013,FRANCHE-COMTE,BEAUCOURT,1053,788,1841,
Musée d'Art et d'Histoire,2013,FRANCHE-COMTE,BELFORT,19605,0,19605,
Musée Précolombien Edgar Clerc,2013,GUADELOUPE,LE MOULE,0,9585,9585,
Musée Départemental Victor Schoelcher,2013,GUADELOUPE,POINTE-A-PITRE,4669,3518,8187,
Musée Français de la Photographie,2013,ILE-DE-FRANCE,BIEVRES,1579,36712,38291,
Musée du Château,2013,ILE-DE-FRANCE,DOURDAN,7103,5830,12933,
Musée Belmondo et de la Sculpture Figurative du XXè siècle,2013,ILE-DE-FRANCE,BOULOGNE-BILLANCOURT,8581,0,8581,
Musée Municipal d'Art et d'Histoire,2013,ILE-DE-FRANCE,COLOMBES,0,7164,7164,
Grande Galerie de l'Evolution (Muséum National d'Histoire Naturelle),2013,ILE-DE-FRANCE,PARIS,498855,253566,752421,
Galerie d'Anatomie Comparée et de Paléontologie (Muséum d'Histoire Naturelle),2013,ILE-DE-FRANCE,PARIS,105794,179365,285159,
Maison de Victor Hugo,2013,ILE-DE-FRANCE,PARIS,30252,129906,160158,
Musée National Jean-Jacques Henner,2013,ILE-DE-FRANCE,PARIS,5375,4521,9896,
Musée Galliera - Musée de la Mode de la ville de Paris,2013,ILE-DE-FRANCE,PARIS,70622,257935,328557,
Musée d'Art Moderne de la ville de Paris,2013,ILE-DE-FRANCE,PARIS,367548,327828,695376,
Musée d'Art et d'Histoire du Judaïsme,2013,ILE-DE-FRANCE,PARIS,79340,38304,117644,
L'Adresse Musée de la Poste,2013,ILE-DE-FRANCE,PARIS,71086,92017,163103,
Musée Départemental de l'Ecole de Barbizon - Auberge Ganne,2013,ILE-DE-FRANCE,BARBIZON,11754,7079,18833,
Maison Natale de Louis Braille,2013,ILE-DE-FRANCE,COUPVRAY,4439,0,4439,
Musée de la Grande Guerre du Pays de Meaux,2013,ILE-DE-FRANCE,MEAUX,78000,18000,96000,
Ecomusée du Val de Bièvre,2013,ILE-DE-FRANCE,FRESNES,0,10732,10732,
Musée de Nogent-Sur-Marne,2013,ILE-DE-FRANCE,NOGENT-SUR-MARNE,512,5604,6116,
Musée de la Renaissance - Château d'Ecouen,2013,ILE-DE-FRANCE,ECOUEN,15727,41274,57001,
Musée Intercommunal d'Histoire et d'Archéologie de Louvres,2013,ILE-DE-FRANCE,ROISSY-EN-FRANCE,6534,2504,9038,
Musée de la Toile de Jouy,2013,ILE-DE-FRANCE,JOUY-EN-JOSAS,6072,1124,7196,
Musée National de Port Royal des Champs,2013,ILE-DE-FRANCE,MAGNY-LES-HAMEAUX,4062,15436,19498,
Collections de la Fondation de Coubertin,2013,ILE-DE-FRANCE,SAINT-REMY-LES-CHEVREUSE,1066,504,1570,
Musée Lambinet,2013,ILE-DE-FRANCE,VERSAILLES,10283,5030,15313,
Etablissement Public du Musée et du Domaine National de Versailles,2013,ILE-DE-FRANCE,VERSAILLES,5663007,1904001,7567008,
Musée Archéologique,2013,LANGUEDOC-ROUSSILLON,SALLELES D'AUDE,6494,1482,7976,
Musée d'Histoire Naturelle et de Préhistoire,2013,LANGUEDOC-ROUSSILLON,NIMES,0,53809,53809,
Musée Paul Raymond,2013,LANGUEDOC-ROUSSILLON,PONT-SAINT-ESPRIT,0,1680,1680,
Musée des Vallées Cévenoles,2013,LANGUEDOC-ROUSSILLON,SAINT-JEAN DU GARD,8977,5814,14791,
Musée Municipal Georges Borias,2013,LANGUEDOC-ROUSSILLON,UZES,1831,1356,3187,
Musée Fleury,2013,LANGUEDOC-ROUSSILLON,LODEVE,21997,7664,29661,
Musée de Vulliod Saint-Germain,2013,LANGUEDOC-ROUSSILLON,PEZENAS,3221,5494,8715,
Musée Paul Valéry,2013,LANGUEDOC-ROUSSILLON,SETE,52325,19038,71363,
Musée du Cloître de Tulle André Mazeyrie,2013,LIMOUSIN,TULLE,0,18705,18705,
Muséum- Aquarium de Nancy,2013,LORRAINE,NANCY,32243,70457,102700,
"Musée ""au Fil du Papier""",2013,LORRAINE,PONT-A-MOUSSON,2772,2301,5073,
Maison du Verre et du Cristal,2013,LORRAINE,MEISENTHAL,17283,2368,19651,
Centre Pompidou de Metz (collections nationales decentralisées),2013,LORRAINE,METZ,113838,221162,335000,
Musée de la Mine - Carreau Wendel,2013,LORRAINE,PETITE-ROSSELLE,32522,11178,43700,
Musée du Palais des Evêques,2013,MIDI-PYRENEES,SAINT-LIZIER,9644,1637,11281,
Musée Municipal de Millau,2013,MIDI-PYRENEES,MILLAU,4501,15461,19962,
Musée Fenaille,2013,MIDI-PYRENEES,RODEZ,6279,12063,18342,
Musée des Arts et Métiers Traditionnels,2013,MIDI-PYRENEES,SALLES-LA-SOURCE,5575,1522,7097,
Musée Municipal Urbain Cabrol,2013,MIDI-PYRENEES,VILLEFRANCHE-DE-ROUERGUE,0,4168,4168,
Musée d'Archéologie,2013,MIDI-PYRENEES,LECTOURE,1752,938,2690,
Le Musée - Arts et Figures des Pyrénées Centrales,2013,MIDI-PYRENEES,SAINT-GAUDENS,0,3691,3691,
Musée des Transports et des Communications,2013,MIDI-PYRENEES,TOULOUSE,0,752,752,
"Les Abattoirs, Musée d'Art Moderne et Contemporain",2013,MIDI-PYRENEES,TOULOUSE,42703,77033,119736,
Muséum d'Histoire Naturelle,2013,MIDI-PYRENEES,BAGNERES-DE-BIGORRE,1438,372,1810,
Musée Salies,2013,MIDI-PYRENEES,BAGNERES-DE-BIGORRE,2960,1087,4047,
Musée Toulouse Lautrec,2013,MIDI-PYRENEES,ALBI,150606,32872,183478,
Musée Jean Jaurès,2013,MIDI-PYRENEES,CASTRES,2797,8962,11759,
Musée Goya,2013,MIDI-PYRENEES,CASTRES,10651,15248,25899,
Musée Charles Portal - Histoire et Patrimoine,2013,MIDI-PYRENEES,CORDES-SUR-CIEL,888,367,1255,
Musée des Beaux-Arts,2013,MIDI-PYRENEES,GAILLAC,2907,1702,4609,
Musée du Pays Vaurais,2013,MIDI-PYRENEES,LAVAUR,2502,2838,5340,
Musée Benoît de Puydt,2013,NORD-PAS-DE-CALAIS,BAILLEUL,2375,2196,4571,
Musée de l'Ostrevant,2013,NORD-PAS-DE-CALAIS,BOUCHAIN,42,396,438,
Musée Diocésain d'Art Sacré,2013,NORD-PAS-DE-CALAIS,CAMBRAI,0,450,450,
Musée d'Archéologie et d'Histoire Locale,2013,NORD-PAS-DE-CALAIS,DENAIN,0,4750,4750,
Musée de la Chartreuse,2013,NORD-PAS-DE-CALAIS,DOUAI,15163,41768,56931,
Musée du Dessin et de l'Estampe Originale,2013,NORD-PAS-DE-CALAIS,GRAVELINES,2822,16541,19363,
Musée Départemental Matisse,2013,NORD-PAS-DE-CALAIS,LE CATEAU-CAMBRESIS,20804,41646,62450,
Louvre-Lens (collections nationales decentralisées),2013,NORD-PAS-DE-CALAIS,LENS,166744,696373,863117,
Musée Municipal Bruno Danvin,2013,NORD-PAS-DE-CALAIS,SAINT-POL-SUR-TERNOISE,0,5194,5194,
Musée Jean-Charles Cazin,2013,NORD-PAS-DE-CALAIS,SAMER,0,575,575,
Musée Baron Gérard,2013,BASSE-NORMANDIE,BAYEUX,22725,12008,34733,
Mémorial de Caen,2013,BASSE-NORMANDIE,CAEN,286696,50090,336786,
Musée Eugène Boudin,2013,BASSE-NORMANDIE,HONFLEUR,42682,2623,45305,
Musée de la Mine,2013,BASSE-NORMANDIE,LE MOLAY-LITTRY,3314,1168,4482,
Musée de la Meunerie - Moulin de Marcy,2013,BASSE-NORMANDIE,LE MOLAY-LITTRY,3170,2707,5877,
Musée et Sites archéologiques de Vieux-la-Romaine,2013,BASSE-NORMANDIE,VIEUX,10362,6359,16721,
Paléospace / Musée Paléontologique,2013,BASSE-NORMANDIE,VILLERS-SUR-MER,33764,2611,36375,
Musée Municipal,2013,BASSE-NORMANDIE,VIRE NORMANDIE,1165,5756,6921,
Musée Municipal d'Avranches,2013,BASSE-NORMANDIE,AVRANCHES,894,828,1722,
Musée du Granit,2013,BASSE-NORMANDIE,SAINT-MICHEL-DE-MONTJOIE,0,1286,1286,
Musée Régional du Cidre et du Calvados,2013,BASSE-NORMANDIE,VALOGNES,3478,2076,5554,
Musée de l'Ancien Evêché,2013,HAUTE-NORMANDIE,EVREUX,0,19408,19408,
Musée du Prieuré,2013,HAUTE-NORMANDIE,HARFLEUR,118,4105,4223,
Musée de l'Hôtel Dubocage de Bléville,2013,HAUTE-NORMANDIE,LE HAVRE,0,8080,8080,
Ecomusée de la Basse-Seine,2013,HAUTE-NORMANDIE,NOTRE-DAME-DE-BLIQUETUIT,19355,4937,24292,
Musée Industriel de la Corderie Vallois,2013,HAUTE-NORMANDIE,NOTRE-DAME-DE-BONDEVILLE,2321,7558,9879,
Musée des Antiquités de la Seine-Maritime,2013,HAUTE-NORMANDIE,ROUEN,1868,24511,26379,
Musée des Marais Salant,2013,PAYS DE LA LOIRE,BATZ-SUR-MER,5716,2896,8612,
Musée des Beaux-Arts,2013,PAYS DE LA LOIRE,ANGERS,18977,49644,68621,
Musée Joseph Denais,2013,PAYS DE LA LOIRE,BEAUFORT-EN-VALLEE,5500,3496,8996,
Musée Municipal,2013,PAYS DE LA LOIRE,LA ROCHE-SUR-YON,0,13924,13924,
Musée ornithologique Charles-Payraudeau,2013,PAYS DE LA LOIRE,LA-CHAIZE-LE-VICOMTE,162,516,678,
Historial de la Vendée,2013,PAYS DE LA LOIRE,LES LUCS-SUR-BOULOGNE,35596,23844,59440,
Familistère de Guise,2013,PICARDIE,GUISE,38796,14791,53587,
Musée d'Art et d'Archéologie,2013,PICARDIE,LAON,1460,4204,5664,
Musée Entomologique,2013,PICARDIE,SAINT-QUENTIN,3545,5788,9333,
Musée Municipal de Soissons,2013,PICARDIE,SOISSONS,0,25592,25592,
Musée de la Résistance et de la Déportation,2013,PICARDIE,TERGNIER,22587,0,22587,
Musée d'Art et d'Archéologie,2013,PICARDIE,SENLIS,5825,11339,17164,
Musée Archéologique de l'Oise,2013,PICARDIE,VENDEUIL-CAPLY,3134,3795,6929,
Musée Alfred Danicourt,2013,PICARDIE,PERONNE,0,2259,2259,
Musée des Arts du Cognac (Annexe musée municipal),2013,POITOU-CHARENTES,COGNAC,6430,4736,11166,
Musée des Beaux-Arts,2013,POITOU-CHARENTES,LA ROCHELLE,4075,10501,14576,
Hôtel Hèbre de Saint-Clément - Musée d'Art et d'Histoire,2013,POITOU-CHARENTES,ROCHEFORT,1935,17240,19175,
Musée de l'Echevinage,2013,POITOU-CHARENTES,SAINTES,0,6774,6774,
Musée de Bressuire,2013,POITOU-CHARENTES,BRESSUIRE,0,1233,1233,
Musée ethnographique et archéologique du Donjon,2013,POITOU-CHARENTES,NIORT,9030,8140,17170,
Musée du baptistère Saint-Jean,2013,POITOU-CHARENTES,POITIERS,11656,1054,12710,
Musée de la vallée,2013,PROVENCE-ALPES-CÔTE D'AZUR,BARCELONNETTE,8960,2424,11384,
Musée Gassendi,2013,PROVENCE-ALPES-CÔTE D'AZUR,DIGNE-LES-BAINS,2776,8189,10965,
Musée d'Art et d'Histoire de Provence,2013,PROVENCE-ALPES-CÔTE D'AZUR,GRASSE,0,20701,20701,
Musée International de la Parfumerie,2013,PROVENCE-ALPES-CÔTE D'AZUR,GRASSE,68250,23981,92231,
Musée Archéologique - Site de  Cimiez,2013,PROVENCE-ALPES-CÔTE D'AZUR,NICE,15511,30870,46381,
Musée Matisse,2013,PROVENCE-ALPES-CÔTE D'AZUR,NICE,50512,131957,182469,
Musée Archéologique - Site de Terra Amata,2013,PROVENCE-ALPES-CÔTE D'AZUR,NICE,0,23129,23129,
Musée Départemental des Merveilles,2013,PROVENCE-ALPES-CÔTE D'AZUR,TENDE,1207,34343,35550,
Musée Picasso la guerre et la paix à Vallauris,2013,PROVENCE-ALPES-CÔTE D'AZUR,VALLAURIS,16910,14098,31008,
Musées de la Citadelle,2013,PROVENCE-ALPES-CÔTE D'AZUR,VILLEFRANCHE-SUR-MER,0,95866,95866,
Musée du Parlement de Provence et du Vieil Aix,2013,PROVENCE-ALPES-CÔTE D'AZUR,AIX-EN-PROVENCE,0,33130,33130,
Musée du Pavillon de Vendôme,2013,PROVENCE-ALPES-CÔTE D'AZUR,AIX-EN-PROVENCE,5158,11392,16550,
Musée Granet,2013,PROVENCE-ALPES-CÔTE D'AZUR,AIX-EN-PROVENCE,249072,97724,346796,
Musée Réattu,2013,PROVENCE-ALPES-CÔTE D'AZUR,ARLES,25956,16045,42001,
Musée Ciotaden,2013,PROVENCE-ALPES-CÔTE D'AZUR,LA CIOTAT,2980,3106,6086,
Musée Folklorique du Vieux Lambesc,2013,PROVENCE-ALPES-CÔTE D'AZUR,LAMBESC,0,4200,4200,
Musée d'Archéologie Méditerranéenne,2013,PROVENCE-ALPES-CÔTE D'AZUR,MARSEILLE,55467,60114,115581,
Musée Borély,2013,PROVENCE-ALPES-CÔTE D'AZUR,MARSEILLE,30458,16582,47040,
Musée de l'Empéri de Salon et de la Crau,2013,PROVENCE-ALPES-CÔTE D'AZUR,SALON-DE-PROVENCE,6673,33336,40009,
Musée Départemental des Hautes-Alpes,2013,PROVENCE-ALPES-CÔTE D'AZUR,GAP,0,10939,10939,
Musée Archéologique Gallo-Romaine du Var,2013,PROVENCE-ALPES-CÔTE D'AZUR,FREJUS,2245,3138,5383,
Musée du Vêtement Provençal (Jean Aicard),2013,PROVENCE-ALPES-CÔTE D'AZUR,SOLLIES-VILLE,0,6379,6379,
Musée de l'Hôtel Dieu,2013,PROVENCE-ALPES-CÔTE D'AZUR,CAVAILLON,253,502,755,
Musée Municipal,2013,PROVENCE-ALPES-CÔTE D'AZUR,ORANGE,58941,0,58941,
Musée Archéologique Théo Desplans,2013,PROVENCE-ALPES-CÔTE D'AZUR,VAISON-LA-ROMAINE,60053,14307,74360,
Musée Chintreuil,2013,RHONE-ALPES,PONT-DE-VAUX,5076,1368,6444,
Musée et Site Archéologiques,2013,RHONE-ALPES,SOYONS,11822,1784,13606,
Château de Grignan,2013,RHONE-ALPES,GRIGNAN,101488,69373,170861,
Musée du Château des Adhémars,2013,RHONE-ALPES,MONTELIMAR,17095,0,17095,
Musée Léon Marès,2013,RHONE-ALPES,LOVAGNY,16393,0,16393,
Musée d'Huez et de l'Oisans,2013,RHONE-ALPES,ALPE D'HUEZ,407,1339,1746,
Musée de Grenoble,2013,RHONE-ALPES,GRENOBLE,94540,101467,196007,
Musée Hébert,2013,RHONE-ALPES,LA TRONCHE,0,32545,32545,
Musée de la Grande Chartreuse,2013,RHONE-ALPES,SAINT-PIERRE-DE-CHARTREUSE,40854,2803,43657,
Musée Lapidaire Saint-Pierre,2013,RHONE-ALPES,VIENNE,3766,7317,11083,
Musée des Beaux-Arts et d'Archéologie,2013,RHONE-ALPES,VIENNE,1997,2945,4942,
Musée d'Histoire du  20ème Siècle - Résistance et Déportation,2013,RHONE-ALPES,ESTIVAREILLES,3043,0,3043,
Musée des Beaux-Arts et d'Archéologie J. Dechelette,2013,RHONE-ALPES,ROANNE,2398,12220,14618,
Musée d'Art et d'Industrie,2013,RHONE-ALPES,SAINT-ETIENNE,24485,20985,45470,
Musée archéologique et minéralogique Pierre Borrione,2013,RHONE-ALPES,AIME-EN-TARENTAISE,760,481,1241,
Musée Historique,2014,ALSACE,STRASBOURG,20463,26785,47248,
Musée d'Art Moderne et Contemporain de Strasbourg,2014,ALSACE,STRASBOURG,57411,101330,158741,
Musée de l'Œuvre Notre-Dame,2014,ALSACE,STRASBOURG,10183,28091,38274,
Musée des Beaux-Arts,2014,ALSACE,STRASBOURG,27783,25053,52836,
Musée d'Histoire Naturelle et d'Ethnographie de Colmar,2014,ALSACE,COLMAR,10000,8867,18867,
Musée Historique et Militaire de Huningue,2014,ALSACE,HUNINGE,107,202,309,
Musée d'Histoire Local,2014,ALSACE,KAYSERSBERG,428,570,998,
Musée Historique,2014,ALSACE,MULHOUSE,0,43380,43380,
Musée National de l'Automobile - Collection Schlumpf,2014,ALSACE,MULHOUSE,159826,31117,190943,
Musée du Dolder,2014,ALSACE,RIQUEWIHR,1622,460,2082,
Muséum d'Histoire Naturelle de Bordeaux,2014,AQUITAINE,BORDEAUX,0,22725,22725,
Musée de la Voiture à Cheval. Au temps des calèches,2014,AQUITAINE,BOURG-SUR-GIRONDE,1999,965,2964,
Musée de Borda,2014,AQUITAINE,DAX,1989,6143,8132,
Musée Départemental d'Histoire et d'Archéologie,2014,AQUITAINE,HASTINGUES,5149,5266,10415,
Musée Despiau-Wlérick,2014,AQUITAINE,MONT-DE-MARSAN,0,10722,10722,
Musée de la Chalosse,2014,AQUITAINE,MONTFORT-EN-CHALOSSE,5623,2307,7930,
Musée Départemental de la Faïence et des Arts de la table,2014,AQUITAINE,SAMADET,2550,2502,5052,
Musée Municipal du Lac,2014,AQUITAINE,SANGUINET,1719,1349,3068,
Musée des Beaux-Arts,2014,AQUITAINE,AGEN,9358,15226,24584,
Musée du Liège et du Bouchon,2014,AQUITAINE,MEZIN,3365,1157,4522,
Musée de Paléontologie,2014,AUVERGNE,CHILHAC,2518,166,2684,
Musée d'Archéologie Bargoin,2014,AUVERGNE,CLERMONT-FERRAND,6746,23368,30114,
Muséum d'Histoire Naturelle Henri-Lecoq,2014,AUVERGNE,CLERMONT-FERRAND,2884,21238,24122,
Musée Paléontologique,2014,AUVERGNE,MENAT,311,66,377,
Musée Francisque Mandet,2014,AUVERGNE,RIOM,4482,9453,13935,
Musée du Vin de Bourgogne,2014,BOURGOGNE,BEAUNE,15776,3691,19467,
Musée des Beaux-Arts,2014,BOURGOGNE,DIJON,0,193733,193733,
Musée du Costume,2014,BOURGOGNE,CHATEAU-CHINON,3483,1359,4842,
Musée du Prieuré de Charolles,2014,BOURGOGNE,CHAROLLES,1456,1611,3067,
Musée des Ursulines,2014,BOURGOGNE,MACON,2068,20028,22096,
Musée de la Tour du Moulin,2014,BOURGOGNE,MARCIGNY,1433,520,1953,
Musée Départemental de Préhistoire de Solutré,2014,BOURGOGNE,SOLUTRE-POUILLY,12814,8059,20873,
Maison du Blé et du Pain,2014,BOURGOGNE,VERDUN-SUR-LE-DOUBS,2653,1850,4503,
Musée de l'Avallonnais Jean Després,2014,BOURGOGNE,AVALLON,978,3083,4061,
Musée des Arts Naïfs et Populaires de Noyers sur Serein,2014,BOURGOGNE,NOYERS-SUR-SEREIN,1789,648,2437,
Musée d'Art et d'Histoire du Puisaye,2014,BOURGOGNE,VILLIERS-SAINT-BENOIT,419,1657,2076,
Musée Mathurin Meheut,2014,BRETAGNE,LAMBALLE,7613,1256,8869,
Musée d'Art et d'Histoire,2014,BRETAGNE,SAINT-BRIEUC,0,27473,27473,
Musée National de la Marine,2014,BRETAGNE,BREST,28916,33485,62401,
Ecomusée des Monts d'Arrée - Moulins de Kerouat,2014,BRETAGNE,COMMANA,7486,1922,9408,
Musée de la Pêche,2014,BRETAGNE,CONCARNEAU,20256,14897,35153,
Le Port-Musée,2014,BRETAGNE,DOUARNENEZ,35477,4001,39478,
Musée Bigouden,2014,BRETAGNE,PONT-L'ABBE,9153,3892,13045,
Ecomusée Industriel des Forges,2014,BRETAGNE,INZINZAC-LOCHRIST,1520,1599,3119,
Musée du Faouët,2014,BRETAGNE,LE FAOUET,11883,4452,16335,
Musée de la Résistance Bretonne,2014,BRETAGNE,SAINT-MARCEL - MALESTROIT,14795,2155,16950,
"La Cohue, Musée des Beaux-Arts de vannes (+ espace d'exposition)",2014,BRETAGNE,VANNES,4446,139531,143977,
Musée des Meilleurs Ouvriers de France,2014,CENTRE,BOURGES,0,17224,17224,
Musée du Château Charles VII,2014,CENTRE,MEHUN-SUR-YEVRE,8030,0,8030,
Musée Saint-Vic,2014,CENTRE,SAINT-AMAND-MONTROND,0,4367,4367,
Musée d'Art et d'Histoire de Dreux,2014,CENTRE,DREUX,1657,5961,7618,
Château Musée,2014,CENTRE,AZAY-LE-FERRON,13546,4860,18406,
"""Maison Musée"" René Descartes",2014,CENTRE,DESCARTES,1458,805,2263,
Musée de Préhistoire du Grand Pressigny,2014,CENTRE,LE GRAND PRESSIGNY,9742,6561,16303,
Muséum d'Histoire Naturelle,2014,CENTRE,TOURS,10476,21449,31925,
Musée des Beaux-Arts,2014,CENTRE,TOURS,21575,40742,62317,
Musée de Vendôme,2014,CENTRE,VENDOME,0,15357,15357,
Musée Historique et Archéologique,2014,CENTRE,ORLEANS,1083,10388,11471,
Musée des Sciences Naturelles,2014,CENTRE,ORLEANS,9170,49317,58487,
Musée des Beaux-Arts,2014,CENTRE,ORLEANS,7483,44056,51539,
Musée de l'Ardenne,2014,CHAMPAGNE-ARDENNES,CHARLEVILLE-MEZIERES,4480,45541,50021,
Musée de la Bonneterie,2014,CHAMPAGNE-ARDENNES,TROYES,2113,4590,6703,
Musée Municipal,2014,CHAMPAGNE-ARDENNES,BOURBONNE-LES-BAINS,0,2242,2242,
Musée d'Art et d'Histoire,2014,CHAMPAGNE-ARDENNES,LANGRES,2775,4210,6985,
Musée Hôtel le Vergeur,2014,CHAMPAGNE-ARDENNES,REIMS,5536,1687,7223,
Musée de l'Ancien Collège des Jésuites/Planétarium,2014,CHAMPAGNE-ARDENNES,REIMS,24024,22838,46862,
Musée d'Histoire de Bastia,2014,CORSE,BASTIA,12150,7138,19288,
Musée de la Corse,2014,CORSE,CORTE,61761,10950,72711,
Musée Départemental Pascal Paoli,2014,CORSE,MOROSAGLIA,7304,2503,9807,
Musée des Beaux-Arts et d'Archéologie,2014,FRANCHE-COMTE,BESANCON,1,16478,16479,
Musée de Plein Air des Maisons Comtoises,2014,FRANCHE-COMTE,NANCRAY,32691,14117,46808,
Musée de Pontarlier,2014,FRANCHE-COMTE,PONTARLIER,659,6340,6999,
Musée Départemental de la Montagne Albert Demard,2014,FRANCHE-COMTE,LE HAUT-DU-THEM,3487,3178,6665,
Musée de la Vigne et du Vin,2014,FRANCHE-COMTE,ARBOIS,3374,2033,5407,
Musée des Beaux-Arts,2014,FRANCHE-COMTE,DOLE,0,24952,24952,
Musée de l'Abbaye/Donations Guy Bardone - René Genis,2014,FRANCHE-COMTE,SAINT-CLAUDE,4101,5846,9947,
Musée Frédéric Japy,2014,FRANCHE-COMTE,BEAUCOURT,612,1317,1929,
Musée Municipal Robert Dubois-Corneau,2014,ILE-DE-FRANCE,BRUNOY,67,3237,3304,
Musée Intercommunal d'Etampes,2014,ILE-DE-FRANCE,ETAMPES,667,5827,6494,
"Albert-Kahn, Musée et Jardin Départementaux",2014,ILE-DE-FRANCE,BOULOGNE-BILLANCOURT,78395,44738,123133,
Musée d'Histoire Locale - Mémoire de la Ville,2014,ILE-DE-FRANCE,RUEIL-MALMAISON,0,8745,8745,
Musée des Avelines - Musée d'Art et d'Histoire,2014,ILE-DE-FRANCE,SAINT-CLOUD,509,17755,18264,
Cité de la céramique - Sèvres & Limoges,2014,ILE-DE-FRANCE,SEVRES,57047,31727,88774,
Galerie de Minéralogie et de Géologie (Muséum d'Histoire Naturelle),2014,ILE-DE-FRANCE,PARIS,6048,1345,7393,
Maison de Victor Hugo,2014,ILE-DE-FRANCE,PARIS,27591,149355,176946,
Crypte Archéologique du Parvis Notre-Dame,2014,ILE-DE-FRANCE,PARIS,53211,144829,198040,
Musée National Gustave Moreau,2014,ILE-DE-FRANCE,PARIS,20374,20977,41351,
Musée du Moyen Age-Thermes et Hôtel de Cluny,2014,ILE-DE-FRANCE,PARIS,151987,165370,317357,
Etablissement public du musée d'Orsay et de l'Orangerie - Musée d'Orsay,2014,ILE-DE-FRANCE,PARIS,1919782,1560827,3480609,
"Petit Palais, Musée des Beaux-Arts de la ville de Paris",2014,ILE-DE-FRANCE,PARIS,341791,660926,1002717,
Musée de Montmartre,2014,ILE-DE-FRANCE,PARIS,75407,0,75407,
Musée d'Ennery,2014,ILE-DE-FRANCE,PARIS,0,1077,1077,
Mémorial du Maréchal Leclerc de Hauteclocque et de la Libération de Paris-musée Jean Moulin,2014,ILE-DE-FRANCE,PARIS,1879,74581,76460,
Musée National Auguste Rodin,2014,ILE-DE-FRANCE,PARIS,484125,203132,687257,
Musée d'Art Moderne de la ville de Paris,2014,ILE-DE-FRANCE,PARIS,266000,327300,593300,
Musée du Louvre,2014,ILE-DE-FRANCE,PARIS,5646956,3454918,9101874,
"Musée Cernuschi, Musée des Arts de l'Asie de la ville de Paris",2014,ILE-DE-FRANCE,PARIS,33173,44110,77283,
Institut du Monde Arabe,2014,ILE-DE-FRANCE,PARIS,397611,153837,551448,
L'Adresse Musée de la Poste,2014,ILE-DE-FRANCE,PARIS,0,20530,20530,
Maison Natale de Louis Braille,2014,ILE-DE-FRANCE,COUPVRAY,4698,0,4698,
Musée Départemental de Préhistoire d'Île de France,2014,ILE-DE-FRANCE,NEMOURS,4144,24154,28298,
Musée de Provins et du Provinois,2014,ILE-DE-FRANCE,PROVINS,15709,5206,20915,
Musée départemental Stéphane Mallarmé,2014,ILE-DE-FRANCE,VULAINES-SUR-SEINE,1655,2688,4343,
Musée de l'Air et de l'Espace,2014,ILE-DE-FRANCE,LE BOURGET,171725,96334,268059,
Musée de l'Histoire Vivante,2014,ILE-DE-FRANCE,MONTREUIL-SOUS-BOIS,535,4109,4644,
Musée de Saint-Maur - Villa Médicis,2014,ILE-DE-FRANCE,LA VARENNE-SAINT-HILAIRE,153,9021,9174,
Musée jean-Jacques Rousseau,2014,ILE-DE-FRANCE,MONTMORENCY,1296,1801,3097,
Musée-Maison Maurice Ravel,2014,ILE-DE-FRANCE,MONTFORT-L'AMAURY,1435,178,1613,
Etablissement Public du Musée et du Domaine National de Versailles,2014,ILE-DE-FRANCE,VERSAILLES,5712312,1989823,7702135,
Musée Départemental de la Réunion - Musée Léon Dierx,2014,LA REUNION,SAINT-DENIS,3516,18019,21535,
Muséum d'Histoire Naturelle,2014,LA REUNION,SAINT-DENIS,5396,27641,33037,
Musée Historique de Villèle,2014,LA REUNION,SAINT-GILLES-LES-HAUTS,16576,23807,40383,
Musée Archéologique du Lauragais,2014,LANGUEDOC-ROUSSILLON,CASTELNAUDARY,386,673,1059,
Musée d'Art et d'Histoire - Ensemble monumental de Narbonne,2014,LANGUEDOC-ROUSSILLON,NARBONNE,68289,580000,648289,
Musée des Corbières,2014,LANGUEDOC-ROUSSILLON,SIGEAN,244,670,914,
Musée Albert André,2014,LANGUEDOC-ROUSSILLON,BAGNOLS-SUR-CEZE,23,3992,4015,
Musée Léon Alègre,2014,LANGUEDOC-ROUSSILLON,BAGNOLS-SUR-CEZE,0,1306,1306,
Musée Municipal de la Vignasse,2014,LANGUEDOC-ROUSSILLON,BEAUCAIRE,1692,3240,4932,
Musée Archéologique,2014,LANGUEDOC-ROUSSILLON,NIMES,486,47713,48199,
Musée Pierre de Luxembourg,2014,LANGUEDOC-ROUSSILLON,VILLENEUVE-LES-AVIGNON,3011,3120,6131,
Musée de l'Etang de Thau,2014,LANGUEDOC-ROUSSILLON,BOUZIGUES,12992,1756,14748,
Musée Fabre,2014,LANGUEDOC-ROUSSILLON,MONTPELLIER,124382,92437,216819,
Musée de Cerdagne,2014,LANGUEDOC-ROUSSILLON,SAINTE-LEOCADIE,2636,1327,3963,
Musée Municipal des Beaux-Arts de Limoges - Palais de l'Evêché,2014,LIMOUSIN,LIMOGES,2654,38347,41001,
Musée de la Bière et du Pays de Stenay,2014,LORRAINE,STENAY,7556,12332,19888,
Musée Départemental du Sel,2014,LORRAINE,MARSAL,3996,6099,10095,
Centre Pompidou de Metz (collections nationales decentralisées),2014,LORRAINE,METZ,210000,140000,350000,
La Tour aux Puces - Musée du Pays Thionvillois,2014,LORRAINE,THIONVILLE,859,9220,10079,
Musée de l'Image,2014,LORRAINE,EPINAL,22282,4389,26671,
Musée Départemental d'Art Ancien et Contemporain,2014,LORRAINE,EPINAL,2909,11017,13926,
Musée de la Forge,2014,MIDI-PYRENEES,MONTGAILHARD,30659,0,30659,
"Musée des Mœurs et Coutumes, Musée du Rouergue",2014,MIDI-PYRENEES,ESPALION,1877,503,2380,
Musée Municipal Urbain Cabrol,2014,MIDI-PYRENEES,VILLEFRANCHE-DE-ROUERGUE,0,4937,4937,
Musée de l'Armagnac,2014,MIDI-PYRENEES,CONDOM,2545,423,2968,
Musée d'Archéologie,2014,MIDI-PYRENEES,LECTOURE,1436,1263,2699,
Musée du Pays de Luchon,2014,MIDI-PYRENEES,BAGNERES-DE-LUCHON,1507,733,2240,
Muséum d'Histoire Naturelle,2014,MIDI-PYRENEES,TOULOUSE,144037,150530,294567,
Musée Paul Dupuy,2014,MIDI-PYRENEES,TOULOUSE,5031,8326,13357,
Musée des Augustins,2014,MIDI-PYRENEES,TOULOUSE,76180,68574,144754,
Musée Pyrénéen,2014,MIDI-PYRENEES,LOURDES,66101,7708,73809,
Musée de l'Automate,2014,MIDI-PYRENEES,SOUILLAC,16729,3168,19897,
Musée Goya,2014,MIDI-PYRENEES,CASTRES,21489,20473,41962,
Musée des Beaux-Arts,2014,MIDI-PYRENEES,GAILLAC,1235,2325,3560,
Muséum d'histoire naturelle Philadelphe Thomas,2014,MIDI-PYRENEES,GAILLAC,1076,3816,4892,
Musée du Pays Vaurais,2014,MIDI-PYRENEES,LAVAUR,1045,3173,4218,
Musée de la Chartreuse,2014,NORD-PAS-DE-CALAIS,DOUAI,7169,33903,41072,
Musée Municipal,2014,NORD-PAS-DE-CALAIS,SAINT-AMAND-LES-EAUX,0,13063,13063,
"LAM - Lille Métropole Musée d'Art Moderne, d'Art Contemporain et d'Art Brut",2014,NORD-PAS-DE-CALAIS,VILLENEUVE-D'ASCQ,92864,48151,141015,
Musée des Beaux-Arts,2014,NORD-PAS-DE-CALAIS,ARRAS,23687,30725,54412,
Musée de la Céramique,2014,NORD-PAS-DE-CALAIS,DESVRES,7188,1356,8544,
Musée d'Histoire et d'Archéologie,2014,NORD-PAS-DE-CALAIS,HARNES,0,2128,2128,
Mémorial de Caen,2014,BASSE-NORMANDIE,CAEN,438998,0,438998,
Musée Eugène Boudin,2014,BASSE-NORMANDIE,HONFLEUR,34354,2244,36598,
Musée de la Meunerie - Moulin de Marcy,2014,BASSE-NORMANDIE,LE MOLAY-LITTRY,3292,3658,6950,
Musée Municipal,2014,BASSE-NORMANDIE,VIRE NORMANDIE,2761,6074,8835,
Musée Municipal d'Avranches,2014,BASSE-NORMANDIE,AVRANCHES,0,10202,10202,
Musée de la Pomme et de la Poire,2014,BASSE-NORMANDIE,BARENTON,847,3303,4150,
Musée d'Art et d'Histoire de Granville,2014,BASSE-NORMANDIE,GRANVILLE,5743,6634,12377,
Musée Municipal,2014,HAUTE-NORMANDIE,BERNAY,1227,9288,10515,
Musée du Verre et de la Pierre,2014,HAUTE-NORMANDIE,CONCHES-EN-OUCHE,2367,2640,5007,
Musée Artisanal et Industriel d'Instruments à Vent,2014,HAUTE-NORMANDIE,LA COUTURE-BOUSSEY,2500,902,3402,
Musée Alphonse-Georges Poulain,2014,HAUTE-NORMANDIE,VERNON,3229,7994,11223,
Musée Louis-Philippe du Château d'Eu,2014,HAUTE-NORMANDIE,EU,14542,4309,18851,
Musée de l'Hôtel Dubocage de Bléville,2014,HAUTE-NORMANDIE,LE HAVRE,0,8599,8599,
Musée-Maison Natale Pierre Corneille,2014,HAUTE-NORMANDIE,ROUEN,0,3911,3911,
Musée de la Céramique,2014,HAUTE-NORMANDIE,ROUEN,2769,3370,6139,
Musée des Beaux-Arts,2014,PAYS DE LA LOIRE,ANGERS,20525,60396,80921,
Musée de Tessé,2014,PAYS DE LA LOIRE,LE MANS,13206,12492,25698,
Musée de Fontenay-le-Comte,2014,PAYS DE LA LOIRE,FONTENAY-LE-COMTE,2124,3383,5507,
Ecomusée du Marais Breton Vendéen,2014,PAYS DE LA LOIRE,LA BARRE-DE-MONTS,15290,4095,19385,
Musée La Bourrine du Bois-Juquaud,2014,PAYS DE LA LOIRE,SAINT-HILAIRE-DE-RIEZ,11924,8091,20015,
Musée d'Art et d'Archéologie,2014,PICARDIE,LAON,1187,4311,5498,
Musée Entomologique,2014,PICARDIE,SAINT-QUENTIN,3741,4609,8350,
Musée des Beaux-Arts Antoine Lecuyer,2014,PICARDIE,SAINT-QUENTIN,6797,4749,11546,
Musée Pillon,2014,PICARDIE,CHAUMONT-EN-VEXIN,0,554,554,
Musée du Noyonnais,2014,PICARDIE,NOYON,1402,1921,3323,
Musée d'Art et d'Archéologie,2014,PICARDIE,SENLIS,6694,11462,18156,
Musée Municipal de Cognac,2014,POITOU-CHARENTES,COGNAC,1661,4371,6032,
Musée du Nouveau Monde,2014,POITOU-CHARENTES,LA ROCHELLE,4950,12728,17678,
Musée Cappon,2014,POITOU-CHARENTES,MARANS,20,0,20,
Musée Archéologique,2014,POITOU-CHARENTES,SAINTES,0,31949,31949,
Collection d'Histoire Naturelle,2014,POITOU-CHARENTES,POITIERS,44000,0,44000,
Musée de la Faïence,2014,PROVENCE-ALPES-CÔTE D'AZUR,MOUSTIERS-SAINTE-MARIE,5168,2461,7629,
Musée d'Histoire et d'Archéologie,2014,PROVENCE-ALPES-CÔTE D'AZUR,ANTIBES,5068,4261,9329,
Musée d'Histoire Locale,2014,PROVENCE-ALPES-CÔTE D'AZUR,BIOT,3392,0,3392,
Villa-Musée Jean-Honoré Fragonard,2014,PROVENCE-ALPES-CÔTE D'AZUR,GRASSE,0,144,144,
Musée d'Art Naïf Anatole Jakovsky,2014,PROVENCE-ALPES-CÔTE D'AZUR,NICE,0,17548,17548,
Musée Départemental des Merveilles,2014,PROVENCE-ALPES-CÔTE D'AZUR,TENDE,6438,20281,26719,
Musée du Pavillon de Vendôme,2014,PROVENCE-ALPES-CÔTE D'AZUR,AIX-EN-PROVENCE,4850,10312,15162,
Musée des Tapisseries,2014,PROVENCE-ALPES-CÔTE D'AZUR,AIX-EN-PROVENCE,4638,14688,19326,
Musée Granet,2014,PROVENCE-ALPES-CÔTE D'AZUR,AIX-EN-PROVENCE,135560,63793,199353,
Musée d'Histoire de Marseille,2014,PROVENCE-ALPES-CÔTE D'AZUR,MARSEILLE,21924,69905,91829,
Musée d'Art Contemporain - Galeries Contemporaines,2014,PROVENCE-ALPES-CÔTE D'AZUR,MARSEILLE,8926,18945,27871,
Muséum d'Histoire Naturelle,2014,PROVENCE-ALPES-CÔTE D'AZUR,MARSEILLE,21177,82366,103543,
Musée Borely,2014,PROVENCE-ALPES-CÔTE D'AZUR,MARSEILLE,19652,21745,41397,
Musée Estrine - Présence Van Gogh,2014,PROVENCE-ALPES-CÔTE D'AZUR,SAINT-REMY-DE-PROVENCE,6519,3982,10501,
Musée du Pays Brignolais,2014,PROVENCE-ALPES-CÔTE D'AZUR,BRIGNOLES,2081,0,2081,
Musée Municipal,2014,PROVENCE-ALPES-CÔTE D'AZUR,DRAGUIGNAN,0,6013,6013,
Musée Marc Deydier,2014,PROVENCE-ALPES-CÔTE D'AZUR,CUCURON,0,1348,1348,
Musée Jean Garcin 39-45 : L'appel de la Liberté,2014,PROVENCE-ALPES-CÔTE D'AZUR,FONTAINE-DE-VAUCLUSE,4111,6493,10604,
Musée Municipal Camille Pautet,2014,PROVENCE-ALPES-CÔTE D'AZUR,MAZAN,0,1632,1632,
Musée Municipal,2014,PROVENCE-ALPES-CÔTE D'AZUR,ORANGE,57305,0,57305,
Musée Municipal,2014,PROVENCE-ALPES-CÔTE D'AZUR,SAULT,0,1345,1345,
Musée Départemental du Cartonnage et de l'Imprimerie,2014,PROVENCE-ALPES-CÔTE D'AZUR,VALREAS,2604,1696,4300,
Musée de la Bresse - Domaine des Planons,2014,RHONE-ALPES,SAINT-CYR-SUR-MENTHON,12866,9377,22243,
MuséAL - Musée Archéologique d'Alba,2014,RHONE-ALPES,ALBA-LA-ROMAINE,53604,0,53604,
Musée Géo-Charles,2014,RHONE-ALPES,ECHIROLLES,0,7148,7148,
Musée Stendhal,2014,RHONE-ALPES,GRENOBLE,2480,1489,3969,
Musée de Grenoble,2014,RHONE-ALPES,GRENOBLE,36266,94149,130415,
Muséum d'Histoire Naturelle de Grenoble,2014,RHONE-ALPES,GRENOBLE,35942,66125,102067,
Musée Matheysin,2014,RHONE-ALPES,LA MURE,505,1166,1671,
Musée Hospitalier,2014,RHONE-ALPES,CHARLIEU,3114,1562,4676,
Atelier - Musée du Chapeau,2014,RHONE-ALPES,CHAZELLES-SUR-LYON,18860,6996,25856,
Musée des Civilisations : Daniel Pouget,2014,RHONE-ALPES,SAINT-JUST-SAINT-RAMBERT,3699,3605,7304,
Musée Barthélemy-Thimonnier,2014,RHONE-ALPES,AMPLEPUIS,1535,3116,4651,
Lugdunum - Musée et Théâtres Romains,2014,RHONE-ALPES,LYON,22351,58411,80762,
Musée des Beaux-Arts,2014,RHONE-ALPES,LYON,104904,246457,351361,
Musée Henri Malartre,2014,RHONE-ALPES,ROCHETAILLEE-SUR-SAONE,14718,18083,32801,
Musée Archéologique,2014,RHONE-ALPES,SAINT-ROMAIN-EN-GAL,22595,57839,80434,
Ecomusée du Haut Beaujolais,2014,RHONE-ALPES,THIZY-LES-BOURGS,0,779,779,
Musée Municipal d'Albertville-Conflans,2014,RHONE-ALPES,ALBERTVILLE,3053,3370,6423,
Musée de l'Académie de La Val d'Isère,2014,RHONE-ALPES,MOÛTIERS,197,236,433,
Musée de la Folie Marco,2015,ALSACE,BARR,1874,1934,3808,
Musée Zoologique de Strasbourg,2015,ALSACE,STRASBOURG,7345,28262,35607,
Musée de l'Œuvre Notre-Dame,2015,ALSACE,STRASBOURG,17310,21318,38628,
Musée J.F. Oberlin,2015,ALSACE,WALDERSBACH,22529,7811,30340,
Musée Lalique,2015,ALSACE,WINGEN-SUR-MODER,37986,11324,49310,
Musée d'Histoire Naturelle et d'Ethnographie de Colmar,2015,ALSACE,COLMAR,7918,6367,14285,
Musée d'Histoire Local,2015,ALSACE,KAYSERSBERG,598,147,745,
Musée des Beaux-Arts,2015,ALSACE,MULHOUSE,0,18527,18527,
Musée Gallo-Romain de Vesunna,2015,AQUITAINE,PERIGUEUX,20967,15964,36931,
Musée Historique de l'Hydravion,2015,AQUITAINE,BISCARROSSE,17081,1943,19024,
Musée de Borda,2015,AQUITAINE,DAX,2811,7886,10697,
Musée du Liège et du Bouchon,2015,AQUITAINE,MEZIN,3317,978,4295,
Musée François Rude,2015,BOURGOGNE,DIJON,0,64708,64708,
Musée Nicéphore Niepce,2015,BOURGOGNE,CHALON-SUR-SAONE,0,25385,25385,
Musée du Prieuré de Charolles,2015,BOURGOGNE,CHAROLLES,1265,1602,2867,
Musée d'Art et d'Archéologie,2015,BOURGOGNE,CLUNY,32960,2847,35807,
Maison du Blé et du Pain,2015,BOURGOGNE,VERDUN-SUR-LE-DOUBS,2069,1334,3403,
Musée de l'Avallonnais Jean Després,2015,BOURGOGNE,AVALLON,730,2864,3594,
Musée Muncipal,2015,BOURGOGNE,SENS,6427,14297,20724,
Musée National de la Marine,2015,BRETAGNE,BREST,33172,37927,71099,
Ecomusée des Monts d'Arrée - Maison Cornec,2015,BRETAGNE,RIVOAL,2230,4142,6372,
Musée des Beaux-Arts,2015,BRETAGNE,RENNES,17360,56053,73413,
Musée d'Histoire de la Ville de Saint-Malo,2015,BRETAGNE,SAINT-MALO,18694,11959,30653,
Musée de Préhistoire J. Miln- Z. Le-Rouzic,2015,BRETAGNE,CARNAC,29576,10007,39583,
Ecomusée de l'Île de Groix,2015,BRETAGNE,ILE DE GROIX,5730,1540,7270,
Musée Estève,2015,CENTRE,BOURGES,0,15257,15257,
Musée du Berry,2015,CENTRE,BOURGES,0,15106,15106,
Musée des Beaux-Arts,2015,CENTRE,CHARTRES,3253,6548,9801,
Musée des Beaux-Arts,2015,CENTRE,TOURS,21802,42102,63904,
Musée de Minerve,2015,CENTRE,YZEURES-SUR-CREUSE,0,175,175,
Maison de la Magie,2015,CENTRE,BLOIS,72621,24621,97242,
Musée Archéologique,2015,CENTRE,THESEE,877,95,972,
Musée d'Art et d'Archéologie,2015,CENTRE,CHATILLON-COLIGNY,0,400,400,
Château-Musée de Gien,2015,CENTRE,GIEN,0,430,430,
Musée de l'Ardenne,2015,CHAMPAGNE-ARDENNES,CHARLEVILLE-MEZIERES,4222,44511,48733,
Musée Napoléon Ier,2015,CHAMPAGNE-ARDENNES,BRIENNE-LE-CHATEAU,3276,1490,4766,
Musée du Breuil de Saint-Germain,2015,CHAMPAGNE-ARDENNES,LANGRES,4857,4792,9649,
Musée Garinet,2015,CHAMPAGNE-ARDENNES,CHALONS-EN-CHAMPAGNE,142,574,716,
Musée Hôtel le Vergeur,2015,CHAMPAGNE-ARDENNES,REIMS,6108,951,7059,
Musée de la Corse,2015,CORSE,CORTE,58601,9958,68559,
Musée Comtois,2015,FRANCHE-COMTE,BESANCON,50272,0,50272,
Musée de Plein Air des Maisons Comtoises,2015,FRANCHE-COMTE,NANCRAY,28020,15144,43164,
Musée Départemental de la Montagne Albert Demard,2015,FRANCHE-COMTE,LE HAUT-DU-THEM,3533,2892,6425,
Musée Georges Garret,2015,FRANCHE-COMTE,VESOUL,0,2970,2970,
Musée des Beaux-Arts,2015,FRANCHE-COMTE,LONS-LE-SAUNIER,1064,4150,5214,
Musée d'Art et d'Histoire,2015,FRANCHE-COMTE,BELFORT,18182,0,18182,
Forge-Musée,2015,FRANCHE-COMTE,ETUEFFONT,633,366,999,
Musée des Cultures Guyanaises,2015,GUYANE,CAYENNE,1109,8129,9238,
Ecomusée Municipal d'Approuague-Kaw,2015,GUYANE,REGINA,4190,1139,5329,
Musée Français de la Photographie,2015,ILE-DE-FRANCE,BIEVRES,1644,6970,8614,
Musée Municipal Robert Dubois-Corneau,2015,ILE-DE-FRANCE,BRUNOY,67,2804,2871,
"Albert-Kahn, Musée et Jardin Départementaux",2015,ILE-DE-FRANCE,BOULOGNE-BILLANCOURT,61148,36514,97662,
Fondation Arp,2015,ILE-DE-FRANCE,CLAMART,927,1522,2449,
Musée d'Art et d'Histoire,2015,ILE-DE-FRANCE,MEUDON,9457,0,9457,
Musée du Louvre,2015,ILE-DE-FRANCE,PARIS,5435535,2933898,8369433,
Musée National Eugène Delacroix,2015,ILE-DE-FRANCE,PARIS,28602,22694,51296,
Musée du Moyen Age-Thermes et Hôtel de Cluny,2015,ILE-DE-FRANCE,PARIS,136988,139939,276927,
Etablissement public du musée d'Orsay et de l'Orangerie - Musée de l'Orangerie,2015,ILE-DE-FRANCE,PARIS,531570,236463,768033,
Musée National de la Marine,2015,ILE-DE-FRANCE,PARIS,56927,41223,98150,
Musée Carnavalet-Histoire de Paris,2015,ILE-DE-FRANCE,PARIS,83205,236460,319665,
Les Catacombes,2015,ILE-DE-FRANCE,PARIS,411758,93327,505085,
"Petit Palais, Musée des Beaux-Arts de la ville de Paris",2015,ILE-DE-FRANCE,PARIS,193143,615181,808324,
Musée de la Franc-Maçonnerie,2015,ILE-DE-FRANCE,PARIS,10350,1610,11960,
Musée des Monuments Français,2015,ILE-DE-FRANCE,PARIS,150417,130446,280863,
Musée du Château de Fontainebleau,2015,ILE-DE-FRANCE,FONTAINEBLEAU,237927,222643,460570,
Château-musée de Nemours,2015,ILE-DE-FRANCE,NEMOURS,4280,5746,10026,
Musée de Saint-Maur - Villa Médicis,2015,ILE-DE-FRANCE,LA VARENNE-SAINT-HILAIRE,55,8739,8794,
Musée de Nogent-Sur-Marne,2015,ILE-DE-FRANCE,NOGENT-SUR-MARNE,0,4902,4902,
Musée de la Renaissance - Château d'Ecouen,2015,ILE-DE-FRANCE,ECOUEN,16438,40158,56596,
ARCHEA - Archéologie en Pays de France,2015,ILE-DE-FRANCE,LOUVRES,7384,3894,11278,
Musée jean-Jacques Rousseau,2015,ILE-DE-FRANCE,MONTMORENCY,1096,1623,2719,
Musée Promenade Marly/Louveciennes,2015,ILE-DE-FRANCE,LOUVECIENNES,6769,3389,10158,
Musée National de Port Royal des Champs,2015,ILE-DE-FRANCE,MAGNY-LES-HAMEAUX,4983,19161,24144,
Musée de la Ville,2015,ILE-DE-FRANCE,MONTIGNY LE BRETONNEUX,1680,2415,4095,
Collections de la Fondation de Coubertin,2015,ILE-DE-FRANCE,SAINT-REMY-LES-CHEVREUSE,1160,572,1732,
Musée Départemental de la Réunion - Musée Léon Dierx,2015,LA REUNION,SAINT-DENIS,3404,15881,19285,
Muséum d'Histoire Naturelle,2015,LA REUNION,SAINT-DENIS,8325,27637,35962,
Musée Historique de Villèle,2015,LA REUNION,SAINT-GILLES-LES-HAUTS,17999,18245,36244,
Musée Archéologique du Lauragais,2015,LANGUEDOC-ROUSSILLON,CASTELNAUDARY,754,709,1463,
Musée Archéologique,2015,LANGUEDOC-ROUSSILLON,SALLELES D'AUDE,6004,4763,10767,
Musée du Colombier,2015,LANGUEDOC-ROUSSILLON,ALES,0,11885,11885,
Musée des Cultures Taurines (Annexe du Vieux Nîmes),2015,LANGUEDOC-ROUSSILLON,NIMES,0,16249,16249,
Musée d'Histoire Naturelle et de Préhistoire,2015,LANGUEDOC-ROUSSILLON,NIMES,0,35716,35716,
Musée de la Maison Romane,2015,LANGUEDOC-ROUSSILLON,SAINT-GILLES-DU-GARD,700,1980,2680,
Site Archéologique Lattara - Musée Henri Prades de Montpellier Agglomération,2015,LANGUEDOC-ROUSSILLON,LATTES,12804,14373,27177,
Musée de Cerdagne,2015,LANGUEDOC-ROUSSILLON,SAINTE-LEOCADIE,3741,1012,4753,
Musée d'Art et d'Archéologie,2015,LIMOUSIN,GUERET,3703,4779,8482,
Musée Départemental Raymond Poincaré,2015,LORRAINE,SAMPIGNY,0,4636,4636,
Musée Départemental du Sel,2015,LORRAINE,MARSAL,4789,3977,8766,
Musées de la Cour d'Or,2015,LORRAINE,METZ,18999,22686,41685,
Musée du Pays de Sarrebourg,2015,LORRAINE,SARREBOURG,9163,7448,16611,
Musée Charles Friry,2015,LORRAINE,REMIREMONT,489,1983,2472,
Musée de La Canne,2015,MARTINIQUE,LES TROIS ILETS,10040,2414,12454,
Musée Départemental de l'Ariège,2015,MIDI-PYRENEES,FOIX,76476,7295,83771,
Musée Régional de Géologie Pierre Vetter,2015,MIDI-PYRENEES,DECAZEVILLE,2564,3304,5868,
"Musée des Mœurs et Coutumes, Musée du Rouergue",2015,MIDI-PYRENEES,ESPALION,142,1972,2114,
Musée des Beaux-Arts Denys Puech,2015,MIDI-PYRENEES,RODEZ,0,12331,12331,
Musée des Jacobins,2015,MIDI-PYRENEES,AUCH,5466,12777,18243,
Musée Georges Labit,2015,MIDI-PYRENEES,TOULOUSE,6090,15346,21436,
Musée Pyrénéen,2015,MIDI-PYRENEES,LOURDES,63516,8605,72121,
Musée-château Gaston Phébus,2015,MIDI-PYRENEES,MAUVEZIN,27385,0,27385,
Musée des Marais Salant,2015,MIDI-PYRENEES,BATZ-SUR-MER,14794,6611,21405,
"Musée de la Fève, Crèches et Traditions Populaires",2015,MIDI-PYRENEES,BLAIN,1025,420,1445,
Musée Henri Martin,2015,MIDI-PYRENEES,CAHORS,2481,4205,6686,
Musée Champollion - Les Ecriture du Monde,2015,MIDI-PYRENEES,FIGEAC,37887,11558,49445,
Musée de l'Automate,2015,MIDI-PYRENEES,SOUILLAC,15363,3143,18506,
Musée Départemental du Textile,2015,MIDI-PYRENEES,LA-BASTIDE-ROUAIROUX,2134,4196,6330,
Musée du Pays Vaurais,2015,MIDI-PYRENEES,LAVAUR,1654,4391,6045,
Musée du Pays Rabastinois,2015,MIDI-PYRENEES,RABASTENS,900,3515,4415,
Musée d'Histoire Naturelle Victor Brun,2015,MIDI-PYRENEES,MONTAUBAN,1371,5518,6889,
Musée Ingres,2015,MIDI-PYRENEES,MONTAUBAN,15450,21174,36624,
Musée Benoît de Puydt,2015,NORD-PAS-DE-CALAIS,BAILLEUL,2184,2646,4830,
Musée du Mont-de-Piété,2015,NORD-PAS-DE-CALAIS,BERGUES,2160,0,2160,
Musée Départemental de Flandre,2015,NORD-PAS-DE-CALAIS,CASSEL,39275,14076,53351,
Ecomusée de la Région,2015,NORD-PAS-DE-CALAIS,FOURMIES,19089,12351,31440,
Musée Départemental Matisse,2015,NORD-PAS-DE-CALAIS,LE CATEAU-CAMBRESIS,15649,38016,53665,
Musée de l'Hospice Comtesse,2015,NORD-PAS-DE-CALAIS,LILLE,55390,0,55390,
Musée d'Histoire Naturelle et de Géologie,2015,NORD-PAS-DE-CALAIS,LILLE,109378,0,109378,
Musée Municipal,2015,NORD-PAS-DE-CALAIS,SAINT-AMAND-LES-EAUX,0,13308,13308,
Musée Municipal,2015,NORD-PAS-DE-CALAIS,LE TOUQUET-PARIS-PLAGE,11588,7083,18671,
Louvre-Lens (collections nationales decentralisées),2015,NORD-PAS-DE-CALAIS,LENS,141504,212257,353761,
Musée de Normandie,2015,BASSE-NORMANDIE,CAEN,27360,40123,67483,
Mémorial de Caen,2015,BASSE-NORMANDIE,CAEN,328654,55304,383958,
Musée de la Meunerie - Moulin de Marcy,2015,BASSE-NORMANDIE,LE MOLAY-LITTRY,2281,2281,4562,
Musée Municipal,2015,BASSE-NORMANDIE,VIRE NORMANDIE,1348,6173,7521,
Musée de l'Abbaye,2015,BASSE-NORMANDIE,CERISY-LA-FORET,5205,1112,6317,
Musée Maritime de l'Ile de Tatihou,2015,BASSE-NORMANDIE,SAINT-VAAST-LA-HOUGUE,58035,4410,62445,
Musée Régional du Cidre et du Calvados,2015,BASSE-NORMANDIE,VALOGNES,3572,1754,5326,
Musée de la Poeslerie,2015,BASSE-NORMANDIE,VILLEDIEU-LES-POELES-ROUFFIGNY,5536,1132,6668,
Musée du Château de Flers,2015,BASSE-NORMANDIE,FLERS,0,3262,3262,
Musée de l'Ancien Evêché,2015,HAUTE-NORMANDIE,EVREUX,0,23659,23659,
Musée Alfred Canel,2015,HAUTE-NORMANDIE,PONT-AUDEMER,571,5049,5620,
Musée Alphonse-Georges Poulain,2015,HAUTE-NORMANDIE,VERNON,3527,10677,14204,
Pavillon Flaubert,2015,HAUTE-NORMANDIE,CANTELEU,0,1122,1122,
Musée de l'Hôtel Dubocage de Bléville,2015,HAUTE-NORMANDIE,LE HAVRE,0,11779,11779,
La Maison de l'Armateur,2015,HAUTE-NORMANDIE,LE HAVRE,6299,9908,16207,
Muséum d'Histoire Naturelle de Nantes,2015,PAYS DE LA LOIRE,NANTES,36300,72200,108500,
Musée Jules-Desbois,2015,PAYS DE LA LOIRE,PARCAY-LES-PINS,2246,2035,4281,
Musée des Tisserands Mayennais,2015,PAYS DE LA LOIRE,AMBRIERES-LES-VALLEES,211,14,225,
Musée Archéologique Départemental de Jublains,2015,PAYS DE LA LOIRE,JUBLAINS,14966,12241,27207,
Musée du Château de Mayenne,2015,PAYS DE LA LOIRE,MAYENNE,10283,9834,20117,
Musée Municipal,2015,PAYS DE LA LOIRE,LA ROCHE-SUR-YON,0,11455,11455,
Musée ornithologique Charles-Payraudeau,2015,PAYS DE LA LOIRE,LA-CHAIZE-LE-VICOMTE,196,656,852,
Musée Franco-Américain du Château de Blérancourt,2015,PICARDIE,BLERANCOURT,186,1389,1575,
Musée Municipal de Soissons,2015,PICARDIE,SOISSONS,4114,9698,13812,
Musée du Noyonnais,2015,PICARDIE,NOYON,1221,1990,3211,
Musée de Picardie,2015,PICARDIE,AMIENS,7415,30149,37564,
Musée National de la Marine & Ancienne école de médecine navale,2015,POITOU-CHARENTES,ROCHEFORT,23497,22011,45508,
Musée de l'Ile d'Oléron,2015,POITOU-CHARENTES,ST-PIERRE D'OLERON,10554,3414,13968,
Musée Bernard d’Agesci,2015,POITOU-CHARENTES,NIORT,3610,8890,12500,
"Musée de la Moto, de l'Automobile et du Vélo",2015,POITOU-CHARENTES,CHATELLERAULT,9942,11050,20992,
Musée Sainte-Croix,2015,POITOU-CHARENTES,POITIERS,5472,22024,27496,
Musée-Château de Cagnes,2015,PROVENCE-ALPES-CÔTE D'AZUR,CAGNES-SUR-MER,16517,7634,24151,
Villa-Musée Jean-Honoré Fragonard,2015,PROVENCE-ALPES-CÔTE D'AZUR,GRASSE,0,7695,7695,
Musée Bonnard,2015,PROVENCE-ALPES-CÔTE D'AZUR,LE CANNET,24625,13135,37760,
Musée de Préhistoire Régionale,2015,PROVENCE-ALPES-CÔTE D'AZUR,MENTON,711,10903,11614,
Musée du Vieux-Logis de Nice,2015,PROVENCE-ALPES-CÔTE D'AZUR,NICE,285,186,471,
Musée Archéologique - Site de Terra Amata,2015,PROVENCE-ALPES-CÔTE D'AZUR,NICE,3236,10977,14213,
Ecomusée du Pays de la Roudoule,2015,PROVENCE-ALPES-CÔTE D'AZUR,PUGET-ROSTANG,1534,0,1534,
Musée du Parlement de Provence et du Vieil Aix,2015,PROVENCE-ALPES-CÔTE D'AZUR,AIX-EN-PROVENCE,0,13698,13698,
Muséum d'Histoire Naturelle,2015,PROVENCE-ALPES-CÔTE D'AZUR,AIX-EN-PROVENCE,1170,11969,13139,
Musée Départemental de l'Arles Antique,2015,PROVENCE-ALPES-CÔTE D'AZUR,ARLES,43003,108896,151899,
Musée de la Légion Etrangère,2015,PROVENCE-ALPES-CÔTE D'AZUR,AUBAGNE/PUYLOUBIER,0,18267,18267,
Musée Frédéric Mistral,2015,PROVENCE-ALPES-CÔTE D'AZUR,MAILLANE,1621,862,2483,
Musée des Troupes de Marine,2015,PROVENCE-ALPES-CÔTE D'AZUR,FREJUS,0,16165,16165,
Musée Jean Aicard,2015,PROVENCE-ALPES-CÔTE D'AZUR,LE POUVEREL LA GARDE,0,150,150,
Musée Archéologique,2015,PROVENCE-ALPES-CÔTE D'AZUR,SAINT-RAPHAËL,340,18630,18970,
Muséum d'Histoire Naturelle de Toulon et du Var,2015,PROVENCE-ALPES-CÔTE D'AZUR,TOULON,0,43744,43744,
Musée Calvet (et musée Lapidaire),2015,PROVENCE-ALPES-CÔTE D'AZUR,AVIGNON,15778,25531,41309,
Musée Vivarois César Filhol,2015,RHONE-ALPES,ANNONAY,80,257,337,
Musée des Vans,2015,RHONE-ALPES,LES VANS,338,669,1007,
Musée d'Huez et de l'Oisans,2015,RHONE-ALPES,ALPE D'HUEZ,593,3963,4556,
Musée Géo-Charles,2015,RHONE-ALPES,ECHIROLLES,0,7725,7725,
Musée Dauphinois,2015,RHONE-ALPES,GRENOBLE,0,63492,63492,
Musée Hébert,2015,RHONE-ALPES,LA TRONCHE,0,26689,26689,
Musée des Beaux-Arts et d'Archéologie J. Dechelette,2015,RHONE-ALPES,ROANNE,4883,6744,11627,
Musée Folklorique et Traditions Populaires Marius Audin,2015,RHONE-ALPES,BEAUJEU,634,646,1280,
Musée d'Art Contemporain de Lyon,2015,RHONE-ALPES,LYON,54505,77015,131520,
Musée Archéologique,2015,RHONE-ALPES,SAINT-ROMAIN-EN-GAL,20782,48909,69691,
Musée des Beaux-Arts,2015,RHONE-ALPES,CHAMBERY,5759,16481,22240,
Musée du Peigne et de la Plasturgie,2016,AUVERGNE-RHONE-ALPES,OYONNAX,2136,2736,4872,
Musée du Vieux Pérouges,2016,AUVERGNE-RHONE-ALPES,PEROUGES,15235,1012,16247,
Musée Départemental du Revermont,2016,AUVERGNE-RHONE-ALPES,VAL-REVERMONT,1704,7946,9650,
Musée Charles-Louis Philippe,2016,AUVERGNE-RHONE-ALPES,CERILLY,104,81,185,
Musée des Musiques Populaires - MuPop,2016,AUVERGNE-RHONE-ALPES,MONTLUCON,14907,710,15617,
Musée Municipal de Souvigny,2016,AUVERGNE-RHONE-ALPES,SOUVIGNY,6221,649,6870,
Musée des Beaux-Arts,2016,AUVERGNE-RHONE-ALPES,VALENCE,9997,31458,41455,
Musée du Chablais,2016,AUVERGNE-RHONE-ALPES,THONON-LES-BAINS,2045,2851,4896,
Musée d'Huez et de l'Oisans,2016,AUVERGNE-RHONE-ALPES,ALPE D'HUEZ,0,2331,2331,
Musée Victor Charreton,2016,AUVERGNE-RHONE-ALPES,BOURGOIN-JALLIEU,566,7533,8099,
Musée Géo-Charles,2016,AUVERGNE-RHONE-ALPES,ECHIROLLES,0,7345,7345,
Musée Hector Berlioz,2016,AUVERGNE-RHONE-ALPES,LA-COTE-SAINT-ANDRE,0,12694,12694,
Musée d'Archéologie,2016,AUVERGNE-RHONE-ALPES,FEURS,2168,3292,5460,
Musée du Vieux Pommiers,2016,AUVERGNE-RHONE-ALPES,POMMIERS-EN-FOREZ,0,25,25,
Musée d'Archéologie Bargoin,2016,AUVERGNE-RHONE-ALPES,CLERMONT-FERRAND,4741,13295,18036,
Musée des Beaux-Arts,2016,AUVERGNE-RHONE-ALPES,LYON,172333,162126,334459,
Musée Henri Malartre,2016,AUVERGNE-RHONE-ALPES,ROCHETAILLEE-SUR-SAONE,14779,16214,30993,
Musée Archéologique,2016,AUVERGNE-RHONE-ALPES,SAINT-ROMAIN-EN-GAL,24799,52189,76988,
Musée archéologique et minéralogique Pierre Borrione,2016,AUVERGNE-RHONE-ALPES,AIME-EN-TARENTAISE,391,145,536,
Musée de la résistance et de la Déportation,2016,BOURGOGNE-FRANCHE-COMTE,BESANCON,33998,11332,45330,
Musée Beurnier-Rossel,2016,BOURGOGNE-FRANCHE-COMTE,MONTBELIARD,1134,2859,3993,
Musée-Maison Natale Gustave Courbet,2016,BOURGOGNE-FRANCHE-COMTE,ORNANS,39929,12046,51975,
Musée de Pontarlier,2016,BOURGOGNE-FRANCHE-COMTE,PONTARLIER,801,6179,6980,
Musée Départemental de la Montagne Albert Demard,2016,BOURGOGNE-FRANCHE-COMTE,LE HAUT-DU-THEM,3832,3336,7168,
Musée de l'Abbaye/Donations Guy Bardone - René Genis,2016,BOURGOGNE-FRANCHE-COMTE,SAINT-CLAUDE,7308,2476,9784,
Musée de l'Artisanat Jurassien,2016,BOURGOGNE-FRANCHE-COMTE,VOITEUR,0,15664,15664,
Musée de la Loire,2016,BOURGOGNE-FRANCHE-COMTE,COSNE-SUR-LOIRE,1188,4415,5603,
Musée Rolin,2016,BOURGOGNE-FRANCHE-COMTE,AUTUN,8335,5952,14287,
Musée René Davoine,2016,BOURGOGNE-FRANCHE-COMTE,CHAROLLES,0,101,101,
Musée des Ursulines,2016,BOURGOGNE-FRANCHE-COMTE,MACON,2383,20951,23334,
Musée Eucharistique du Hiéron,2016,BOURGOGNE-FRANCHE-COMTE,PARAY-LE-MONIAL,3329,5886,9215,
Ecomusée de la Bresse Bourguignonne,2016,BOURGOGNE-FRANCHE-COMTE,PIERRE-DE-BRESSE,24665,13508,38173,
Musée Départemental du Compagnonnage,2016,BOURGOGNE-FRANCHE-COMTE,ROMANECHE-THORINS,1835,2378,4213,
Maison du Blé et du Pain,2016,BOURGOGNE-FRANCHE-COMTE,VERDUN-SUR-LE-DOUBS,2532,1474,4006,
Musée Zervos - Maison Romain Rolland,2016,BOURGOGNE-FRANCHE-COMTE,VEZELAY,4384,2534,6918,
Ecomusée des Monts d'Arrée - Moulins de Kerouat,2016,BRETAGNE,COMMANA,8075,2147,10222,
Musée de Morlaix,2016,BRETAGNE,MORLAIX,14283,12132,26415,
Musée des Phares et Balises,2016,BRETAGNE,OUESSANT,14196,2104,16300,
Musée Bigouden,2016,BRETAGNE,PONT-L'ABBE,11370,3269,14639,
Musée de l'Ecole Rurale en Bretagne,2016,BRETAGNE,TREGARVAN,7651,1854,9505,
Musée des Beaux-Arts,2016,BRETAGNE,RENNES,20926,63573,84499,
Ecomusée Industriel des Forges,2016,BRETAGNE,INZINZAC-LOCHRIST,1606,1995,3601,
Musée du Château Charles VII,2016,CENTRE-VAL DE LOIRE,MEHUN-SUR-YEVRE,7779,0,7779,
Muséum des Sciences Naturelles et de Préhistoire,2016,CENTRE-VAL DE LOIRE,CHARTRES,0,10000,10000,
Musée des Beaux-Arts,2016,CENTRE-VAL DE LOIRE,CHARTRES,3875,3712,7587,
Musée d'Art et d'Histoire Marcel Dessal,2016,CENTRE-VAL DE LOIRE,DREUX,1081,8971,10052,
"""Maison Musée"" René Descartes",2016,CENTRE-VAL DE LOIRE,DESCARTES,1339,779,2118,
Musée de Préhistoire du Grand Pressigny,2016,CENTRE-VAL DE LOIRE,LE GRAND PRESSIGNY,8143,7649,15792,
Musée Lansyer,2016,CENTRE-VAL DE LOIRE,LOCHES,13248,2188,15436,
Musée du Savignéen,2016,CENTRE-VAL DE LOIRE,SAVIGNE-SUR-LATHAN,1285,92,1377,
Musée François Rabelais,2016,CENTRE-VAL DE LOIRE,SEUILLY,9788,2032,11820,
Musée du Compagnonnage,2016,CENTRE-VAL DE LOIRE,TOURS,22874,8346,31220,
Château Musées de Blois,2016,CENTRE-VAL DE LOIRE,BLOIS,220317,32326,252643,
Musée de Sologne,2016,CENTRE-VAL DE LOIRE,ROMORANTIN-LANTHENAY,1416,3051,4467,
Musée Archéologique,2016,CENTRE-VAL DE LOIRE,THESEE,629,99,728,
Musée Municipal Théâtre Forain et Archéologique,2016,CENTRE-VAL DE LOIRE,ARTENAY,6567,2307,8874,
Musée des Beaux-Arts,2016,CENTRE-VAL DE LOIRE,ORLEANS,9462,47960,57422,
Musée Palais Fesch,2016,CORSE,AJACCIO,24716,18647,43363,
Musée de Préhistoire Corse,2016,CORSE,SARTENE,5892,4650,10542,
Musée d'Histoire de Bastia,2016,CORSE,BASTIA,12499,12235,24734,
Musée du Château-Fort,2016,GRAND EST,SEDAN,55930,2846,58776,
Musée du Pays de Hanau - Histoire et Vies d’un Territoire,2016,GRAND EST,BOUXWILLER,2124,4065,6189,
Maison de l'Archéologie des Vosges du Nord,2016,GRAND EST,NIEDERBRONN-LES-BAINS,2008,1037,3045,
Musée du Château des Rohan,2016,GRAND EST,SAVERNE,3501,3963,7464,
Musée des Arts Décoratifs,2016,GRAND EST,STRASBOURG,28487,30098,58585,
Cabinet des Estampes et des Dessins,2016,GRAND EST,STRASBOURG,0,217,217,
Musée de l'Œuvre Notre-Dame,2016,GRAND EST,STRASBOURG,21165,26695,47860,
Musée Westercamp,2016,GRAND EST,WISSEMBOURG,0,669,669,
Musée Municipal,2016,GRAND EST,SAINT-DIZIER,0,5298,5298,
Musée du Vignoble et des Vins d'Alsace,2016,GRAND EST,KAYSERSBERG VIGNOBLE,2586,45,2631,
Musée Vauban,2016,GRAND EST,NEUF-BRISACH,2099,362,2461,
Musée Municipal,2016,GRAND EST,CHALONS-EN-CHAMPAGNE,1872,9436,11308,
Musée des Beaux-Arts de Saint-Denis,2016,GRAND EST,REIMS,22947,21704,44651,
Musée de l'Histoire du Fer,2016,GRAND EST,JARVILLE-LA-MALGRANGE,4000,5287,9287,
Musée de l'Ecole de Nancy,2016,GRAND EST,NANCY,25122,15243,40365,
Musée d'Art et d'Histoire de Toul,2016,GRAND EST,TOUL,0,8927,8927,
Musée Militaire et Erckmann-Chatrian,2016,GRAND EST,PHALSBOURG,608,676,1284,
Musée du Pays de Sarrebourg,2016,GRAND EST,SARREBOURG,8576,8066,16642,
"Jardin d'Hiver, Musée de La Faïence",2016,GRAND EST,SARREGUEMINES,5345,5345,10690,
La Tour aux Puces - Musée du Pays Thionvillois,2016,GRAND EST,THIONVILLE,470,8094,8564,
Musée de l'Image,2016,GRAND EST,EPINAL,18512,4577,23089,
Ecomusée de Marie-Galante,2016,GUADELOUPE,GRAND-BOURG de MARIE-GALANTE,0,37777,37777,
Musée Municipal de Cambrai,2016,HAUTS-DE-FRANCE,CAMBRAI,2849,8602,11451,
Lieu d'Art et Action Contemporaine de Dunkerque - LAAC,2016,HAUTS-DE-FRANCE,DUNKERQUE,15550,8226,23776,
Musée d'Histoire Naturelle et de Géologie,2016,HAUTS-DE-FRANCE,LILLE,85663,0,85663,
MUDO - Musée de l'Oise,2016,HAUTS-DE-FRANCE,BEAUVAIS,0,57977,57977,
Musée de la Céramique,2016,HAUTS-DE-FRANCE,DESVRES,6908,1194,8102,
Musée d'Art et d'Histoire Roger Rodière,2016,HAUTS-DE-FRANCE,MONTREUIL-SUR-MER,13432,11646,25078,
Musée-Historial de la Grande Guerre,2016,HAUTS-DE-FRANCE,PERONNE,93569,8247,101816,
Musée Intercommunal d'Etampes,2016,ILE-DE-FRANCE,ETAMPES,872,6751,7623,
Musée - Atelier Rodin (Annexe du musée de Paris),2016,ILE-DE-FRANCE,MEUDON,5674,7328,13002,
Musée National des Châteaux de Malmaison et de Bois-Préau,2016,ILE-DE-FRANCE,RUEIL-MALMAISON,38756,28614,67370,
Musée Nissim de Camondo (Union Centrale des Arts Décoratifs),2016,ILE-DE-FRANCE,PARIS,31235,13876,45111,
Musée du Moyen Age-Thermes et Hôtel de Cluny,2016,ILE-DE-FRANCE,PARIS,110960,119228,230188,
Musée National Eugène Delacroix,2016,ILE-DE-FRANCE,PARIS,28362,29786,58148,
"Musée Cernuschi, Musée des Arts de l'Asie de la ville de Paris",2016,ILE-DE-FRANCE,PARIS,23101,23208,46309,
Etablissement Public du Musée des Arts Asiatiques Guimet,2016,ILE-DE-FRANCE,PARIS,156169,119065,275234,
Musée d'Art Moderne de la ville de Paris,2016,ILE-DE-FRANCE,PARIS,282863,330539,613402,
Palais Galliera - Musée de la Mode de la ville de Paris,2016,ILE-DE-FRANCE,PARIS,107948,46313,154261,
Musée National de la Marine,2016,ILE-DE-FRANCE,PARIS,51247,35719,86966,
Musée du 11 Conti - Monnaie de Paris,2016,ILE-DE-FRANCE,PARIS,96200,33800,130000,
Musée Municipal des Capucins,2016,ILE-DE-FRANCE,COULOMMIERS,882,1505,2387,
Musée de la Grande Guerre du Pays de Meaux,2016,ILE-DE-FRANCE,MEAUX,73846,15154,89000,
Musée Adrien Mentienne,2016,ILE-DE-FRANCE,BRY-SUR-MARNE,0,889,889,
Musée National de Port Royal des Champs,2016,ILE-DE-FRANCE,MAGNY-LES-HAMEAUX,6689,15920,22609,
Collections de la Fondation de Coubertin,2016,ILE-DE-FRANCE,SAINT-REMY-LES-CHEVREUSE,59,0,59,
Musée Lambinet,2016,ILE-DE-FRANCE,VERSAILLES,8449,6555,15004,
Muséum Agricole et Industriel Stella Matutina,2016,LA REUNION,PITON-SAINT-LEU,88481,46615,135096,
Musée Départemental de la Réunion - Musée Léon Dierx,2016,LA REUNION,SAINT-DENIS,3327,11503,14830,
Muséum d'Histoire Naturelle,2016,LA REUNION,SAINT-DENIS,6575,20211,26786,
Musée de La Canne,2016,MARTINIQUE,LES TROIS ILETS,7696,9160,16856,
Musée Volcanologique Franck Arnold Perret,2016,MARTINIQUE,SAINT-PIERRE,22335,1027,23362,
Musée d'Art et d'Histoire de Lisieux,2016,NORMANDIE,LISIEUX,148,5232,5380,
Musée Municipal,2016,NORMANDIE,VIRE NORMANDIE,1363,5603,6966,
Musée Alfred Canel,2016,NORMANDIE,PONT-AUDEMER,718,6205,6923,
Musée du Poiré,2016,NORMANDIE,BARENTON,705,3195,3900,
Musée de la Guerre et de la Libération,2016,NORMANDIE,CHERBOURG-EN-COTENTIN,3163,5463,8626,
Musée Maritime de l'Ile de Tatihou,2016,NORMANDIE,SAINT-VAAST-LA-HOUGUE,49148,3925,53073,
Musée des Beaux-Arts et de la Dentelle,2016,NORMANDIE,ALENCON,8852,7583,16435,
Musée Municipal d'Archéologie,2016,NORMANDIE,L'AIGLE,365,619,984,
Pavillon Flaubert,2016,NORMANDIE,CANTELEU,0,2024,2024,
Musée d'Elbeuf,2016,NORMANDIE,ELBEUF,0,65248,65248,
La Maison de l'Armateur,2016,NORMANDIE,LE HAVRE,6112,7860,13972,
"Juliobona, Musée Gallo-Romain de Lillebonne",2016,NORMANDIE,LILLEBONNE,1131,0,1131,
Musée des Sapeurs-Pompiers de France,2016,NORMANDIE,MONTVILLE,5352,3874,9226,
Musée Flaubert et d'Histoire de la Médecine,2016,NORMANDIE,ROUEN,2775,4260,7035,
Musée Municipal des Ivoires,2016,NORMANDIE,YVETOT,660,327,987,
Musée Napoléonien et Africain,2016,NOUVELLE-AQUITAINE,ILE D'AIX,10843,9161,20004,
Muséum d'Histoire Naturelle,2016,NOUVELLE-AQUITAINE,LA ROCHELLE,10508,40133,50641,
Musée National de la Marine,2016,NOUVELLE-AQUITAINE,ROCHEFORT,12549,11444,23993,
Ancienne École de médecine navale - Musée national de la Marine,2016,NOUVELLE-AQUITAINE,ROCHEFORT,4934,6645,11579,
Musée d'Art et d'Archéologie,2016,NOUVELLE-AQUITAINE,GUERET,2823,7390,10213,
Musée des Tumulus de Bougon,2016,NOUVELLE-AQUITAINE,BOUGON,12574,4488,17062,
Musée Henri Barré,2016,NOUVELLE-AQUITAINE,THOUARS,427,1839,2266,
Musée d'Art et d'Archéologie du Périgord (MAAP),2016,NOUVELLE-AQUITAINE,PERIGUEUX,7085,16745,23830,
Musée des Beaux-Arts et d'Archéologie,2016,NOUVELLE-AQUITAINE,LIBOURNE,0,10023,10023,
Musée Municipal Albert Marzelles,2016,NOUVELLE-AQUITAINE,MARMANDE,0,5866,5866,
Musée du Liège et du Bouchon,2016,NOUVELLE-AQUITAINE,MEZIN,3469,926,4395,
Musée Municipal,2016,NOUVELLE-AQUITAINE,ARUDY,1136,917,2053,
Muséum d'Histoire Naturelle,2016,NOUVELLE-AQUITAINE,BAYONNE,0,31398,31398,
Musée du baptistère Saint-Jean,2016,NOUVELLE-AQUITAINE,POITIERS,11974,1462,13436,
Collection d'Histoire Naturelle,2016,NOUVELLE-AQUITAINE,POITIERS,17430,38336,55766,
Musée de la Forge,2016,OCCITANIE,MONTGAILHARD,28402,0,28402,
Musée du Palais des Evêques,2016,OCCITANIE,SAINT-LIZIER,8705,1459,10164,
Musée des Beaux-Arts,2016,OCCITANIE,CARCASSONNE,0,66216,66216,
Musée Archéologique du Lauragais,2016,OCCITANIE,CASTELNAUDARY,546,744,1290,
Musée Archéologique,2016,OCCITANIE,SALLELES D'AUDE,6111,4761,10872,
Musée Pierre de Luxembourg,2016,OCCITANIE,VILLENEUVE-LES-AVIGNON,2306,3269,5575,
Musée de l'Armagnac,2016,OCCITANIE,CONDOM,1422,290,1712,
Musée des Beaux-Arts et des Arts Décoratifs,2016,OCCITANIE,MIRANDE,3013,0,3013,
Musée-Forum de l'Aurignacien,2016,OCCITANIE,AURIGNAC,6482,1564,8046,
Musée du Pays de Luchon,2016,OCCITANIE,BAGNERES-DE-LUCHON,987,490,1477,
Musée de l'Ephèbe,2016,OCCITANIE,LE CAP D'AGDE,8701,4483,13184,
Musée Murat,2016,OCCITANIE,CŒUR DE CAUSSE,689,54,743,
Ecomusée du Mont Lozère,2016,OCCITANIE,LE PONT DE MONTVERT,1926,1518,3444,
Musée de Tautavel,2016,OCCITANIE,TAUTAVEL,52959,11891,64850,
Musée du Pays Vaurais,2016,OCCITANIE,LAVAUR,1490,2731,4221,
Musée du Vieil Auvillar,2016,OCCITANIE,AUVILLAR,2329,647,2976,
Musée  Départemental Dobrée,2016,PAYS DE LA LOIRE,NANTES,563,40186,40749,
Musée d'Art et d'Histoire,2016,PAYS DE LA LOIRE,BAUGE,0,3607,3607,
Musée de Tessé,2016,PAYS DE LA LOIRE,LE MANS,15222,13250,28472,
Musée Municipal,2016,PAYS DE LA LOIRE,LA ROCHE-SUR-YON,0,15979,15979,
Musée du Château,2016,PAYS DE LA LOIRE,NOIRMOUTIER-EN-L'ILE,31537,3788,35325,
Musée Picasso,2016,PROVENCE-ALPES-CÔTE D'AZUR,ANTIBES,80818,39859,120677,
Musée Renoir,2016,PROVENCE-ALPES-CÔTE D'AZUR,CAGNES-SUR-MER,24431,14609,39040,
Villa-Musée Jean-Honoré Fragonard,2016,PROVENCE-ALPES-CÔTE D'AZUR,GRASSE,0,1749,1749,
Musée International de la Parfumerie,2016,PROVENCE-ALPES-CÔTE D'AZUR,GRASSE,69657,41079,110736,
Musée des Beaux-Arts,2016,PROVENCE-ALPES-CÔTE D'AZUR,MENTON,0,8344,8344,
Musée des Beaux-Arts Jules Chéret,2016,PROVENCE-ALPES-CÔTE D'AZUR,NICE,7549,16054,23603,
Musée National Marc Chagall,2016,PROVENCE-ALPES-CÔTE D'AZUR,NICE,92397,52906,145303,
Musée Archéologique - Site de Terra Amata,2016,PROVENCE-ALPES-CÔTE D'AZUR,NICE,1025,12394,13419,
Musées de la Citadelle,2016,PROVENCE-ALPES-CÔTE D'AZUR,VILLEFRANCHE-SUR-MER,0,89493,89493,
Musée Granet,2016,PROVENCE-ALPES-CÔTE D'AZUR,AIX-EN-PROVENCE,109825,65652,175477,
Muséon Arlaten,2016,PROVENCE-ALPES-CÔTE D'AZUR,ARLES,0,3062,3062,
Musée Départemental de l'Arles Antique,2016,PROVENCE-ALPES-CÔTE D'AZUR,ARLES,49381,113103,162484,
Fondation Louis Jou,2016,PROVENCE-ALPES-CÔTE D'AZUR,LES-BAUX-DE-PROVENCE,0,1000,1000,
Musée Ziem,2016,PROVENCE-ALPES-CÔTE D'AZUR,MARTIGUES,0,14029,14029,
Musée Suffren et du Vieux Saint-Cannat,2016,PROVENCE-ALPES-CÔTE D'AZUR,SAINT-CANNAT,0,775,775,
Musée des Alpilles,2016,PROVENCE-ALPES-CÔTE D'AZUR,SAINT-REMY-DE-PROVENCE,3195,7072,10267,
Musée Estrine - Présence Van Gogh,2016,PROVENCE-ALPES-CÔTE D'AZUR,SAINT-REMY-DE-PROVENCE,7265,4477,11742,
Musée du Vêtement Provençal (Jean Aicard),2016,PROVENCE-ALPES-CÔTE D'AZUR,SOLLIES-VILLE,0,8864,8864,
Muséum d'Histoire Naturelle Esprit Requien,2016,PROVENCE-ALPES-CÔTE D'AZUR,AVIGNON,0,14840,14840,
Musée du Petit Palais,2016,PROVENCE-ALPES-CÔTE D'AZUR,AVIGNON,13691,15567,29258,
Musée Jean Garcin 39-45 : L'appel de la Liberté,2016,PROVENCE-ALPES-CÔTE D'AZUR,FONTAINE-DE-VAUCLUSE,2764,4954,7718,
Musée Municipal,2016,PROVENCE-ALPES-CÔTE D'AZUR,ORANGE,49159,0,49159,
Musée Municipal de Souvigny,2017,AUVERGNE-RHONE-ALPES,SOUVIGNY,8499,1085,9584,
Musée des Vans,2017,AUVERGNE-RHONE-ALPES,LES VANS,578,1276,1854,
Musée et Site Archéologiques,2017,AUVERGNE-RHONE-ALPES,SOYONS,11807,1803,13610,
Musée d'Art et d'Archéologie,2017,AUVERGNE-RHONE-ALPES,AURILLAC,1448,15107,16555,
Musée de la Haute Auvergne,2017,AUVERGNE-RHONE-ALPES,SAINT-FLOUR,1874,4932,6806,
Musée du Château des Adhémars,2017,AUVERGNE-RHONE-ALPES,MONTELIMAR,11957,12613,24570,
Musée du site Préhistorique,2017,AUVERGNE-RHONE-ALPES,VASSIEUX-EN-VERCORS,10235,0,10235,
Musée du Chablais,2017,AUVERGNE-RHONE-ALPES,THONON-LES-BAINS,1973,1448,3421,
Musée de Bourgoin-Jallieu,2017,AUVERGNE-RHONE-ALPES,BOURGOIN-JALLIEU,3038,5097,8135,
Musée de Grenoble,2017,AUVERGNE-RHONE-ALPES,GRENOBLE,69698,115248,184946,
Musée Dauphinois,2017,AUVERGNE-RHONE-ALPES,GRENOBLE,0,59665,59665,
Musée Hector Berlioz,2017,AUVERGNE-RHONE-ALPES,LA-COTE-SAINT-ANDRE,0,14174,14174,
Musée Lapidaire Saint-Pierre,2017,AUVERGNE-RHONE-ALPES,VIENNE,3369,7294,10663,
Musée d'Histoire du  20ème Siècle - Résistance et Déportation,2017,AUVERGNE-RHONE-ALPES,ESTIVAREILLES,2285,1207,3492,
Musée d'Art Moderne et Contemporain de Saint-Etienne Métropole,2017,AUVERGNE-RHONE-ALPES,SAINT-PRIEST-EN-JAREZ,29914,36629,66543,
Musée Rural,2017,AUVERGNE-RHONE-ALPES,USSON-EN-FOREZ,3547,651,4198,
Musée d'Archéologie Bargoin,2017,AUVERGNE-RHONE-ALPES,CLERMONT-FERRAND,3857,21238,25095,
Musées Gadagne,2017,AUVERGNE-RHONE-ALPES,LYON,32200,42685,74885,
Musée Municipal d'Albertville-Conflans,2017,AUVERGNE-RHONE-ALPES,ALBERTVILLE,2928,2575,5503,
Musée des Beaux-Arts,2017,AUVERGNE-RHONE-ALPES,CHAMBERY,6092,21874,27966,
Musée des Charmettes,2017,AUVERGNE-RHONE-ALPES,CHAMBERY,0,7265,7265,
Musée Alésia - Centre d'Interprétation,2017,BOURGOGNE-FRANCHE-COMTE,ALISE-SAINTE-REINE,50994,13829,64823,
Muséum - Jardin des Sciences,2017,BOURGOGNE-FRANCHE-COMTE,DIJON,15283,107542,122825,
Musée Magnin,2017,BOURGOGNE-FRANCHE-COMTE,DIJON,6270,9736,16006,
Musée Municipal,2017,BOURGOGNE-FRANCHE-COMTE,NUITS-SAINT-GEORGES,589,4238,4827,
Musée Municipal François Pompon,2017,BOURGOGNE-FRANCHE-COMTE,SAULIEU,3633,6748,10381,
Musée du Costume,2017,BOURGOGNE-FRANCHE-COMTE,CHATEAU-CHINON,2848,892,3740,
Musée de la Mine,2017,BOURGOGNE-FRANCHE-COMTE,LA MACHINE,5902,734,6636,
Musée Lapidaire Saint-Nicolas,2017,BOURGOGNE-FRANCHE-COMTE,AUTUN,0,375,375,
Musée Saint-Nazaire,2017,BOURGOGNE-FRANCHE-COMTE,BOURBON-LANCY,0,205,205,
Musée Nicéphore Niepce,2017,BOURGOGNE-FRANCHE-COMTE,CHALON-SUR-SAONE,0,27530,27530,
"L'Atelier d'un Journal"" de Louhans - Musée Municipal",2017,BOURGOGNE-FRANCHE-COMTE,LOUHANS,1697,3151,4848,
Maison du Blé et du Pain,2017,BOURGOGNE-FRANCHE-COMTE,VERDUN-SUR-LE-DOUBS,2334,1492,3826,
Musée de l'Avallonnais,2017,BOURGOGNE-FRANCHE-COMTE,AVALLON,655,3876,4531,
Musée Colette,2017,BOURGOGNE-FRANCHE-COMTE,SAINT-SAUVEUR-EN-PUISAYE,7382,1264,8646,
Ecomusée des Monts d'Arrée - Maison Cornec,2017,BRETAGNE,RIVOAL,0,2578,2578,
Musée de l'Ancienne Abbaye de Landévennec,2017,BRETAGNE,LANDEVENNEC,23885,2923,26808,
Ecomusée d'Ouessant - Vivre sur une Ile,2017,BRETAGNE,OUESSANT,5975,945,6920,
Musée International du Long-Cours Cap-Hornier,2017,BRETAGNE,SAINT-MALO,7946,8284,16230,
Musée de la Carte Postale,2017,BRETAGNE,BAUD,1576,1055,2631,
Musée National de la Marine,2017,BRETAGNE,PORT-LOUIS,40427,29307,69734,
"La Cohue, Musée des Beaux-Arts de vannes",2017,BRETAGNE,VANNES,6778,144023,150801,
Musée Estève,2017,CENTRE-VAL DE LOIRE,BOURGES,6779,2238,9017,
Musée des Meilleurs Ouvriers de France,2017,CENTRE-VAL DE LOIRE,BOURGES,5157,2068,7225,
Musée Marcel Proust,2017,CENTRE-VAL DE LOIRE,ILLIERS-COMBRAY,4414,174,4588,
Musée Farcot,2017,CENTRE-VAL DE LOIRE,SAINVILLE,6,22,28,
Musée Archéologique d'Argentomagus,2017,CENTRE-VAL DE LOIRE,SAINT-MARCEL,5606,5253,10859,
Musée du Savignéen,2017,CENTRE-VAL DE LOIRE,SAVIGNE-SUR-LATHAN,338,29,367,
Musée des Beaux-Arts,2017,CENTRE-VAL DE LOIRE,TOURS,17530,46221,63751,
Muséum d'Histoire Naturelle,2017,CENTRE-VAL DE LOIRE,BLOIS,5769,5963,11732,
Maison de la Magie,2017,CENTRE-VAL DE LOIRE,BLOIS,74266,23941,98207,
Musée Gaston Couté,2017,CENTRE-VAL DE LOIRE,MEUNG-SUR-LOIRE,0,2772,2772,
Musée Girodet,2017,CENTRE-VAL DE LOIRE,MONTARGIS,0,1200,1200,
Musée de l'Alta Rocca,2017,CORSE,LEVIE,5825,3243,9068,
Musée Vauluisant - Musée de la Bonneterie,2017,GRAND EST,TROYES,2251,6133,8384,
Musée de la Folie Marco,2017,GRAND EST,BARR,1163,1281,2444,
Musée Historique,2017,GRAND EST,HAGUENAU,23,5574,5597,
Musée de la Chartreuse,2017,GRAND EST,MOLSHEIM,4641,2053,6694,
Musée du Château des Rohan,2017,GRAND EST,SAVERNE,4055,4231,8286,
Musée de l'Œuvre Notre-Dame,2017,GRAND EST,STRASBOURG,19102,28443,47545,
Musée Municipal,2017,GRAND EST,SAINT-DIZIER,0,3437,3437,
Musée Gallo-Romain,2017,GRAND EST,BIESHEIM,632,1272,1904,
Musée de la Porte de Thann,2017,GRAND EST,CERNAY,38,113,151,
Musée d'Unterlinden,2017,GRAND EST,COLMAR,173530,40000,213530,
Musée des Amis de Thann,2017,GRAND EST,THANN,397,894,1291,
Musée du Sapeur Pompier d'Alsace,2017,GRAND EST,VIEUX FERRETTE,4476,923,5399,
Musée Saint-Rémi,2017,GRAND EST,REIMS,7744,13072,20816,
Musée du Château de Lunéville,2017,GRAND EST,LUNEVILLE,26333,152679,179012,
Musée Barrois,2017,GRAND EST,BAR-LE-DUC,2858,6112,8970,
Musée d'Art Sacré de la Meuse,2017,GRAND EST,SAINT-MIHIEL,959,409,1368,
Musée Municipal Saint-John Perse,2017,GUADELOUPE,POINTE-A-PITRE,0,2700,2700,
Musée des Cultures Guyanaises,2017,GUYANE,CAYENNE,975,4201,5176,
Musée Jeanne d'Aboville,2017,HAUTS-DE-FRANCE,LA FERE,590,771,1361,
Musée Entomologique,2017,HAUTS-DE-FRANCE,SAINT-QUENTIN,0,6115,6115,
Musée Alexandre Dumas,2017,HAUTS-DE-FRANCE,VILLERS COTTERETS,743,826,1569,
Musée du Mont-de-Piété,2017,HAUTS-DE-FRANCE,BERGUES,770,1525,2295,
Musée Municipal de Cambrai,2017,HAUTS-DE-FRANCE,CAMBRAI,1293,8662,9955,
Musée Départemental de Flandre,2017,HAUTS-DE-FRANCE,CASSEL,35332,15684,51016,
Musée de la Chartreuse,2017,HAUTS-DE-FRANCE,DOUAI,4236,17885,22121,
Musée d'Histoire Naturelle et de Géologie,2017,HAUTS-DE-FRANCE,LILLE,44301,48357,92658,
Musée de la Tour Abbatiale,2017,HAUTS-DE-FRANCE,SAINT-AMAND-LES-EAUX,0,10038,10038,
Musée Archéologique de l'Oise,2017,HAUTS-DE-FRANCE,VENDEUIL-CAPLY,4169,2578,6747,
Musée Communautaire Opale-Sud,2017,HAUTS-DE-FRANCE,BERCK-SUR-MER,1932,6943,8875,
Musée du Touquet Paris-Plage,2017,HAUTS-DE-FRANCE,LE TOUQUET-PARIS-PLAGE,6499,7805,14304,
Louvre-Lens (collections nationales decentralisées),2017,HAUTS-DE-FRANCE,LENS,124985,325339,450324,
Musée Municipal Bruno Danvin,2017,HAUTS-DE-FRANCE,SAINT-POL-SUR-TERNOISE,0,3499,3499,
Musée Boucher-de-Perthes,2017,HAUTS-DE-FRANCE,ABBEVILLE,1495,8362,9857,
Musée de Picardie,2017,HAUTS-DE-FRANCE,AMIENS,3207,7747,10954,
Musée-Historial de la Grande Guerre,2017,HAUTS-DE-FRANCE,PERONNE,80774,8743,89517,
Musée du Château,2017,ILE-DE-FRANCE,DOURDAN,11888,10574,22462,
Musée Intercommunal d'Etampes,2017,ILE-DE-FRANCE,ETAMPES,289,5773,6062,
Musée Roybet Fould,2017,ILE-DE-FRANCE,COURBEVOIE,1041,8722,9763,
Musée Français de la Carte à Jouer,2017,ILE-DE-FRANCE,ISSY-LES-MOULINEAUX,7772,18034,25806,
Musée d'Art et d'Histoire,2017,ILE-DE-FRANCE,MEUDON,3501,10000,13501,
Musée National des Châteaux de Malmaison et de Bois-Préau,2017,ILE-DE-FRANCE,RUEIL-MALMAISON,46311,38827,85138,
Musée de l'Armée,2017,ILE-DE-FRANCE,PARIS,667162,509825,1176987,
Crypte Archéologique du Parvis Notre-Dame,2017,ILE-DE-FRANCE,PARIS,46221,124969,171190,
Musée National de la Légion d'Honneur et des Ordres de Chevalerie,2017,ILE-DE-FRANCE,PARIS,0,50436,50436,
"Petit Palais, Musée des Beaux-Arts de la ville de Paris",2017,ILE-DE-FRANCE,PARIS,379048,792172,1171220,
Musée de la Franc-Maçonnerie,2017,ILE-DE-FRANCE,PARIS,12468,6993,19461,
Musée des Monuments Français,2017,ILE-DE-FRANCE,PARIS,52730,68284,121014,
Etablissement Public de la Porte Dorée - Palais,2017,ILE-DE-FRANCE,PARIS,15407,18980,34387,
Musée d'Art et d'Histoire de l'Hôpital Sainte-Anne,2017,ILE-DE-FRANCE,PARIS,0,7627,7627,
Musée Yves Saint Laurent,2017,ILE-DE-FRANCE,PARIS,72906,6493,79399,
Musée de l'Ecole de Barbizon - Auberge Ganne,2017,ILE-DE-FRANCE,BARBIZON,11368,10403,21771,
Musée Municipal de Chelles Alfred Bonno,2017,ILE-DE-FRANCE,CHELLES,0,3085,3085,
Maison Natale de Louis Braille,2017,ILE-DE-FRANCE,COUPVRAY,4233,817,5050,
Musée d'Art et d'Histoire de Melun,2017,ILE-DE-FRANCE,MELUN,504,3780,4284,
Musée des Pays de Seine-et-Marne,2017,ILE-DE-FRANCE,SAINT-CYR-SUR-MORIN,3608,8039,11647,
Ecomusée du Val de Bièvre,2017,ILE-DE-FRANCE,FRESNES,0,8572,8572,
Musée de Saint-Maur - Villa Médicis,2017,ILE-DE-FRANCE,LA VARENNE-SAINT-HILAIRE,209,16559,16768,
Musée Archéologique du Val d'Oise,2017,ILE-DE-FRANCE,GUIRY-EN-VEXIN,0,15231,15231,
Musée de la Batellerie et des Voies Navigables,2017,ILE-DE-FRANCE,CONFLANS-SAINTE-HONORINE,9496,3506,13002,
Musée Départemental de la Réunion - Musée Léon Dierx,2017,LA REUNION,SAINT-DENIS,7385,21428,28813,
Musée des Arts Décoratifs de l’Océan indien (MADOI),2017,LA REUNION,SAINT-LOUIS,7928,692,8620,
Musée Régional d'Histoire et d'Ethnologie,2017,MARTINIQUE,FORT-DE-FRANCE,557,3354,3911,
Musée des Beaux-Arts,2017,NORMANDIE,CAEN,26209,47030,73239,
Musée d'Ethnographie et d'Arts Populaires et Musée de la Marine,2017,NORMANDIE,HONFLEUR,17750,5756,23506,
Musée Municipal,2017,NORMANDIE,LOUVIERS,0,5738,5738,
Musée Alfred Canel,2017,NORMANDIE,PONT-AUDEMER,690,4829,5519,
Musée de l'Abbaye,2017,NORMANDIE,CERISY-LA-FORET,5510,450,5960,
Musée Thomas Henry,2017,NORMANDIE,CHERBOURG-EN-COTENTIN,4387,16223,20610,
Musée de la Guerre et de la Libération,2017,NORMANDIE,CHERBOURG-EN-COTENTIN,3985,5731,9716,
Musée Quesnel-Morinière,2017,NORMANDIE,COUTANCES,6161,0,6161,
Musée Christian Dior,2017,NORMANDIE,GRANVILLE,48464,7851,56315,
"Musée du Bocage Normand, ferme du bois Jugan",2017,NORMANDIE,SAINT-LO,1265,3189,4454,
Musée du Granit,2017,NORMANDIE,SAINT-MICHEL-DE-MONTJOIE,76,1770,1846,
Musée des Terres-Neuvas et de la Pêche,2017,NORMANDIE,FECAMP,1891,11579,13470,
Musée de l'Hôtel Dubocage de Bléville,2017,NORMANDIE,LE HAVRE,0,11224,11224,
La Maison de l'Armateur,2017,NORMANDIE,LE HAVRE,10407,10814,21221,
Musée des Traditions et Arts Normands,2017,NORMANDIE,MARTAINVILLE-EPREVILLE,9731,14057,23788,
Musée Municipal des Ivoires,2017,NORMANDIE,YVETOT,592,167,759,
Musée Archéologique et Historique,2017,NOUVELLE-AQUITAINE,ANGOULEME,105,442,547,
Cité International de la Bande Dessinée et de l'Image - Musée de la Bande Dessinée,2017,NOUVELLE-AQUITAINE,ANGOULEME,18666,51783,70449,
Musée Napoléonien et Africain,2017,NOUVELLE-AQUITAINE,ILE D'AIX,11549,10117,21666,
Musée Archéologique,2017,NOUVELLE-AQUITAINE,SAINTES,582,3746,4328,
Musée Municipal des Cordeliers,2017,NOUVELLE-AQUITAINE,SAINT-JEAN-D'ANGELY,418,7298,7716,
Musée du Président Jacques Chirac,2017,NOUVELLE-AQUITAINE,SARRAN,15988,5472,21460,
Musée d'Aquitaine,2017,NOUVELLE-AQUITAINE,BORDEAUX,47796,95653,143449,
Musée Municipal,2017,NOUVELLE-AQUITAINE,VILLANDRAUT,112,200,312,
Musée René Baubérot,2017,NOUVELLE-AQUITAINE,CHATEAUPONSAC,1808,429,2237,
Musée Municipal des Beaux-Arts de Limoges - Palais de l'Evêché,2017,NOUVELLE-AQUITAINE,LIMOGES,7016,19578,26594,
Musée de Borda,2017,NOUVELLE-AQUITAINE,DAX,3035,8277,11312,
Musée Despiau-Wlérick,2017,NOUVELLE-AQUITAINE,MONT-DE-MARSAN,0,10972,10972,
Musée du Liège et du Bouchon,2017,NOUVELLE-AQUITAINE,MEZIN,3330,820,4150,
Musée Municipal,2017,NOUVELLE-AQUITAINE,ARUDY,1265,332,1597,
Musée Municipal de Guéthary,2017,NOUVELLE-AQUITAINE,GUETHARY,1167,3000,4167,
Musée National du Château,2017,NOUVELLE-AQUITAINE,PAU,53051,46564,99615,
Musée Municipal des Beaux-Arts,2017,NOUVELLE-AQUITAINE,PAU,9120,10575,19695,
"Musée de la Moto, de l'Automobile et du Vélo",2017,NOUVELLE-AQUITAINE,CHATELLERAULT,4574,7362,11936,
Musée Sainte-Croix,2017,NOUVELLE-AQUITAINE,POITIERS,6596,25065,31661,
Collection d'Histoire Naturelle,2017,NOUVELLE-AQUITAINE,POITIERS,31000,46000,77000,
Musée du Textile et du Peigne en Corne,2017,OCCITANIE,LAVELANET,1755,503,2258,
Musée des Corbières,2017,OCCITANIE,SIGEAN,250,1069,1319,
Musée Joseph Vaylet,2017,OCCITANIE,ESPALION,3149,2500,5649,
Musée Fenaille,2017,OCCITANIE,RODEZ,21060,10972,32032,
Musée du Charroi Rural et de l'Artisanat Traditionnel,2017,OCCITANIE,SALMIECH,0,1050,1050,
Musée Léon Alègre,2017,OCCITANIE,BAGNOLS-SUR-CEZE,0,1402,1402,
Musée Cévenol,2017,OCCITANIE,LE VIGAN,1856,1855,3711,
Musée-Forum de l'Aurignacien,2017,OCCITANIE,AURIGNAC,4287,4531,8818,
Muséum d'Histoire Naturelle,2017,OCCITANIE,TOULOUSE,164336,125526,289862,
Musée du Vieux Toulouse,2017,OCCITANIE,TOULOUSE,6573,978,7551,
Musée Georges Labit,2017,OCCITANIE,TOULOUSE,5868,22740,28608,
Musée Saint-Raymond,2017,OCCITANIE,TOULOUSE,13539,45355,58894,
Musée Pyrénéen,2017,OCCITANIE,LOURDES,69555,9244,78799,
Musée Massey,2017,OCCITANIE,TARBES,4661,5471,10132,
Musée Agathois,2017,OCCITANIE,AGDE,1461,1858,3319,
Musée des Beaux-Arts de Béziers,2017,OCCITANIE,BEZIERS,1908,4894,6802,
Musée Archéologique,2017,OCCITANIE,MINERVE,3768,0,3768,
Musée Fabre,2017,OCCITANIE,MONTPELLIER,225213,27828,253041,
Musée Murat,2017,OCCITANIE,CŒUR DE CAUSSE,1067,23,1090,
Musée Départemental de Cuzals,2017,OCCITANIE,SAULIAC-SUR-CELE,6167,3069,9236,
Muséum d'Histoire Naturelle,2017,OCCITANIE,PERPIGNAN,0,14037,14037,
Musée de Tautavel,2017,OCCITANIE,TAUTAVEL,49273,8793,58066,
Musée Charles Portal - Histoire et Patrimoine,2017,OCCITANIE,CORDES-SUR-CIEL,864,418,1282,
Musée du Pays Rabastinois,2017,OCCITANIE,RABASTENS,1172,5532,6704,
Muséum des Sciences Naturelles,2017,PAYS DE LA LOIRE,ANGERS,4547,19395,23942,
Musée de l'Ardoise,2017,PAYS DE LA LOIRE,TRELAZE,8040,1050,9090,
Musée Communal Robert Tatin,2017,PAYS DE LA LOIRE,COSSE-LE-VIVIEN,20958,5056,26014,
Musée du Vieux Château,2017,PAYS DE LA LOIRE,LAVAL,8341,25768,34109,
Musée de Tessé,2017,PAYS DE LA LOIRE,LE MANS,17915,10670,28585,
Musée de la Chartreuse,2001,ALSACE,MOLSHEIM,3160,0,3160,
Musée de la Bataille du 6 Août 1870,2001,ALSACE,WOERTH,5419,628,6047,
Musée Sundgauvien d'Altkirch,2001,ALSACE,ALTKIRCH,1203,508,1711,
Musée d'Unterlinden,2001,ALSACE,COLMAR,207729,30172,237901,
Musée du Vignoble et des Vins d'Alsace,2001,ALSACE,KIENTZHEIM,8212,0,8212,
Maison du Sundgau - Musée Paysan,2001,ALSACE,OLTINGUE,3030,449,3479,
Musée du Papier Peint,2001,ALSACE,RIXHEIM,10475,2197,12672,
Ecomusée d'Alsace,2001,ALSACE,UNGERSHEIM,279588,33947,313535,
Musée National de la Préhistoire,2001,AQUITAINE,LES EYZIES-DE-TAYAC,46324,27961,74285,
Musée des Arts Décoratifs,2001,AQUITAINE,BORDEAUX,8109,19664,27773,
CAPC Musée d'Art Contemporain de Bordeaux,2001,AQUITAINE,BORDEAUX,11658,43312,54970,
Musée de la Voiture à Cheval,2001,AQUITAINE,BOURG-SUR-GIRONDE,4204,0,4204,
Musée des Beaux-Arts et d'Archéologie,2001,AQUITAINE,LIBOURNE,2301,5765,8066,
Musée Bonnat,2001,AQUITAINE,BAYONNE,17249,11037,28286,
Musée Municipal de Guéthary,2001,AQUITAINE,GUETHARY,534,1982,2516,
Musée Charles-Louis Philippe,2001,AUVERGNE,CERILLY,107,0,107,
Musée Municipal de Gannat,2001,AUVERGNE,GANNAT,1055,0,1055,
Musée des Musiques Populaires - MuPop,2001,AUVERGNE,MONTLUCON,1859,854,2713,
Musée Rieckotter,2001,AUVERGNE,NERIS-LES-BAINS,1229,0,1229,
Musée Municipal de Souvigny,2001,AUVERGNE,SOUVIGNY,4078,476,4554,
Musée d'Art Roger-Quillot,2001,AUVERGNE,CLERMONT-FERRAND,8670,27937,36607,
Musée Départemental de la Céramique Gallo-Romaine,2001,AUVERGNE,LEZOUX,1384,2200,3584,
Musée des Pénitents Blancs,2001,AUVERGNE,MARSAC-EN-LIVRADOIS,710,0,710,
Musée Alésia,2001,BOURGOGNE,ALISE-SAINTE-REINE,15243,1443,16686,
Musée Bonaparte,2001,BOURGOGNE,AUXONNE,0,3070,3070,
Musée des Beaux-Arts,2001,BOURGOGNE,BEAUNE,3399,5598,8997,
Musée François Rude,2001,BOURGOGNE,DIJON,0,25312,25312,
Muséum - Jardin des Sciences,2001,BOURGOGNE,DIJON,7099,89127,96226,
Musée Buffon,2001,BOURGOGNE,MONTBARD,2645,780,3425,
Musée Saint-Nazaire,2001,BOURGOGNE,BOURBON-LANCY,0,1674,1674,
Musée René Davoine,2001,BOURGOGNE,CHAROLLES,277,0,277,
Ecomusée de la Communauté Le Creusot-Monceau-Les-Mines,2001,BOURGOGNE,LE CREUSOT,14012,4779,18791,
Ecomusée de la Bresse Bourguignonne,2001,BOURGOGNE,PIERRE-DE-BRESSE,23643,3878,27521,
Musée de l'Avallonnais Jean Després,2001,BOURGOGNE,AVALLON,595,973,1568,
Musée du Château de Dinan,2001,BRETAGNE,DINAN,18578,5942,24520,
Musée des Beaux-Arts de Brest,2001,BRETAGNE,BREST,1068,10729,11797,
Musée Départemental Breton,2001,BRETAGNE,QUIMPER,44343,0,44343,
Ecomusée du Pays de Rennes,2001,BRETAGNE,RENNES,20313,21456,41769,
Musée Saint-Nicolas,2001,BRETAGNE,VITRE,2723,406,3129,
Musée de Préhistoire J. Miln- Z. Le-Rouzic,2001,BRETAGNE,CARNAC,26794,5962,32756,
Musées de Châteauroux - Hôtel Bertrand,2001,CENTRE,CHATEAUROUX,0,6369,6369,
Musée de l'Hôtel Goüin,2001,CENTRE,TOURS,7101,0,7101,
Musée Municipal Théâtre Forain et Archéologique,2001,CENTRE,ARTENAY,3655,5596,9251,
Musée de la Marine de Loire,2001,CENTRE,CHATEAUNEUF-SUR-LOIRE,10451,3933,14384,
Musée d'Art et d'Archéologie,2001,CENTRE,CHATILLON-COLIGNY,1778,0,1778,
Musée de l'Ardenne,2001,CHAMPAGNE-ARDENNES,CHARLEVILLE-MEZIERES,33630,0,33630,
Musée Napoléon Ier,2001,CHAMPAGNE-ARDENNES,BRIENNE-LE-CHATEAU,2567,326,2893,
Musée de la Résistance,2001,CHAMPAGNE-ARDENNES,MUSSY-SUR-SEINE,127,280,407,
Musée Paul Dubois - Alfred Boucher,2001,CHAMPAGNE-ARDENNES,NOGENT-SUR-SEINE,0,3018,3018,
Ecomusée de la Montagne de Reims,2001,CHAMPAGNE-ARDENNES,POURCY,1267,0,1267,
Viséum-Musée de la Lunette,2001,FRANCHE-COMTE,MOREZ HAUTS DE BIENNE,8420,424,8844,
Musée d'Art et d'Histoire,2001,FRANCHE-COMTE,BELFORT,7427,5066,12493,
Musée Territorial Alexandre Franconie,2001,GUYANE,CAYENNE,6632,4460,11092,
Musée Départemental Albert-Kahn,2001,ILE-DE-FRANCE,BOULOGNE-BILLANCOURT,64237,13328,77565,
Musée des Années Trente,2001,ILE-DE-FRANCE,BOULOGNE-BILLANCOURT,31389,0,31389,
Musée Français de la Carte à Jouer,2001,ILE-DE-FRANCE,ISSY-LES-MOULINEAUX,5477,6261,11738,
Musée - Atelier Rodin (Annexe du musée de Paris),2001,ILE-DE-FRANCE,MEUDON,2855,1828,4683,
Musée Bouchard,2001,ILE-DE-FRANCE,PARIS,1628,548,2176,
Musée de la Musique,2001,ILE-DE-FRANCE,PARIS,116635,17361,133996,
"Musée Cognacq-Jay, Musée du XVIIIe siècle de la ville de Paris",2001,ILE-DE-FRANCE,PARIS,13919,19370,33289,
Musée National d'Art Moderne (Centre National d'Art et de Culture Georges Pompidou),2001,ILE-DE-FRANCE,PARIS,3674008,0,3674008,
Maison Natale de Louis Braille,2001,ILE-DE-FRANCE,COUPVRAY,2479,497,2976,
Musée du Château de Fontainebleau,2001,ILE-DE-FRANCE,FONTAINEBLEAU,195016,122180,317196,
Musée Bossuet,2001,ILE-DE-FRANCE,MEAUX,4208,3484,7692,
Musée Départemental de Préhistoire d'Île de France,2001,ILE-DE-FRANCE,NEMOURS,4559,20768,25327,
Ecomusée du Val de Bièvre,2001,ILE-DE-FRANCE,FRESNES,0,10401,10401,
Musée de Nogent-Sur-Marne,2001,ILE-DE-FRANCE,NOGENT-SUR-MARNE,0,4000,4000,
Musée Emile Jean,2001,ILE-DE-FRANCE,VILLIERS-SUR-MARNE,0,300,300,
Musée jean-Jacques Rousseau,2001,ILE-DE-FRANCE,MONTMORENCY,1708,1336,3044,
Collections de la Fondation de Coubertin,2001,ILE-DE-FRANCE,SAINT-REMY-LES-CHEVREUSE,5688,0,5688,
Musée Historique de Villèle,2001,LA REUNION,SAINT-GILLES-LES-HAUTS,26998,10887,37885,
Musée des Beaux-Arts,2001,LANGUEDOC-ROUSSILLON,CARCASSONNE,0,57416,57416,
Musée des Corbières,2001,LANGUEDOC-ROUSSILLON,SIGEAN,400,1400,1800,
Musée du Colombier,2001,LANGUEDOC-ROUSSILLON,ALES,0,8210,8210,
Musée de la Maison Romane,2001,LANGUEDOC-ROUSSILLON,SAINT-GILLES-DU-GARD,0,11379,11379,
Musée des Vallées Cévenoles,2001,LANGUEDOC-ROUSSILLON,SAINT-JEAN DU GARD,15439,1957,17396,
Musée Fabre,2001,LANGUEDOC-ROUSSILLON,MONTPELLIER,48619,37069,85688,
Musée Archéologique Paul Soyris,2001,LANGUEDOC-ROUSSILLON,MURVIEL-LES-MONTPELLIER,244,85,329,
Musée de Préhistoire Régionale et du Mégalithisme,2001,LANGUEDOC-ROUSSILLON,SAINT-PONS-DE-THOMIERES,1776,269,2045,
Ecomusée du Mont Lozère,2001,LANGUEDOC-ROUSSILLON,LE PONT DE MONTVERT,4161,1960,6121,
Musée des Monnaies et Médailles Joseph Puig,2001,LANGUEDOC-ROUSSILLON,PERPIGNAN,1964,0,1964,
Musée du Pays d'Ussel,2001,LIMOUSIN,USSEL,0,2419,2419,
Musée Départemental de la Tapisserie,2001,LIMOUSIN,AUBUSSON,23968,0,23968,
Musée d'Art et d'Archéologie,2001,LIMOUSIN,GUERET,4462,8377,12839,
Musée Départemental d'Art Contemporain,2001,LIMOUSIN,ROCHECHOUART,4772,4888,9660,
Musée du Château de Montaigu,2001,LORRAINE,LANEUVEVILLE-DEVANT-NANCY,324,142,466,
Musée de Zoologie - Aquarium Tropical,2001,LORRAINE,NANCY,35781,14209,49990,
"Musée ""au Fil du Papier""",2001,LORRAINE,PONT-A-MOUSSON,2844,2931,5775,
Musée de la Céramique et de l'Ivoire,2001,LORRAINE,COMMERCY,1396,938,2334,
Musée d'Argonne,2001,LORRAINE,VARENNES-EN-ARGONNE,3268,0,3268,
Maison du Verre et du Cristal,2001,LORRAINE,MEISENTHAL,16066,375,16441,
Musées de la Cour d'Or,2001,LORRAINE,METZ,14972,30669,45641,
Musée du Pays de Sarrebourg,2001,LORRAINE,SARREBOURG,1478,479,1957,
Moulin de la Blies - Musée des Techniques Faïencières,2001,LORRAINE,SARREGUEMINES,14188,0,14188,
Musée Départemental d'Art Ancien et Contemporain,2001,LORRAINE,EPINAL,14830,16125,30955,
Musée Louis Français,2001,LORRAINE,PLOMBIERES-LES-BAINS,241,149,390,
Musée Charles Friry,2001,LORRAINE,REMIREMONT,426,2830,3256,
Musée Pierre Noël - Musée de la Vie dans les Hautes-Vosges,2001,LORRAINE,SAINT-DIE-DES-VOSGES,0,24265,24265,
Musée Municipal d'archéologie,2001,MIDI-PYRENEES,ROQUEFORT-SUR-SOULZON,0,3150,3150,
Musée de l'Armagnac,2001,MIDI-PYRENEES,CONDOM,7489,160,7649,
Musée Archéologique,2001,MIDI-PYRENEES,EAUZE,6257,1334,7591,
Musée d'Archéologie,2001,MIDI-PYRENEES,LECTOURE,4597,174,4771,
Musée Campanaire,2001,MIDI-PYRENEES,L'ISLE JOURDAIN,8583,1468,10051,
Musée du Pays de Luchon,2001,MIDI-PYRENEES,BAGNERES-DE-LUCHON,2808,981,3789,
Musée du Vieux Toulouse,2001,MIDI-PYRENEES,TOULOUSE,3383,104,3487,
Musée Georges Labit,2001,MIDI-PYRENEES,TOULOUSE,4703,11030,15733,
Musée du Vieux Figeac,2001,MIDI-PYRENEES,FIGEAC,558,0,558,
Musée Municipal,2001,MIDI-PYRENEES,VAYRAC,267,59,326,
Musée Goya,2001,MIDI-PYRENEES,CASTRES,16762,10876,27638,
Musée du Protestantisme en Haut-Languedoc,2001,MIDI-PYRENEES,FERRIERES,1231,0,1231,
Muséum d'histoire naturelle Philadelphe Thomas,2001,MIDI-PYRENEES,GAILLAC,1330,2789,4119,
Musée Ingres,2001,MIDI-PYRENEES,MONTAUBAN,15614,19038,34652,
Musée Municipal d'Escaudain,2001,NORD-PAS-DE-CALAIS,ESCAUDAIN,0,973,973,
Palais des Beaux-Arts de Lille,2001,NORD-PAS-DE-CALAIS,LILLE,120614,36921,157535,
Musée d'Art et d'Industrie,2001,NORD-PAS-DE-CALAIS,TOURCOING,0,26792,26792,
Musée d'Art Moderne de Lille Métropole,2001,NORD-PAS-DE-CALAIS,VILLENEUVE-D'ASCQ,22466,63945,86411,
Musée des Beaux-Arts,2001,NORD-PAS-DE-CALAIS,ARRAS,20941,9692,30633,
Musée des Beaux-Arts et de la Dentelle,2001,NORD-PAS-DE-CALAIS,CALAIS,3170,14887,18057,
Musée d'Histoire et d'Archéologie,2001,NORD-PAS-DE-CALAIS,HARNES,0,1137,1137,
Musée du Château,2001,BASSE-NORMANDIE,PONTECOULANT,6125,0,6125,
Musée paléontologique,2001,BASSE-NORMANDIE,VILLERS-SUR-MER,0,13900,13900,
Musée de l'Abbaye,2001,BASSE-NORMANDIE,CERISY-LA-FORET,9543,0,9543,
Musée de la Libération,2001,BASSE-NORMANDIE,CHERBOURG-EN-COTENTIN,5956,5748,11704,
Musée du Château de Flers,2001,BASSE-NORMANDIE,FLERS,3368,2380,5748,
Musée Municipal,2001,HAUTE-NORMANDIE,BERNAY,6066,0,6066,
Musée de l'Ancien Evêché,2001,HAUTE-NORMANDIE,EVREUX,0,16030,16030,
Maison des Templiers,2001,HAUTE-NORMANDIE,CAUDEBEC-EN-CAUX,359,169,528,
Musée du Prieuré,2001,HAUTE-NORMANDIE,HARFLEUR,266,5077,5343,
Ecomusée de la Basse-Seine,2001,HAUTE-NORMANDIE,NOTRE-DAME-DE-BLIQUETUIT,26163,7316,33479,
Association de l'Horlogerie Aliermontaise,2001,HAUTE-NORMANDIE,SAINT-NICOLAS-D'ALIERMONT,736,200,936,
Muséum d'Histoire Naturelle de Nantes,2001,PAYS DE LA LOIRE,NANTES,16814,31239,48053,
Musée Pincé,2001,PAYS DE LA LOIRE,ANGERS,5417,8760,14177,
Musée d'Art et d'Histoire,2001,PAYS DE LA LOIRE,CHOLET,5213,12900,18113,
Musée Communal Robert Tatin,2001,PAYS DE LA LOIRE,COSSE-LE-VIVIEN,13382,2190,15572,
Musée Archéologique Départemental de Jublains,2001,PAYS DE LA LOIRE,JUBLAINS,8377,25626,34003,
Musée Vert Véron-de-Forbonnais,2001,PAYS DE LA LOIRE,LE MANS,12436,0,12436,
Musée de la Construction Navale Artisanale,2001,PAYS DE LA LOIRE,NOIRMOUTIER EN L'ILE,14381,2380,16761,
Musée Milcendeau Jean-Yole,2001,PAYS DE LA LOIRE,SOULLANS,1947,1050,2997,
Musée du Château de Blérancourt,2001,PICARDIE,BLERANCOURT,3839,2808,6647,
Musée Entomologique,2001,PICARDIE,SAINT-QUENTIN,2129,9935,12064,
Musée du Château de Compiègne,2001,PICARDIE,COMPIEGNE,39878,71138,111016,
Musée-Historial de la Grande Guerre,2001,PICARDIE,PERONNE,79776,0,79776,
Musée des Beaux-Arts,2001,POITOU-CHARENTES,LA ROCHELLE,2010,4789,6799,
Musée d'Orbigny-Bernon,2001,POITOU-CHARENTES,LA ROCHELLE,6759,0,6759,
Musée Ernest Cognacq,2001,POITOU-CHARENTES,SAINT-MARTIN-DE-RE,10781,2586,13367,
Musée de l'Ile d'Oléron,2001,POITOU-CHARENTES,ST-PIERRE D'OLERON,2090,75,2165,
Musée des Ruralies,2001,POITOU-CHARENTES,PRAHECQ,9213,2000,11213,
Musée Henri Barré,2001,POITOU-CHARENTES,THOUARS,372,859,1231,
Musée des Traditions Populaires et d'Archéologie,2001,POITOU-CHARENTES,CHAUVIGNY,7185,3429,10614,
Musée Charbonneau-Lassay,2001,POITOU-CHARENTES,LOUDUN,356,0,356,
Musée de la vallée,2001,PROVENCE-ALPES-CÔTE D'AZUR,BARCELONNETTE,14480,3600,18080,
Musée du Vieux Sisteron,2001,PROVENCE-ALPES-CÔTE D'AZUR,SISTERON,0,747,747,
Musée Picasso,2001,PROVENCE-ALPES-CÔTE D'AZUR,ANTIBES,147430,0,147430,
Musée de la Mer,2001,PROVENCE-ALPES-CÔTE D'AZUR,CANNES,37752,20657,58409,
Musée d'Art et d'Histoire de Provence,2001,PROVENCE-ALPES-CÔTE D'AZUR,GRASSE,7661,0,7661,
Musées de la Citadelle,2001,PROVENCE-ALPES-CÔTE D'AZUR,VILLEFRANCHE-SUR-MER,0,32898,32898,
Musée Paul Arbaud,2001,PROVENCE-ALPES-CÔTE D'AZUR,AIX-EN-PROVENCE,1573,0,1573,
Musée Réattu,2001,PROVENCE-ALPES-CÔTE D'AZUR,ARLES,26000,0,26000,
Musée Municipal Méditerranéen de Cassis A.T.P.,2001,PROVENCE-ALPES-CÔTE D'AZUR,CASSIS,0,3500,3500,
Musée d'Archéologie Méditerranéenne,2001,PROVENCE-ALPES-CÔTE D'AZUR,MARSEILLE,19599,0,19599,
Musée de Salon et de la Crau,2001,PROVENCE-ALPES-CÔTE D'AZUR,SALON-DE-PROVENCE,5496,0,5496,
Musée de la Société d’Etudes Scientifiques et Achéologiques,2001,PROVENCE-ALPES-CÔTE D'AZUR,DRAGUIGNAN,0,200,200,
Musée d'Apt,2001,PROVENCE-ALPES-CÔTE D'AZUR,APT,2686,0,2686,
Musée Comtadin-Duplessis,2001,PROVENCE-ALPES-CÔTE D'AZUR,CARPENTRAS,1186,0,1186,
Synagogue Musée Juif Comtadin,2001,PROVENCE-ALPES-CÔTE D'AZUR,CAVAILLON,6983,0,6983,
Musée Marc Deydier,2001,PROVENCE-ALPES-CÔTE D'AZUR,CUCURON,0,3000,3000,
Musée Léon Marès,2001,RHONE-ALPES,LOVAGNY,24948,0,24948,
Musée des Vallées de Thônes,2001,RHONE-ALPES,THONES,2598,365,2963,
Musée Gallo-Romain,2001,RHONE-ALPES,AOSTE,3355,1814,5169,
Musée de Bourgoin-Jallieu,2001,RHONE-ALPES,BOURGOIN-JALLIEU,9595,0,9595,
Musée Lapidaire Saint-Pierre,2001,RHONE-ALPES,VIENNE,3833,1374,5207,
Musée des Beaux-Arts et d'Archéologie,2001,RHONE-ALPES,VIENNE,1791,892,2683,
Musée Départemental de la Révolution Française,2001,RHONE-ALPES,VIZILLE,36584,0,36584,
Musée Hospitalier,2001,RHONE-ALPES,CHARLIEU,4562,881,5443,
Musée d'Histoire du  20ème Siècle - Résistance et Déportation,2001,RHONE-ALPES,ESTIVAREILLES,3707,1060,4767,
Musée d'Allard,2001,RHONE-ALPES,MONTBRISON,5201,2140,7341,
Musée de la Mine / Site Couriot,2001,RHONE-ALPES,SAINT-ETIENNE,35681,18815,54496,
Musée des Civilisations : Daniel Pouget,2001,RHONE-ALPES,SAINT-JUST-SAINT-RAMBERT,8325,0,8325,
Musée Rural,2001,RHONE-ALPES,USSON-EN-FOREZ,7958,1596,9554,
Musée Folklorique et Traditions Populaires Marius Audin,2001,RHONE-ALPES,BEAUJEU,6278,728,7006,
Musée des Hospices Civils de Lyon,2001,RHONE-ALPES,LYON,7630,1867,9497,
Muséum d'Histoire Naturelle,2001,RHONE-ALPES,LYON,58652,84400,143052,
Musée de la Poterie,2002,ALSACE,BETSCHDORF,4007,1216,5223,
Musée de Bouxwiller et du pays de hanau,2002,ALSACE,BOUXWILLER,2623,793,3416,
Musée des Arts Décoratifs,2002,ALSACE,STRASBOURG,22363,27047,49410,
Musée Westercamp,2002,ALSACE,WISSEMBOURG,2880,1200,4080,
Musée Sundgauvien d'Altkirch,2002,ALSACE,ALTKIRCH,1172,987,2159,
Musée Gallo-Romain,2002,ALSACE,BIESHEIM,1073,2981,4054,
Musée Bartholdi,2002,ALSACE,COLMAR,7337,3155,10492,
Musée d'Histoire Local,2002,ALSACE,KAYSERSBERG,400,200,600,
Musée des Beaux-Arts,2002,ALSACE,MULHOUSE,0,8947,8947,
Musée des Amis de Thann,2002,ALSACE,THANN,887,276,1163,
Château de Bourdeilles,2002,AQUITAINE,BOURDEILLES,30343,0,30343,
Musée des Arts et Traditions Populaires du Périgord,2002,AQUITAINE,MUSSIDAN,1704,1031,2735,
Musée d'Art et Traditions Populaires,2002,AQUITAINE,VILLEFRANCHE-DE-LONCHAT,0,1500,1500,
Musée d'Aquitaine,2002,AQUITAINE,BORDEAUX,24055,55169,79224,
CAPC Musée d'Art Contemporain de Bordeaux,2002,AQUITAINE,BORDEAUX,15747,70343,86090,
Centre National Jean Moulin,2002,AQUITAINE,BORDEAUX,0,22714,22714,
Musée de la Faïence et des arts de la table,2002,AQUITAINE,SAMADET,5621,2765,8386,
Musée Bonnat,2002,AQUITAINE,BAYONNE,16023,16307,32330,
Musée Basque et de l'Histoire de Bayonne,2002,AQUITAINE,BAYONNE,32242,21503,53745,
Musée d'Art et d'Archéologie,2002,AUVERGNE,AURILLAC,910,17890,18800,
Musée des Manufactures de Dentelles,2002,AUVERGNE,RETOURNAC,3766,0,3766,
Musée des Peintres de l'Ecole de Murols,2002,AUVERGNE,MUROL,3970,250,4220,
Musée Régional d'Auvergne,2002,AUVERGNE,RIOM,990,2240,3230,
Musée Alésia - Centre d'Interprétation,2002,BOURGOGNE,ALISE-SAINTE-REINE,15898,2026,17924,
Musée Bonaparte,2002,BOURGOGNE,AUXONNE,0,2372,2372,
Musée E.J Marey,2002,BOURGOGNE,BEAUNE,3804,662,4466,
Musée François Rude,2002,BOURGOGNE,DIJON,0,30181,30181,
Musée Magnin,2002,BOURGOGNE,DIJON,10598,9096,19694,
Musée des Beaux-Arts,2002,BOURGOGNE,DIJON,48434,99398,147832,
Musée Noisot,2002,BOURGOGNE,FIXIN,431,1269,1700,
Musée Municipal,2002,BOURGOGNE,NUITS-SAINT-GEORGES,641,2044,2685,
Musée du Costume,2002,BOURGOGNE,CHATEAU-CHINON,5084,794,5878,
Musée d'Art et d'Histoire Romain Rolland,2002,BOURGOGNE,CLAMECY,0,1172,1172,
Musée d'Art et d'Archéologie,2002,BOURGOGNE,CLUNY,86123,22694,108817,
Musée Lamartine,2002,BOURGOGNE,MACON,1627,1984,3611,
Musée Eucharistique du Hiéron,2002,BOURGOGNE,PARAY-LE-MONIAL,1352,0,1352,
Musée Départemental du Compagnonnage,2002,BOURGOGNE,ROMANECHE-THORINS,1908,2506,4414,
Musée Bourguignon -  Perrin de Puycousin,2002,BOURGOGNE,TOURNUS,1284,1128,2412,
Musée National de la Marine,2002,BRETAGNE,BREST,58863,0,58863,
Le Port-Musée,2002,BRETAGNE,DOUARNENEZ,32880,3842,36722,
Musée des Phares et Balises,2002,BRETAGNE,OUESSANT,19575,0,19575,
Musée de la Faucillonnaie,2002,BRETAGNE,MONTREUIL-SOUS-PEROUSE,2215,768,2983,
Musée Saint-Nicolas,2002,BRETAGNE,VITRE,2837,860,3697,
Musée de la Résistance Bretonne,2002,BRETAGNE,SAINT-MARCEL - MALESTROIT,39399,5984,45383,
"La Cohue, Musée des Beaux-Arts de vannes",2002,BRETAGNE,VANNES,16973,9858,26831,
Musée des Arts Décoratifs,2002,CENTRE,BOURGES,0,16466,16466,
Musée des Meilleurs Ouvriers de France,2002,CENTRE,BOURGES,0,25936,25936,
Musée des Beaux-Arts,2002,CENTRE,CHARTRES,9003,11351,20354,
Musée Marcel Proust,2002,CENTRE,ILLIERS-COMBRAY,4346,0,4346,
Musée de l'Hôtel des Communes,2002,CENTRE,AMBOISE,0,3108,3108,
Musée Lansyer,2002,CENTRE,LOCHES,2101,0,2101,
Musée du Savignéen,2002,CENTRE,SAVIGNE-SUR-LATHAN,1780,0,1780,
Musée de l'Hôtel Goüin,2002,CENTRE,TOURS,5579,5070,10649,
Château Musées de Blois,2002,CENTRE,BLOIS,297879,0,297879,
Musée de Vendôme,2002,CENTRE,VENDOME,1720,8967,10687,
Musée Gaston Couté,2002,CENTRE,MEUNG-SUR-LOIRE,174,207,381,
Musée des Sciences Naturelles,2002,CENTRE,ORLEANS,65050,0,65050,
Musée de la Résistance,2002,CHAMPAGNE-ARDENNES,MUSSY-SUR-SEINE,50,64,114,
Musée Paul Dubois - Alfred Boucher,2002,CHAMPAGNE-ARDENNES,NOGENT-SUR-SEINE,0,5406,5406,
Ecomusée de la Montagne de Reims,2002,CHAMPAGNE-ARDENNES,POURCY,1872,0,1872,
Musée des Beaux-Arts de Saint-Denis,2002,CHAMPAGNE-ARDENNES,REIMS,10470,24432,34902,
Musée Départemental Albert-et-Félicie Demard - ATP,2002,FRANCHE-COMTE,CHAMPLITTE,20306,0,20306,
Ecomusée du Pays de la Cerise,2002,FRANCHE-COMTE,FOUGEROLLES,6880,250,7130,
Musée Intercommunal d'Etampes,2002,ILE-DE-FRANCE,ETAMPES,662,4444,5106,
Musée d'Art et d'Histoire,2002,ILE-DE-FRANCE,MEUDON,926,6786,7712,
Musée national de céramique de Sèvres,2002,ILE-DE-FRANCE,SEVRES,16842,9996,26838,
Musée National de la Marine,2002,ILE-DE-FRANCE,PARIS,305904,0,305904,
Musée de la Vie Romantique,2002,ILE-DE-FRANCE,PARIS,27729,24401,52130,
Musée National Auguste Rodin,2002,ILE-DE-FRANCE,PARIS,329577,229359,558936,
Musée de la Chasse et de la Nature,2002,ILE-DE-FRANCE,PARIS,8033,0,8033,
Musée d'Art et d'Histoire de Melun,2002,ILE-DE-FRANCE,MELUN,3863,4033,7896,
Musée de Provins et du Provinois,2002,ILE-DE-FRANCE,PROVINS,19269,1346,20615,
Musée jean-Jacques Rousseau,2002,ILE-DE-FRANCE,MONTMORENCY,1623,1454,3077,
Musée des Beaux-Arts,2002,LANGUEDOC-ROUSSILLON,CARCASSONNE,0,29178,29178,
Musée Archéologique,2002,LANGUEDOC-ROUSSILLON,SALLELES D'AUDE,13080,0,13080,
Musée-Bibliothèque Pierre-André Benoît,2002,LANGUEDOC-ROUSSILLON,ALES,0,11466,11466,
Musée Albert André,2002,LANGUEDOC-ROUSSILLON,BAGNOLS-SUR-CEZE,1958,1103,3061,
Musée des Cultures Taurines (Annexe Musée du Vieux Nîmes),2002,LANGUEDOC-ROUSSILLON,NIMES,977,13513,14490,
Musée des Beaux-Arts,2002,LANGUEDOC-ROUSSILLON,NIMES,2465,9364,11829,
Musée Paul Raymond,2002,LANGUEDOC-ROUSSILLON,PONT-SAINT-ESPRIT,2481,0,2481,
Musée des Beaux-Arts de Béziers,2002,LANGUEDOC-ROUSSILLON,BEZIERS,11735,0,11735,
Musée du Vieux Montpellier,2002,LANGUEDOC-ROUSSILLON,MONTPELLIER,0,6054,6054,
Musée Paul Valéry,2002,LANGUEDOC-ROUSSILLON,SETE,5882,8979,14861,
Musée d'Art Moderne - Fonds Peskè,2002,LANGUEDOC-ROUSSILLON,COLLIOURE,5384,2939,8323,
Muséum d'Histoire Naturelle,2002,LANGUEDOC-ROUSSILLON,PERPIGNAN,627,7073,7700,
Musée des Monnaies et Médailles Joseph Puig,2002,LANGUEDOC-ROUSSILLON,PERPIGNAN,214,1657,1871,
Musée Départemental de la Tapisserie,2002,LIMOUSIN,AUBUSSON,19317,2669,21986,
Musée du Château de Montaigu,2002,LORRAINE,LANEUVEVILLE-DEVANT-NANCY,384,280,664,
Musée des Beaux-Arts de Nancy,2002,LORRAINE,NANCY,50232,66245,116477,
Musée d'Art et d'Histoire de Toul,2002,LORRAINE,TOUL,1573,3345,4918,
Musée Barrois,2002,LORRAINE,BAR-LE-DUC,9000,0,9000,
Musée de la Céramique et de l'Ivoire,2002,LORRAINE,COMMERCY,1333,856,2189,
Musée Jules Bastien-Lepage - Musée de la Fortification,2002,LORRAINE,MONTMEDY,21195,536,21731,
Musée Départemental du Sel,2002,LORRAINE,MARSAL,7829,1036,8865,
Moulin de la Blies - Musée des Techniques Faïencières,2002,LORRAINE,SARREGUEMINES,13859,0,13859,
Musée Départemental d'Art Ancien et Contemporain,2002,LORRAINE,EPINAL,20237,0,20237,
Musée Charles Friry,2002,LORRAINE,REMIREMONT,522,2646,3168,
Musée Charles de Bruyères,2002,LORRAINE,REMIREMONT,1570,6066,7636,
Musée Pierre Noël - Musée de la Vie dans les Hautes-Vosges,2002,LORRAINE,SAINT-DIE-DES-VOSGES,0,26295,26295,
Muséum d'Histoire Naturelle,2002,MARTINIQUE,FORT-DE-FRANCE TERRE-SAINVILLE,279,400,679,
"Musée des Mœurs et Coutumes, Musée du Rouergue",2002,MIDI-PYRENEES,ESPALION,1390,612,2002,
Musée Joseph Vaylet,2002,MIDI-PYRENEES,ESPALION,6816,2727,9543,
Musée du Vieux Toulouse,2002,MIDI-PYRENEES,TOULOUSE,3035,165,3200,
Musée Saint-Raymond,2002,MIDI-PYRENEES,TOULOUSE,58527,0,58527,
Musée de Préhistoire de Cabrerets,2002,MIDI-PYRENEES,CABRERETS,81100,600,81700,
Musée du Vieux Figeac,2002,MIDI-PYRENEES,FIGEAC,572,364,936,
Musée Municipal,2002,MIDI-PYRENEES,VAYRAC,432,63,495,
Musée Goya,2002,MIDI-PYRENEES,CASTRES,14630,9969,24599,
Musée d'Art et d'Histoire Charles Portal,2002,MIDI-PYRENEES,CORDES-SUR-CIEL,710,543,1253,
Musée des Beaux-Arts,2002,MIDI-PYRENEES,GAILLAC,4673,1174,5847,
Musée d'Histoire Naturelle Victor Brun,2002,MIDI-PYRENEES,MONTAUBAN,878,7933,8811,
Musée Départemental de Flandre,2002,NORD-PAS-DE-CALAIS,CASSEL,0,12406,12406,
Ecomusée de la Région,2002,NORD-PAS-DE-CALAIS,FOURMIES,44499,0,44499,
Musée de l'Hospice Comtesse,2002,NORD-PAS-DE-CALAIS,LILLE,28510,12578,41088,
Musée du Verre,2002,NORD-PAS-DE-CALAIS,SARS-POTERIES,8874,0,8874,
Musée des Beaux-Arts,2002,NORD-PAS-DE-CALAIS,VALENCIENNES,19851,30930,50781,
Musée d'Histoire et d'Archéologie,2002,NORD-PAS-DE-CALAIS,HARNES,0,1144,1144,
Musée de Normandie,2002,BASSE-NORMANDIE,CAEN,83068,0,83068,
Mémorial de Caen,2002,BASSE-NORMANDIE,CAEN,436800,43200,480000,
Musée Eugène Boudin,2002,BASSE-NORMANDIE,HONFLEUR,37458,0,37458,
Musée Municipal,2002,BASSE-NORMANDIE,ORBEC,0,2918,2918,
Musée des Techniques Fromagères,2002,BASSE-NORMANDIE,SAINT-PIERRE-SUR-DIVES,917,0,917,
Musée Thomas Henry,2002,BASSE-NORMANDIE,CHERBOURG-EN-COTENTIN,608,3932,4540,
Musée Christian Dior,2002,BASSE-NORMANDIE,GRANVILLE,11000,3500,14500,
Musée des Beaux-Arts,2002,BASSE-NORMANDIE,SAINT-LO,996,3701,4697,
Musée du Granit,2002,BASSE-NORMANDIE,SAINT-MICHEL-DE-MONTJOIE,1374,0,1374,
Musée Barbey d'Aurevilly,2002,BASSE-NORMANDIE,SAINT-SAUVEUR-LE-VICOMTE,1252,0,1252,
Musée Régional du Cidre et du Calvados,2002,BASSE-NORMANDIE,VALOGNES,8287,0,8287,
Musée de la Poeslerie,2002,BASSE-NORMANDIE,VILLEDIEU-LES-POELES-ROUFFIGNY,8033,0,8033,
Musée du Château de Flers,2002,BASSE-NORMANDIE,FLERS,3669,4056,7725,
Musée Artisanal et Industriel d'Instruments à Vent,2002,HAUTE-NORMANDIE,LA COUTURE-BOUSSEY,2000,500,2500,
Musée Municipal,2002,HAUTE-NORMANDIE,LOUVIERS,0,4919,4919,
Musée de la Marine de Seine,2002,HAUTE-NORMANDIE,CAUDEBEC-EN-CAUX,6094,1428,7522,
Abbaye de Graville - Musée du Prieuré de Graville,2002,HAUTE-NORMANDIE,LE HAVRE,2040,6035,8075,
Musée Départemental Pierre Corneille,2002,HAUTE-NORMANDIE,LE PETIT-COURONNE,842,1723,2565,
Musée des Traditions et Arts Normands,2002,HAUTE-NORMANDIE,MARTAINVILLE-EPREVILLE,18446,0,18446,
Musée des Sapeurs-Pompiers de France,2002,HAUTE-NORMANDIE,MONTVILLE,6797,1999,8796,
Musée des Beaux-Arts,2002,HAUTE-NORMANDIE,ROUEN,33613,38528,72141,
Musée Victor Hugo,2002,HAUTE-NORMANDIE,VILLEQUIER,15044,18574,33618,
"Musée de la Fève, Crèches et Traditions Populaires",2002,PAYS DE LA LOIRE,BLAIN,3023,605,3628,
Musée du Pays de Guérande et de la Porte Saint Michel,2002,PAYS DE LA LOIRE,GUERANDE,20945,3034,23979,
Musée du Chaume/Kerhinet - Parc Naturel Régional de Brière,2002,PAYS DE LA LOIRE,SAINT-LYPHARD,7510,1104,8614,
Muséum des Sciences Naturelles,2002,PAYS DE LA LOIRE,ANGERS,4768,12208,16976,
Galerie David d'Angers,2002,PAYS DE LA LOIRE,ANGERS,7659,12563,20222,
Musée Joseph Denais,2002,PAYS DE LA LOIRE,BEAUFORT-EN-VALLEE,1325,1476,2801,
Musée du Textile,2002,PAYS DE LA LOIRE,CHOLET,5008,5368,10376,
Musée Jules-Desbois,2002,PAYS DE LA LOIRE,PARCAY-LES-PINS,1488,1083,2571,
Musée des Tisserands Mayennais,2002,PAYS DE LA LOIRE,AMBRIERES-LES-VALLEES,467,51,518,
Familistère de Guise,2002,PICARDIE,GUISE,19765,0,19765,
Musée Antoine Lecuyer,2002,PICARDIE,SAINT-QUENTIN,3351,10403,13754,
Musée du Château de Compiègne,2002,PICARDIE,COMPIEGNE,40675,46583,87258,
Musée de la Vénerie,2002,PICARDIE,SENLIS,5527,0,5527,
Musée-Historial de la Grande Guerre,2002,PICARDIE,PERONNE,74312,5863,80175,
Musée Régional de Fouras,2002,POITOU-CHARENTES,FOURAS,4511,3642,8153,
Musée du Nouveau Monde,2002,POITOU-CHARENTES,LA ROCHELLE,10490,0,10490,
Musée d'Orbigny-Bernon,2002,POITOU-CHARENTES,LA ROCHELLE,6902,0,6902,
Musée Archéologique,2002,POITOU-CHARENTES,SAINTES,1727,36156,37883,
Collection d'Histoire Naturelle,2002,POITOU-CHARENTES,POITIERS,63197,0,63197,
Villa-Musée Jean-Honoré Fragonard,2002,PROVENCE-ALPES-CÔTE D'AZUR,GRASSE,6060,0,6060,
Musée d'Art et d'Histoire de Provence,2002,PROVENCE-ALPES-CÔTE D'AZUR,GRASSE,4649,6936,11585,
Musée Jean Cocteau Collection Séverin Wunderman,2002,PROVENCE-ALPES-CÔTE D'AZUR,MENTON,15777,0,15777,
Muséum d'Histoire Naturelle,2002,PROVENCE-ALPES-CÔTE D'AZUR,NICE,0,37296,37296,
Musée du Vieux-Logis de Nice,2002,PROVENCE-ALPES-CÔTE D'AZUR,NICE,0,630,630,
Musée du Parlement de Provence et du Vieil Aix,2002,PROVENCE-ALPES-CÔTE D'AZUR,AIX-EN-PROVENCE,9595,6510,16105,
Musée- Atelier de Paul Cézanne,2002,PROVENCE-ALPES-CÔTE D'AZUR,AIX-EN-PROVENCE,93365,0,93365,
Musée Frédéric Mistral,2002,PROVENCE-ALPES-CÔTE D'AZUR,MAILLANE,2216,879,3095,
"Musée d'Arts Africains, Océaniens, Amérindiens",2002,PROVENCE-ALPES-CÔTE D'AZUR,MARSEILLE,14000,0,14000,
Musée Grobet-Labadié,2002,PROVENCE-ALPES-CÔTE D'AZUR,MARSEILLE,2868,10119,12987,
Musée de la Mode,2002,PROVENCE-ALPES-CÔTE D'AZUR,MARSEILLE,2705,3859,6564,
Musée Archéologique Municipal,2002,PROVENCE-ALPES-CÔTE D'AZUR,FREJUS,0,18539,18539,
Musée Jean Aicard,2002,PROVENCE-ALPES-CÔTE D'AZUR,LE POUVEREL LA GARDE,0,1096,1096,
Musée Archéologique,2002,PROVENCE-ALPES-CÔTE D'AZUR,SAINT-RAPHAËL,6500,600,7100,
Musée du Vêtement Provençal (Jean Aicard),2002,PROVENCE-ALPES-CÔTE D'AZUR,SOLLIES-VILLE,0,3500,3500,
Muséum d'Histoire Naturelle de Toulon,2002,PROVENCE-ALPES-CÔTE D'AZUR,TOULON,0,20368,20368,
Musée Marc Deydier,2002,PROVENCE-ALPES-CÔTE D'AZUR,CUCURON,0,3300,3300,
Musée Municipal,2002,PROVENCE-ALPES-CÔTE D'AZUR,ORANGE,62414,0,62414,
Musée du Peigne et de la Plasturgie,2002,RHONE-ALPES,OYONNAX,3511,1522,5033,
Musée du Vieux Pérouges,2002,RHONE-ALPES,PEROUGES,16686,0,16686,
Musée Stendhal,2002,RHONE-ALPES,GRENOBLE,0,7263,7263,
Muséum d'Histoire Naturelle de Grenoble,2002,RHONE-ALPES,GRENOBLE,24202,49173,73375,
Musée d'Art Contemporain de Lyon,2002,RHONE-ALPES,LYON,20245,23785,44030,
Musée de la Chartreuse,2003,ALSACE,MOLSHEIM,2696,0,2696,
Musée de l'Image Populaire de Pfaffenhoffen,2003,ALSACE,PFAFFENHOFFEN,2388,1324,3712,
Musée d'Unterlinden,2003,ALSACE,COLMAR,183328,28894,212222,
Musée du Vignoble et des Vins d'Alsace,2003,ALSACE,KIENTZHEIM,5636,120,5756,
Musée de l'Impression sur Etoffes,2003,ALSACE,MULHOUSE,11516,16210,27726,
Ecomusée d'Alsace,2003,ALSACE,UNGERSHEIM,244302,34995,279297,
Château de Bourdeilles,2003,AQUITAINE,BOURDEILLES,26865,0,26865,
Musée d'Aquitaine,2003,AQUITAINE,BORDEAUX,34019,77900,111919,
Atelier-Musée  (Ecomusée de la Grande Landes),2003,AQUITAINE,LUXEY,7519,0,7519,
Musée de Préhistoire Mésolithique Laurent Coulonges,2003,AQUITAINE,SAUVETERRE-LA-LEMANCE,1999,679,2678,
Musée Rural de la Sologne Bourbonnaise,2003,AUVERGNE,BEAULON,138,30,168,
Musée Anne de Beaujeu,2003,AUVERGNE,MOULINS,4327,1198,5525,
Musée des Sciences,2003,AUVERGNE,AURILLAC,7118,8394,15512,
Ecomusée de Margeride-Haute-Auvergne,2003,AUVERGNE,RUYNES-EN-MARGERIDE,15348,808,16156,
Musée d'art et d'histoire Alfred Douët,2003,AUVERGNE,SAINT-FLOUR,1600,1827,3427,
Musée Crozatier,2003,AUVERGNE,LE PUY-EN-VELAY,11847,14700,26547,
Musée des Manufactures de Dentelles,2003,AUVERGNE,RETOURNAC,2670,1069,3739,
Musée de la Dentelle,2003,AUVERGNE,ARLANC,2148,196,2344,
Musée d'Art Roger-Quillot,2003,AUVERGNE,CLERMONT-FERRAND,7777,29272,37049,
Musée Régional d'Auvergne,2003,AUVERGNE,RIOM,2194,706,2900,
Musée E.J Marey,2003,BOURGOGNE,BEAUNE,2635,1099,3734,
Musée Magnin,2003,BOURGOGNE,DIJON,3809,6172,9981,
Musée des Beaux-Arts,2003,BOURGOGNE,DIJON,51591,103508,155099,
Musée des Beaux-Arts,2003,BOURGOGNE,MONTBARD,197,90,287,
Musée d'Art et d'Histoire Romain Rolland,2003,BOURGOGNE,CLAMECY,1570,2491,4061,
Musée Municipal,2003,BOURGOGNE,LA CHARITE-SUR-LOIRE,633,4023,4656,
Musée du Grès de Puisaye,2003,BOURGOGNE,SAINT-AMAND-EN-PUISAYE,2388,566,2954,
Musée Rolin,2003,BOURGOGNE,AUTUN,16932,4595,21527,
Museum d'Histoire Naturelle Jacques de La Comble,2003,BOURGOGNE,AUTUN,593,2789,3382,
Musée Denon,2003,BOURGOGNE,CHALON-SUR-SAONE,988,10329,11317,
"L'Atelier d'un Journal"" de Louhans - Musée Municipal",2003,BOURGOGNE,LOUHANS,2494,409,2903,
Muséum - Maison de l'Eau,2003,BOURGOGNE,AUXERRE,451,15040,15491,
Musée Muncipal,2003,BOURGOGNE,SENS,8997,8357,17354,
Musée des Beaux-Arts de Brest,2003,BRETAGNE,BREST,1294,10438,11732,
Ecomusée d'Ouessant - Vivre sur une Ile,2003,BRETAGNE,OUESSANT,14374,0,14374,
Musée de Pont-Aven,2003,BRETAGNE,PONT-AVEN,108110,5031,113141,
Musée Départemental Breton,2003,BRETAGNE,QUIMPER,24650,17511,42161,
Musée de l'Ecole Rurale en Bretagne,2003,BRETAGNE,TREGARVAN,11890,1306,13196,
Musée Saint-Nicolas,2003,BRETAGNE,VITRE,2668,720,3388,
Musée du Château de Vitré,2003,BRETAGNE,VITRE,22739,5633,28372,
Musée de la Compagnie des Indes,2003,BRETAGNE,PORT-LOUIS,41336,19192,60528,
Musée National de la Marine,2003,BRETAGNE,PORT-LOUIS,41337,19191,60528,
Musée d'Histoire et d'Archéologie de Vannes,2003,BRETAGNE,VANNES,3975,1660,5635,
"La Cohue, Musée des Beaux-Arts de vannes",2003,BRETAGNE,VANNES,19168,10440,29608,
Musée Estève,2003,CENTRE,BOURGES,0,15720,15720,
Château Musée,2003,CENTRE,AZAY-LE-FERRON,1949,0,1949,
Musée de l'Hôtel des Communes,2003,CENTRE,AMBOISE,0,2732,2732,
Musée de l'Hôtel de Ville,2003,CENTRE,RICHELIEU,685,258,943,
Musée Municipal,2003,CENTRE,SAINTE-MAURE-DE-TOURAINE,716,244,960,
Musée de Minerve,2003,CENTRE,YZEURES-SUR-CREUSE,0,2367,2367,
Musée de la Corbillière,2003,CENTRE,MER,519,880,1399,
Musée Municipal Théâtre Forain et Archéologique,2003,CENTRE,ARTENAY,3527,2402,5929,
Musée d'Art et d'Archéologie,2003,CENTRE,CHATILLON-COLIGNY,421,789,1210,
Musée Municipal,2003,CENTRE,PITHIVIERS,0,1700,1700,
Musée du Feutre,2003,CHAMPAGNE-ARDENNES,MOUZON,4349,1663,6012,
Musée de l'Affiche,2003,CHAMPAGNE-ARDENNES,CHAUMONT,0,10000,10000,
Musée de la Coutellerie,2003,CHAMPAGNE-ARDENNES,NOGENT,4965,863,5828,
Musée Garinet,2003,CHAMPAGNE-ARDENNES,CHALONS-EN-CHAMPAGNE,271,816,1087,
Musée de la Maison Bonaparte,2003,CORSE,AJACCIO,43317,23073,66390,
Ecomusée du Pays de la Cerise,2003,FRANCHE-COMTE,FOUGEROLLES,6909,0,6909,
Musée Départemental de la Montagne Albert Demard,2003,FRANCHE-COMTE,LE HAUT-DU-THEM,5520,4330,9850,
Musée de la Tour des Echevins,2003,FRANCHE-COMTE,LUXEUIL-LES-BAINS,1950,479,2429,
Musée des Beaux-Arts,2003,FRANCHE-COMTE,DOLE,0,17401,17401,
Musée d'Archéologie,2003,FRANCHE-COMTE,LONS-LE-SAUNIER,9729,0,9729,
Musée des Salines,2003,FRANCHE-COMTE,SALINS-LES-BAINS,54299,0,54299,
Musée d'Art et d'Histoire,2003,FRANCHE-COMTE,BELFORT,11497,0,11497,
Forge-Musée,2003,FRANCHE-COMTE,ETUEFFONT,1293,456,1749,
Musée Municipal Robert Dubois-Corneau,2003,ILE-DE-FRANCE,BRUNOY,340,1796,2136,
Musée Intercommunal d'Etampes,2003,ILE-DE-FRANCE,ETAMPES,381,4819,5200,
Musée d'Art et d'Histoire,2003,ILE-DE-FRANCE,MEUDON,988,6749,7737,
Musée National des Châteaux de Malmaison et de Bois-Préau,2003,ILE-DE-FRANCE,RUEIL-MALMAISON,40241,25705,65946,
Musée René Sordes,2003,ILE-DE-FRANCE,SURESNES,0,2310,2310,
Galerie d'Anatomie Comparée et de Paléontologie (Muséum d'Histoire Naturelle),2003,ILE-DE-FRANCE,PARIS,146371,54815,201186,
Galerie de Minéralogie et de Géologie (Muséum d'Histoire Naturelle),2003,ILE-DE-FRANCE,PARIS,26978,5713,32691,
Musée de la Franc-Maçonnerie,2003,ILE-DE-FRANCE,PARIS,8000,1000,9000,
Musée des Arts Asiatiques Guimet,2003,ILE-DE-FRANCE,PARIS,192871,119028,311899,
Musée Nissim de Camondo (Les Arts Décoratifs),2003,ILE-DE-FRANCE,PARIS,31319,7541,38860,
Musée Hébert,2003,ILE-DE-FRANCE,PARIS,1757,2259,4016,
Musée du Louvre,2003,ILE-DE-FRANCE,PARIS,3782240,1944400,5726640,
Musée d'Art et d'Histoire du Judaïsme,2003,ILE-DE-FRANCE,PARIS,44796,16141,60937,
Musée des Monnaies et des Médailles,2003,ILE-DE-FRANCE,PARIS,31473,3700,35173,
Musée Bouchard,2003,ILE-DE-FRANCE,PARIS,1506,574,2080,
Maison Natale de Louis Braille,2003,ILE-DE-FRANCE,COUPVRAY,2176,1389,3565,
Musée de Provins et du Provinois,2003,ILE-DE-FRANCE,PROVINS,15687,1893,17580,
Musée du Vieil Argenteuil,2003,ILE-DE-FRANCE,ARGENTEUIL,361,993,1354,
Musée Archéologique du Val d'Oise,2003,ILE-DE-FRANCE,GUIRY-EN-VEXIN,10826,3645,14471,
Musée jean-Jacques Rousseau,2003,ILE-DE-FRANCE,MONTMORENCY,1097,782,1879,
Musée National de Port Royal des Champs,2003,ILE-DE-FRANCE,MAGNY-LES-HAMEAUX,4961,7891,12852,
Musée d'Archéologie Nationale (des origines à l'an mille) - Château de st-Germain-en-Laye,2003,ILE-DE-FRANCE,SAINT-GERMAIN-EN-LAYE,20467,41292,61759,
Etablissement Public du Musée et du Domaine National de Versailles,2003,ILE-DE-FRANCE,VERSAILLES,3183755,741031,3924786,
Muséum Agricole et Industriel Stella Matutina,2003,LA REUNION,PITON-SAINT-LEU,48401,5021,53422,
Musée Petiet,2003,LANGUEDOC-ROUSSILLON,LIMOUX,894,1509,2403,
Musée des Corbières,2003,LANGUEDOC-ROUSSILLON,SIGEAN,73,1085,1158,
Musée Municipal de la Vignasse,2003,LANGUEDOC-ROUSSILLON,BEAUCAIRE,632,3743,4375,
Musée du Vieux Nîmes,2003,LANGUEDOC-ROUSSILLON,NIMES,0,8849,8849,
Musée Paul Raymond,2003,LANGUEDOC-ROUSSILLON,PONT-SAINT-ESPRIT,346,536,882,
Musée Pierre de Luxembourg,2003,LANGUEDOC-ROUSSILLON,VILLENEUVE-LES-AVIGNON,4801,2803,7604,
Musée Municipal,2003,LANGUEDOC-ROUSSILLON,FRONTIGNAN-LA-PEYRADE,0,8673,8673,
Musée Fleury,2003,LANGUEDOC-ROUSSILLON,LODEVE,36345,6927,43272,
Musée Paul Valéry,2003,LANGUEDOC-ROUSSILLON,SETE,6825,11767,18592,
Ecomusée du Mont Lozère,2003,LANGUEDOC-ROUSSILLON,LE PONT DE MONTVERT,3230,1960,5190,
Musée des Monnaies et Médailles Joseph Puig,2003,LANGUEDOC-ROUSSILLON,PERPIGNAN,156,1011,1167,
Musée de Cerdagne,2003,LANGUEDOC-ROUSSILLON,SAINTE-LEOCADIE,2663,1285,3948,
Musée du Président Jacques Chirac,2003,LIMOUSIN,SARRAN,32857,3112,35969,
Musée Municipal des Emaux et Faïences,2003,LORRAINE,LONGWY,4921,2061,6982,
Musée d'Art Sacré de la Meuse,2003,LORRAINE,SAINT-MIHIEL,1936,1450,3386,
Musée de la Mine - Carreau Wendel,2003,LORRAINE,PETITE-ROSSELLE,3364,866,4230,
La Tour aux Puces - Musée du Pays Thionvillois,2003,LORRAINE,THIONVILLE Cedex,2947,6911,9858,
Musée Pierre Noël - Musée de la Vie dans les Hautes-Vosges,2003,LORRAINE,SAINT-DIE-DES-VOSGES,74341,13995,88336,
Muséum d'Histoire Naturelle,2003,MARTINIQUE,FORT-DE-FRANCE TERRE-SAINVILLE,97,85,182,
Musée de la Préhistoire,2003,MIDI-PYRENEES,LE MAS D'AZIL,14761,0,14761,
"Musée des Mœurs et Coutumes, Musée du Rouergue",2003,MIDI-PYRENEES,ESPALION,1064,319,1383,
Musée Fenaille,2003,MIDI-PYRENEES,RODEZ,10226,10910,21136,
Musée du Charroi Rural et de l'Artisanat Traditionnel,2003,MIDI-PYRENEES,SALMIECH,940,1470,2410,
Musée des Jacobins,2003,MIDI-PYRENEES,AUCH,4500,5000,9500,
Musée Municipal,2003,MIDI-PYRENEES,MARTRES-TOLOSANE,0,445,445,
Musée Municipal d'Art et d'Histoire,2003,MIDI-PYRENEES,SAINT-GAUDENS,438,1325,1763,
Musée Paul Dupuy,2003,MIDI-PYRENEES,TOULOUSE,5668,6177,11845,
Musée Pyrénéen,2003,MIDI-PYRENEES,LOURDES,57795,3692,61487,
Musée de Préhistoire Amédée Lémozi,2003,MIDI-PYRENEES,CABRERETS,80380,0,80380,
Musée du Vieil Auvillar,2003,MIDI-PYRENEES,AUVILLAR,2090,516,2606,
Musée de Préhistoire,2003,MIDI-PYRENEES,SAINT-ANTONIN-NOBLE-VAL,1300,0,1300,
Musée Benoît de Puydt,2003,NORD-PAS-DE-CALAIS,BAILLEUL,2006,1992,3998,
Musée Municipal d'Escaudain,2003,NORD-PAS-DE-CALAIS,ESCAUDAIN,0,1000,1000,
Musée des Beaux-Arts,2003,NORD-PAS-DE-CALAIS,ROUBAIX,78691,66494,145185,
Musée Municipal,2003,NORD-PAS-DE-CALAIS,SAINT-AMAND-LES-EAUX,2292,2989,5281,
Musée Eugène Boudin,2003,BASSE-NORMANDIE,HONFLEUR,37812,4196,42008,
Musée de Trouville - Villa Montebello,2003,BASSE-NORMANDIE,TROUVILLE-SUR-MER,9032,0,9032,
Musée paléontologique,2003,BASSE-NORMANDIE,VILLERS-SUR-MER,0,16500,16500,
Musée Municipal d'Avranches,2003,BASSE-NORMANDIE,AVRANCHES,4150,522,4672,
Musée de la Pomme et de la Poire,2003,BASSE-NORMANDIE,BARENTON,2255,675,2930,
Musée Thomas Henry,2003,BASSE-NORMANDIE,CHERBOURG-EN-COTENTIN,0,18300,18300,
Musée Quesnel-Morinière,2003,BASSE-NORMANDIE,COUTANCES,4724,0,4724,
Musée Richard Anacréon,2003,BASSE-NORMANDIE,GRANVILLE,7023,4968,11991,
Musée du Vieux Granville,2003,BASSE-NORMANDIE,GRANVILLE,7738,3910,11648,
Musée du Granit,2003,BASSE-NORMANDIE,SAINT-MICHEL-DE-MONTJOIE,1002,71,1073,
Musée Maritime de l'Ile de Tatihou,2003,BASSE-NORMANDIE,SAINT-VAAST-LA-HOUGUE,49664,0,49664,
Musée du Château,2003,BASSE-NORMANDIE,TORIGNI-SUR-VIRE,178,200,378,
Musée de la Poeslerie,2003,BASSE-NORMANDIE,VILLEDIEU-LES-POELES-ROUFFIGNY,8774,517,9291,
Musée Municipal Nicolas Poussin,2003,HAUTE-NORMANDIE,LES ANDELYS,651,597,1248,
Musée d'Elbeuf,2003,HAUTE-NORMANDIE,ELBEUF,0,8247,8247,
Musée des Terres-Neuvas et de la Pêche,2003,HAUTE-NORMANDIE,FECAMP,17500,24963,42463,
Musée Départemental Pierre Corneille,2003,HAUTE-NORMANDIE,LE PETIT-COURONNE,939,2073,3012,
"Juliobona, Musée Gallo-Romain de Lillebonne",2003,HAUTE-NORMANDIE,LILLEBONNE,822,890,1712,
Musée Industriel de la Corderie Vallois,2003,HAUTE-NORMANDIE,NOTRE-DAME-DE-BONDEVILLE,3899,8393,12292,
Musée de la Céramique,2003,HAUTE-NORMANDIE,ROUEN,4705,6364,11069,
Musée du Vignoble Nantais,2003,PAYS DE LA LOIRE,LE PALLET,3560,831,4391,
Muséum d'Histoire Naturelle de Nantes,2003,PAYS DE LA LOIRE,NANTES,14186,45453,59639,
Musée  Départemental Dobrée,2003,PAYS DE LA LOIRE,NANTES,5336,19700,25036,
Ecomusée de Saint-Nazaire,2003,PAYS DE LA LOIRE,SAINT-NAZAIRE,0,125141,125141,
Muséum d'Histoire Naturelle,2003,PAYS DE LA LOIRE,ANGERS,4597,10638,15235,
Musée Jean Lurcat et de la Tapisserie Contemporaine,2003,PAYS DE LA LOIRE,ANGERS,14714,42609,57323,
Musée Jules-Desbois,2003,PAYS DE LA LOIRE,PARCAY-LES-PINS,1338,969,2307,
Château-Musée,2003,PAYS DE LA LOIRE,SAUMUR,69217,17288,86505,
Musée des Sciences - CCSTI,2003,PAYS DE LA LOIRE,LAVAL,2371,7153,9524,
Musée de Tessé,2003,PAYS DE LA LOIRE,LE MANS,23212,0,23212,
Musée Vendéen,2003,PAYS DE LA LOIRE,FONTENAY-LE-COMTE,2276,4756,7032,
Musée Municipal,2003,PAYS DE LA LOIRE,LA ROCHE-SUR-YON,0,7889,7889,
Musée du Château,2003,PAYS DE LA LOIRE,NOIRMOUTIER-EN-L'ILE,41118,3602,44720,
Familistère de Guise,2003,PICARDIE,GUISE,20052,0,20052,
Musée Monseigneur Pigneau de Behaine,2003,PICARDIE,ORIGNY-EN-THIERACHE,0,250,250,
Musée Municipal de Soissons,2003,PICARDIE,SOISSONS,0,23771,23771,
Musée de la Résistance et de la Déportation,2003,PICARDIE,TERGNIER,3030,2600,5630,
Musée de La Thiérache,2003,PICARDIE,VERVINS,0,6000,6000,
Musée Jean Calvin,2003,PICARDIE,NOYON,1642,1448,3090,
Musée Alfred Danicourt,2003,PICARDIE,PERONNE,0,1600,1600,
Atelier - Musée du Papier,2003,POITOU-CHARENTES,ANGOULEME,0,10396,10396,
Cité International de la Bande Dessinée et de l'Image - Musée de la Bande Dessinée,2003,POITOU-CHARENTES,ANGOULEME,47641,0,47641,
Musée Municipal de Cognac,2003,POITOU-CHARENTES,COGNAC,2162,9565,11727,
Musée Régional de Fouras,2003,POITOU-CHARENTES,FOURAS,10000,0,10000,
Musée Cappon,2003,POITOU-CHARENTES,MARANS,90,15,105,
Musée d'Art et d'Histoire Georges Turpin,2003,POITOU-CHARENTES,PARTHENAY,0,6500,6500,
Musée Henri Barré,2003,POITOU-CHARENTES,THOUARS,315,700,1015,
Musée Municipal,2003,PROVENCE-ALPES-CÔTE D'AZUR,FORCALQUIER,111,170,281,
Musée départemental de préhistoire,2003,PROVENCE-ALPES-CÔTE D'AZUR,QUINSON,60000,11813,71813,
Musée d'Histoire et d'Archéologie,2003,PROVENCE-ALPES-CÔTE D'AZUR,ANTIBES,3842,4677,8519,
Musée de la Castre,2003,PROVENCE-ALPES-CÔTE D'AZUR,CANNES,9698,12290,21988,
Musée de la Mer,2003,PROVENCE-ALPES-CÔTE D'AZUR,CANNES,15684,19945,35629,
Musée de Préhistoire Régionale,2003,PROVENCE-ALPES-CÔTE D'AZUR,MENTON,0,12278,12278,
Musée Départemental des Arts Asiatiques,2003,PROVENCE-ALPES-CÔTE D'AZUR,NICE,15741,15375,31116,
Muséum d'Histoire Naturelle,2003,PROVENCE-ALPES-CÔTE D'AZUR,NICE,0,42935,42935,
Musée du Palais Lascaris,2003,PROVENCE-ALPES-CÔTE D'AZUR,NICE,0,55483,55483,
Ecomusée du Pays de la Roudoule,2003,PROVENCE-ALPES-CÔTE D'AZUR,PUGET-ROSTANG,2718,4789,7507,
"Musée Magnelli, Musée de la Céramique",2003,PROVENCE-ALPES-CÔTE D'AZUR,VALLAURIS,22007,7080,29087,
Musée- Atelier de Paul Cézanne,2003,PROVENCE-ALPES-CÔTE D'AZUR,AIX-EN-PROVENCE,60202,13666,73868,
Musée des Docks Romains,2003,PROVENCE-ALPES-CÔTE D'AZUR,MARSEILLE,2284,4888,7172,
Musée d'Histoire de Marseille,2003,PROVENCE-ALPES-CÔTE D'AZUR,MARSEILLE,43824,0,43824,
Musée Municipal Paul Lafran,2003,PROVENCE-ALPES-CÔTE D'AZUR,SAINT-CHAMAS,0,3100,3100,
Musée Archéologique Municipal,2003,PROVENCE-ALPES-CÔTE D'AZUR,FREJUS,0,17659,17659,
Musée Archéologique,2003,PROVENCE-ALPES-CÔTE D'AZUR,SAINT-RAPHAËL,0,4000,4000,
Musée de l'Annonciade,2003,PROVENCE-ALPES-CÔTE D'AZUR,SAINT-TROPEZ,40687,5287,45974,
Musée du Petit Palais,2003,PROVENCE-ALPES-CÔTE D'AZUR,AVIGNON,20304,12812,33116,
Musée Marc Deydier,2003,PROVENCE-ALPES-CÔTE D'AZUR,CUCURON,0,4350,4350,
Musée Archéologique Théo Desplans,2003,PROVENCE-ALPES-CÔTE D'AZUR,VAISON-LA-ROMAINE,70952,750,71702,
Musée Départemental du Cartonnage et de l'Imprimerie,2003,PROVENCE-ALPES-CÔTE D'AZUR,VALREAS,1960,1935,3895,
Musée du Bugey-Valmorey,2003,RHONE-ALPES,LOCHIEU,5021,0,5021,
Musée du Peigne et de la Plasturgie,2003,RHONE-ALPES,OYONNAX,2404,995,3399,
Musée de la Bresse - Domaine des Planons,2003,RHONE-ALPES,SAINT-CYR-SUR-MENTHON,11110,4973,16083,
Musée Départemental du Revermont,2003,RHONE-ALPES,VAL-REVERMONT,5520,14672,20192,
Cité de Préhistoire,2003,RHONE-ALPES,ORGNAC-L'AVEN,135683,0,135683,
Musée de la terre ardéchoise,2003,RHONE-ALPES,PRIVAS,150,60,210,
Château de Grignan,2003,RHONE-ALPES,GRIGNAN,121604,4938,126542,
Musée du Château des Adhémars,2003,RHONE-ALPES,MONTELIMAR,8095,1075,9170,
Musée de Bourgoin-Jallieu,2003,RHONE-ALPES,BOURGOIN-JALLIEU,4370,3233,7603,
Musée Archéologique Grenoble Saint-Laurent,2003,RHONE-ALPES,GRENOBLE,6143,1026,7169,
Musée de la Résistance de la Déportation de l'Isère,2003,RHONE-ALPES,GRENOBLE,1983,18028,20011,
Musée de Grenoble,2003,RHONE-ALPES,GRENOBLE,71792,93385,165177,
Musée de la Soierie,2003,RHONE-ALPES,CHARLIEU,7429,2061,9490,
Atelier - Musée du Chapeau,2003,RHONE-ALPES,CHAZELLES-SUR-LYON,15387,3203,18590,
Centre d'Histoire de la Résistance et de la Déportation,2003,RHONE-ALPES,LYON,14884,43593,58477,
Musée Paul Dini,2003,RHONE-ALPES,VILLEFRANCHE-SUR-SAONE,4401,6728,11129,
Musée archéologique et minéralogique Pierre Borrione,2003,RHONE-ALPES,AIME-EN-TARENTAISE,1497,0,1497,
Maison de l'Archéologie des Vosges du Nord,2004,ALSACE,NIEDERBRONN-LES-BAINS,1150,326,1476,
Musée du Fer,2004,ALSACE,REICHSHOFFEN,1172,253,1425,
Musée des Beaux-Arts,2004,ALSACE,MULHOUSE,0,12891,12891,
Musée National de l'Automobile - Collection Schlumpf,2004,ALSACE,MULHOUSE,182427,21107,203534,
Musée Minéralogique de la Société Industrielle de Mulhouse,2004,ALSACE,MULHOUSE,0,500,500,
Musée National de la Préhistoire,2004,AQUITAINE,LES EYZIES-DE-TAYAC,52935,31252,84187,
Musée des Beaux-Arts et d'Archéologie,2004,AQUITAINE,LIBOURNE,0,3675,3675,
Musée Bonnat,2004,AQUITAINE,BAYONNE,13949,17331,31280,
Musée Rieckotter,2004,AUVERGNE,NERIS-LES-BAINS,784,899,1683,
Ecomusée de Margeride-Haute-Auvergne,2004,AUVERGNE,RUYNES-EN-MARGERIDE,15604,3629,19233,
Musée de Paléontologie,2004,AUVERGNE,CHILHAC,2702,0,2702,
Musée d'Art Roger-Quillot,2004,AUVERGNE,CLERMONT-FERRAND,5280,21233,26513,
Musée des Pénitents Blancs,2004,AUVERGNE,MARSAC-EN-LIVRADOIS,252,0,252,
Musée Francisque Mandet,2004,AUVERGNE,RIOM,10732,3965,14697,
Musée du Vin de Bourgogne,2004,BOURGOGNE,BEAUNE,24718,3814,28532,
Musée François Rude,2004,BOURGOGNE,DIJON,0,29035,29035,
Musée Municipal François Pompon,2004,BOURGOGNE,SAULIEU,2662,710,3372,
Musée du Costume,2004,BOURGOGNE,CHATEAU-CHINON,6855,818,7673,
Musée de la Mine,2004,BOURGOGNE,BLANZY,10801,2749,13550,
Musée Saint-Nazaire,2004,BOURGOGNE,BOURBON-LANCY,0,6730,6730,
Musée Nicéphore Niepce,2004,BOURGOGNE,CHALON-SUR-SAONE,5764,12406,18170,
Muséum - Maison de l'Eau,2004,BOURGOGNE,AUXERRE,0,17210,17210,
Musée des Arts Naïfs et Populaires de Noyers sur Serein,2004,BOURGOGNE,NOYERS-SUR-SEREIN,1688,913,2601,
Musée Mathurin Meheut,2004,BRETAGNE,LAMBALLE,4871,308,5179,
Musée des Beaux-Arts de Brest,2004,BRETAGNE,BREST,3066,16016,19082,
Ecomusée des Monts d'Arrée - Moulins de Kerouat & Maison Cornec de Rivoal,2004,BRETAGNE,COMMANA,21711,8194,29905,
Musée de la Pêche,2004,BRETAGNE,CONCARNEAU,42563,3948,46511,
Musée du Château de Vitré,2004,BRETAGNE,VITRE,24938,5487,30425,
Musée de Préhistoire J. Miln- Z. Le-Rouzic,2004,BRETAGNE,CARNAC,28522,4977,33499,
Musée du Berry,2004,CENTRE,BOURGES,0,17912,17912,
Musée Emile Chénon,2004,CENTRE,CHATEAUMEILLANT,735,339,1074,
Musée Saint-Vic,2004,CENTRE,SAINT-AMAND-MONTROND,5346,261,5607,
Muséum des Sciences Naturelles et de Préhistoire,2004,CENTRE,CHARTRES,0,11748,11748,
Château Musée,2004,CENTRE,AZAY-LE-FERRON,8144,0,8144,
Musée George Sand et de la Vallée Noire,2004,CENTRE,LA CHATRE,9585,2874,12459,
Musée du Savignéen,2004,CENTRE,SAVIGNE-SUR-LATHAN,1264,0,1264,
Musée François Rabelais,2004,CENTRE,SEUILLY,13057,0,13057,
Château-Musée de Gien,2004,CENTRE,GIEN,19050,3902,22952,
Musée du Gatinais,2004,CENTRE,MONTARGIS,162,370,532,
Musée Municipal,2004,CENTRE,PITHIVIERS,0,1800,1800,
Musée de l'Ardenne,2004,CHAMPAGNE-ARDENNES,CHARLEVILLE-MEZIERES,18290,0,18290,
Musée de la Résistance,2004,CHAMPAGNE-ARDENNES,MUSSY-SUR-SEINE,105,260,365,
Musée Vauluisant - Musée de la Bonneterie,2004,CHAMPAGNE-ARDENNES,TROYES,2829,3156,5985,
Musée des Beaux-Arts,2004,CHAMPAGNE-ARDENNES,TROYES,5572,8894,14466,
Pharmacie Musée de l'Hôtel-Dieu,2004,CHAMPAGNE-ARDENNES,TROYES,1991,1729,3720,
Musée Municipal,2004,CHAMPAGNE-ARDENNES,SAINT-DIZIER,0,5024,5024,
Musée Garinet,2004,CHAMPAGNE-ARDENNES,CHALONS-EN-CHAMPAGNE,165,1066,1231,
Musée Hôtel le Vergeur,2004,CHAMPAGNE-ARDENNES,REIMS,10006,0,10006,
Musée Palais Fesch,2004,CORSE,AJACCIO,34952,13239,48191,
Musée Beurnier-Rossel,2004,FRANCHE-COMTE,MONTBELIARD,8837,0,8837,
Musée du Château des Ducs de Wurtemberg,2004,FRANCHE-COMTE,MONTBELIARD,11036,7537,18573,
Musée Sarret de Grozon,2004,FRANCHE-COMTE,ARBOIS,0,278,278,
Musée de la Vigne et du Vin,2004,FRANCHE-COMTE,ARBOIS,5094,1846,6940,
Musée Municipal d'Archéologie,2004,FRANCHE-COMTE,CHAMPAGNOLE,1128,0,1128,
Musée d'Archéologie,2004,FRANCHE-COMTE,LONS-LE-SAUNIER,10850,0,10850,
Musée des Salines,2004,FRANCHE-COMTE,SALINS-LES-BAINS,50719,0,50719,
Musée du Château,2004,ILE-DE-FRANCE,DOURDAN,16247,2528,18775,
Musée-Jardin Paul Landowski,2004,ILE-DE-FRANCE,BOULOGNE-BILLANCOURT,1260,0,1260,
Musée Municipal d'Art et d'Histoire,2004,ILE-DE-FRANCE,COLOMBES,0,3017,3017,
Musée Français de la Carte à Jouer,2004,ILE-DE-FRANCE,ISSY-LES-MOULINEAUX,4970,7884,12854,
Grande Galerie de l'Evolution (Muséum National d'Histoire Naturelle),2004,ILE-DE-FRANCE,PARIS,587993,168697,756690,
Musée de la Vie Romantique,2004,ILE-DE-FRANCE,PARIS,120606,28293,148899,
Musée de la Franc-Maçonnerie,2004,ILE-DE-FRANCE,PARIS,6600,1500,8100,
Etablissement public du musée des arts asiatiques Guimet,2004,ILE-DE-FRANCE,PARIS,160855,99298,260153,
Mémorial du Maréchal Leclerc de Hauteclocque et de la Libération de Paris-musée Jean Moulin,2004,ILE-DE-FRANCE,PARIS,10186,11642,21828,
Musée Nissim de Camondo (UCAD),2004,ILE-DE-FRANCE,PARIS,36240,12394,48634,
Musée d'Art et d'Histoire du Judaïsme,2004,ILE-DE-FRANCE,PARIS,59207,25402,84609,
"Musée Cernuschi, Musée des Arts de l'Asie de la ville de Paris",2004,ILE-DE-FRANCE,PARIS,0,38371,38371,
Musée d'Art et d'Histoire Militaire,2004,ILE-DE-FRANCE,FONTAINEBLEAU,1598,4731,6329,
Musée d'Art et d'Histoire de Melun,2004,ILE-DE-FRANCE,MELUN,4039,1657,5696,
Musée Départemental de Préhistoire d'Île de France,2004,ILE-DE-FRANCE,NEMOURS,3280,23325,26605,
Musée de Provins et du Provinois,2004,ILE-DE-FRANCE,PROVINS,11497,1486,12983,
Ecomusée du Val de Bièvre,2004,ILE-DE-FRANCE,FRESNES,0,11227,11227,
Musée du Vieil Argenteuil,2004,ILE-DE-FRANCE,ARGENTEUIL,294,1524,1818,
Musée Camille Pissarro,2004,ILE-DE-FRANCE,PONTOISE,0,1448,1448,
Collections de la Fondation de Coubertin,2004,ILE-DE-FRANCE,SAINT-REMY-LES-CHEVREUSE,5284,709,5993,
Musée Départemental de la Réunion - Musée Léon Dierx,2004,LA REUNION,SAINT-DENIS,2193,973,3166,
Musée Petiet,2004,LANGUEDOC-ROUSSILLON,LIMOUX,3054,0,3054,
Musée d'Histoire Naturelle et de Préhistoire,2004,LANGUEDOC-ROUSSILLON,NIMES,0,26995,26995,
Musée Municipal Georges Borias,2004,LANGUEDOC-ROUSSILLON,UZES,1062,1014,2076,
Musée Pierre de Luxembourg,2004,LANGUEDOC-ROUSSILLON,VILLENEUVE-LES-AVIGNON,4332,2783,7115,
Musée du Biterrois,2004,LANGUEDOC-ROUSSILLON,BEZIERS,5536,10564,16100,
Musée de la Cloche et de la Sonnaille,2004,LANGUEDOC-ROUSSILLON,HEREPIAN,6304,0,6304,
Musée Fleury,2004,LANGUEDOC-ROUSSILLON,LODEVE,55764,8328,64092,
Agropolis-Muséum,2004,LANGUEDOC-ROUSSILLON,MONTPELLIER,21106,0,21106,
Musée Paul Valéry,2004,LANGUEDOC-ROUSSILLON,SETE,12214,0,12214,
Musée Hyacinthe Rigaud,2004,LANGUEDOC-ROUSSILLON,PERPIGNAN,3433,3243,6676,
Musée du Castillet Casa Pairal,2004,LANGUEDOC-ROUSSILLON,PERPIGNAN,10373,16978,27351,
Musée de Tautavel,2004,LANGUEDOC-ROUSSILLON,TAUTAVEL,88288,8919,97207,
Musée Départemental de la Tapisserie,2004,LIMOUSIN,AUBUSSON,17575,3904,21479,
Musée d'Art et d'Archéologie,2004,LIMOUSIN,GUERET,4937,5652,10589,
Musée de l'Histoire du Fer,2004,LORRAINE,JARVILLE-LA-MALGRANGE,4714,0,4714,
Musée Municipal des Emaux et Faïences,2004,LORRAINE,LONGWY,4840,2154,6994,
Musée de l'Ecole de Nancy,2004,LORRAINE,NANCY,35079,21037,56116,
Musée des Beaux-Arts de Nancy,2004,LORRAINE,NANCY,32062,51439,83501,
Musée Barrois,2004,LORRAINE,BAR-LE-DUC,9313,0,9313,
Musée Départemental Raymond Poincaré,2004,LORRAINE,SAMPIGNY,333,732,1065,
Maison du Verre et du Cristal,2004,LORRAINE,MEISENTHAL,22305,895,23200,
Musées de la Cour d'Or,2004,LORRAINE,METZ,14423,28864,43287,
Musée de la Mine - Carreau Wendel,2004,LORRAINE,PETITE-ROSSELLE,3745,2229,5974,
Musée du Pays de Sarrebourg,2004,LORRAINE,SARREBOURG,4078,5261,9339,
Musée Charles Friry,2004,LORRAINE,REMIREMONT,339,1730,2069,
Ecomusée de la Martinique,2004,MARTINIQUE,RIVIERE-PILOTE,10626,3747,14373,
Musée de la Forge,2004,MIDI-PYRENEES,MONTGAILHARD,29177,0,29177,
Musée du Palais des Evêques,2004,MIDI-PYRENEES,SAINT-LIZIER,6034,973,7007,
"Musée des Mœurs et Coutumes, Musée du Rouergue",2004,MIDI-PYRENEES,ESPALION,752,136,888,
Musée des Beaux-Arts Denys Puech,2004,MIDI-PYRENEES,RODEZ,1206,7965,9171,
Musée des Arts et Métiers Traditionnels,2004,MIDI-PYRENEES,SALLES-LA-SOURCE,9648,1281,10929,
Musée de l'Armagnac,2004,MIDI-PYRENEES,CONDOM,4649,41,4690,
Musée Joseph Abeilhé,2004,MIDI-PYRENEES,MARCIAC,41,75,116,
Musée Saint-Raymond,2004,MIDI-PYRENEES,TOULOUSE,25778,46773,72551,
Musée Champollion,2004,MIDI-PYRENEES,FIGEAC,22010,250,22260,
"Musée Archéologique ""Armand-Viré""",2004,MIDI-PYRENEES,LUZECH,618,0,618,
Musée Gallo-Romain d'Uxellodunum,2004,MIDI-PYRENEES,MARTEL,370,0,370,
Musée Départemental de Cuzals,2004,MIDI-PYRENEES,SAULIAC-SUR-CELE,14231,0,14231,
Musée Municipal,2004,MIDI-PYRENEES,VAYRAC,195,89,284,
Musée Toulouse Lautrec,2004,MIDI-PYRENEES,ALBI,102973,25962,128935,
Musée Eugénie et Maurice Guérin,2004,MIDI-PYRENEES,ANDILLAC,2274,1727,4001,
Musée des Beaux-Arts,2004,MIDI-PYRENEES,GAILLAC,10045,3798,13843,
Musée de Préhistoire,2004,MIDI-PYRENEES,SAINT-ANTONIN-NOBLE-VAL,1280,0,1280,
"Forum Antique de Bavay, Musée Archéologique du Département du Nord",2004,NORD-PAS-DE-CALAIS,BAVAY,12271,3773,16044,
Musée d'Archéologie et d'Histoire Locale,2004,NORD-PAS-DE-CALAIS,DENAIN,0,2150,2150,
Musée Portuaire,2004,NORD-PAS-DE-CALAIS,DUNKERQUE,29137,19743,48880,
Musée des Beaux-Arts,2004,NORD-PAS-DE-CALAIS,DUNKERQUE,5724,12343,18067,
Palais des Beaux-Arts de Lille,2004,NORD-PAS-DE-CALAIS,LILLE,460972,82814,543786,
Musée d'Histoire Locale de Marchiennes,2004,NORD-PAS-DE-CALAIS,MARCHIENNES,380,640,1020,
Musée Municipal,2004,NORD-PAS-DE-CALAIS,SAINT-AMAND-LES-EAUX,2099,2897,4996,
Musée du Verre,2004,NORD-PAS-DE-CALAIS,SARS-POTERIES,5436,4859,10295,
Musée d'Ethnographie et d'Arts Populaires et Musée de la Marine,2004,BASSE-NORMANDIE,HONFLEUR,18988,0,18988,
Musée de la Meunerie - Moulin de Marcy,2004,BASSE-NORMANDIE,LE MOLAY-LITTRY,5570,2685,8255,
Musée Municipal,2004,BASSE-NORMANDIE,VIRE NORMANDIE,719,1780,2499,
Musée des Beaux-Arts et de la Dentelle,2004,BASSE-NORMANDIE,ALENCON,19684,5859,25543,
Musée du Château de Flers,2004,BASSE-NORMANDIE,FLERS,2811,3200,6011,
Musée du Percheron,2004,BASSE-NORMANDIE,MORTAGNE-AU-PERCHE,0,923,923,
Musée d'Art Moderne André Malraux - MuMa,2004,HAUTE-NORMANDIE,LE HAVRE,40060,10743,50803,
La Maison de l'Armateur,2004,HAUTE-NORMANDIE,LE HAVRE,0,471,471,
Abbaye de Graville - Musée du Prieuré de Graville,2004,HAUTE-NORMANDIE,LE HAVRE,6543,0,6543,
"Juliobona, Musée Gallo-Romain de Lillebonne",2004,HAUTE-NORMANDIE,LILLEBONNE,1012,1030,2042,
Musée des Antiquités de la Seine-Maritime,2004,HAUTE-NORMANDIE,ROUEN,3523,30634,34157,
Musée Flaubert et d'Histoire de la Médecine,2004,HAUTE-NORMANDIE,ROUEN,2539,3779,6318,
"Musée de la Fève, Crèches et Traditions Populaires",2004,PAYS DE LA LOIRE,BLAIN,1114,175,1289,
Muséum d'Histoire Naturelle de Nantes,2004,PAYS DE LA LOIRE,NANTES,24269,53133,77402,
Musée Joseph Denais,2004,PAYS DE LA LOIRE,BEAUFORT-EN-VALLEE,2129,2245,4374,
Musée d'Art et d'Histoire,2004,PAYS DE LA LOIRE,CHOLET,1956,8194,10150,
Musée de la Vigne et du Vin d'Anjou,2004,PAYS DE LA LOIRE,SAINT LAMBERT-DU-LATTAY - VAL-DU-LAYON,6070,2171,8241,
Musée des Sciences - CCSTI,2004,PAYS DE LA LOIRE,LAVAL,5427,19695,25122,
Ecomusée du Marais Breton Vendéen,2004,PAYS DE LA LOIRE,LA BARRE-DE-MONTS,20422,10264,30686,
Musée ornithologique Charles-Payraudeau,2004,PAYS DE LA LOIRE,LA-CHAIZE-LE-VICOMTE,0,655,655,
Musée de la Construction Navale Artisanale,2004,PAYS DE LA LOIRE,NOIRMOUTIER EN L'ILE,13154,1180,14334,
Musée du Château de Blérancourt,2004,PICARDIE,BLERANCOURT,1819,2007,3826,
Musée Départemental de l'Oise,2004,PICARDIE,BEAUVAIS,4721,10948,15669,
Musée du Château de Compiègne,2004,PICARDIE,COMPIEGNE,38450,59034,97484,
Musée de la Vénerie,2004,PICARDIE,SENLIS,1761,20,1781,
Musée Boucher-de-Perthes,2004,PICARDIE,ABBEVILLE,9890,5107,14997,
Musée de Picardie,2004,PICARDIE,AMIENS,14287,34137,48424,
Musée Archéologique et Historique,2004,POITOU-CHARENTES,ANGOULEME,0,517,517,
Musée Municipal de Cognac,2004,POITOU-CHARENTES,COGNAC,2485,9577,12062,
Musée du Nouveau Monde,2004,POITOU-CHARENTES,LA ROCHELLE,10118,0,10118,
Musée Henri Barré,2004,POITOU-CHARENTES,THOUARS,287,730,1017,
Musée Municipal de Civray,2004,POITOU-CHARENTES,CIVRAY,0,805,805,
Musée Rupert de Chièvres,2004,POITOU-CHARENTES,POITIERS,854,2301,3155,
Musée du baptistère Saint-Jean,2004,POITOU-CHARENTES,POITIERS,24229,0,24229,
Musée Municipal,2004,PROVENCE-ALPES-CÔTE D'AZUR,FORCALQUIER,2349,0,2349,
Musée Fernand Léger,2004,PROVENCE-ALPES-CÔTE D'AZUR,BIOT,1000,1000,2000,
Musée de la Mer,2004,PROVENCE-ALPES-CÔTE D'AZUR,CANNES,15450,17833,33283,
Musée d'Art et d'Histoire de Provence,2004,PROVENCE-ALPES-CÔTE D'AZUR,GRASSE,11290,0,11290,
Musée d'Art Naïf Anatole Jakovsky,2004,PROVENCE-ALPES-CÔTE D'AZUR,NICE,3613,10970,14583,
Musée National Message Biblique Marc Chagall,2004,PROVENCE-ALPES-CÔTE D'AZUR,NICE,84000,82000,166000,
Musée Archéologique - Site de Terra Amata,2004,PROVENCE-ALPES-CÔTE D'AZUR,NICE,3093,11636,14729,
Musée Départemental des Merveilles,2004,PROVENCE-ALPES-CÔTE D'AZUR,TENDE,15539,7201,22740,
Musée Alphonse Daudet,2004,PROVENCE-ALPES-CÔTE D'AZUR,FONTVIEILLE,29596,0,29596,
Musée Frédéric Mistral,2004,PROVENCE-ALPES-CÔTE D'AZUR,MAILLANE,2639,725,3364,
Musée du Vieux Marseille,2004,PROVENCE-ALPES-CÔTE D'AZUR,MARSEILLE,791,3527,4318,
Musée de l'Empéri de Salon et de la Crau,2004,PROVENCE-ALPES-CÔTE D'AZUR,SALON-DE-PROVENCE,8970,13507,22477,
Muséum d'Histoire Naturelle de Toulon,2004,PROVENCE-ALPES-CÔTE D'AZUR,TOULON,0,23104,23104,
Musée Sobirats,2004,PROVENCE-ALPES-CÔTE D'AZUR,CARPENTRAS,319,774,1093,
Musée-Bibliothèque François Pétrarque,2004,PROVENCE-ALPES-CÔTE D'AZUR,FONTAINE-DE-VAUCLUSE,5769,0,5769,
Musée Départemental du Cartonnage et de l'Imprimerie,2004,PROVENCE-ALPES-CÔTE D'AZUR,VALREAS,1619,1647,3266,
Musée du Peigne et de la Plasturgie,2004,RHONE-ALPES,OYONNAX,2830,1445,4275,
Musée d'Histoire et d'Archéologie,2004,RHONE-ALPES,DIE,2819,1187,4006,
Musée du Château des Adhémars,2004,RHONE-ALPES,MONTELIMAR,11507,0,11507,
Musée du site Préhistorique,2004,RHONE-ALPES,VASSIEUX-EN-VERCORS,17080,0,17080,
Musée des Vallées de Thônes,2004,RHONE-ALPES,THONES,1607,608,2215,
Musée du Chablais,2004,RHONE-ALPES,THONON-LES-BAINS,1721,1570,3291,
Musée d'Huez et de l'Oisans,2004,RHONE-ALPES,ALPE D'HUEZ,5074,0,5074,
Musée Gallo-Romain,2004,RHONE-ALPES,AOSTE,3345,1908,5253,
Musée de Grenoble,2004,RHONE-ALPES,GRENOBLE,93426,39981,133407,
Maison du Patrimoine de Hières-sur-Amby,2004,RHONE-ALPES,HIERES SUR AMBY,6984,735,7719,
Musée Hector Berlioz,2004,RHONE-ALPES,LA-COTE-SAINT-ANDRE,0,15836,15836,
Musée de la Soierie,2004,RHONE-ALPES,CHARLIEU,8370,2253,10623,
Musées Gadagne,2004,RHONE-ALPES,LYON,6557,3375,9932,
Musée de la Civilisation Gallo-Romaine,2004,RHONE-ALPES,LYON,48796,52625,101421,
Centre d'Histoire de la Résistance et de la Déportation,2004,RHONE-ALPES,LYON,67364,0,67364,
Musée Henri Malartre,2004,RHONE-ALPES,ROCHETAILLEE-SUR-SAONE,43354,0,43354,
Musée Paul Dini,2004,RHONE-ALPES,VILLEFRANCHE-SUR-SAONE,4676,7418,12094,
Musée archéologique et minéralogique Pierre Borrione,2004,RHONE-ALPES,AIME-EN-TARENTAISE Cedex,1170,513,1683,
Musée du docteur Faure,2004,RHONE-ALPES,AIX-LES-BAINS,10523,0,10523,
Musée du Château des Rohan,2005,ALSACE,SAVERNE,5095,3313,8408,
Musée Zoologique de Strasbourg,2005,ALSACE,STRASBOURG,11067,20551,31618,
Musée de l'Œuvre Notre-Dame,2005,ALSACE,STRASBOURG,11975,22134,34109,
Musée de la Bataille du 6 Août 1870,2005,ALSACE,WOERTH,3100,242,3342,
Musée Gallo-Romain,2005,ALSACE,BIESHEIM,1025,1775,2800,
Musée du Vignoble et des Vins d'Alsace,2005,ALSACE,KAYSERSBERG VIGNOBLE,5105,25,5130,
Musée du Tabac,2005,AQUITAINE,BERGERAC,8520,1500,10020,
Musée Militaire - Souvenir du Périgord,2005,AQUITAINE,PERIGUEUX,1529,1174,2703,
Muséum d'Histoire Naturelle de Bordeaux,2005,AQUITAINE,BORDEAUX,8402,57586,65988,
Musée des Arts Décoratifs,2005,AQUITAINE,BORDEAUX,16389,22017,38406,
Musée des Beaux-Arts,2005,AQUITAINE,BORDEAUX,21249,48491,69740,
Musée Historique de l'Hydravion,2005,AQUITAINE,BISCARROSSE,14044,1681,15725,
Musée de Borda,2005,AQUITAINE,DAX,3424,5173,8597,
Musée Municipal,2005,AQUITAINE,ARUDY,1133,276,1409,
Musée des Arts et Traditions Populaires de Haute Loire,2005,AUVERGNE,LAVAUDIEU,12975,444,13419,
Musée Paléontologique,2005,AUVERGNE,MENAT,965,73,1038,
Musée Municipal de la Coutellerie,2005,AUVERGNE,THIERS,36207,5575,41782,
Musée François Rude,2005,BOURGOGNE,DIJON,0,28691,28691,
Musée Municipal François Pompon,2005,BOURGOGNE,SAULIEU,3357,1412,4769,
Musée de la Loire,2005,BOURGOGNE,COSNE-SUR-LOIRE,1963,2419,4382,
Musée de la Mine,2005,BOURGOGNE,LA MACHINE,5842,0,5842,
Musée du Grès de Puisaye,2005,BOURGOGNE,SAINT-AMAND-EN-PUISAYE,3324,0,3324,
Musée Rolin,2005,BOURGOGNE,AUTUN,16232,4905,21137,
Musée de la Mine,2005,BOURGOGNE,BLANZY,11745,1644,13389,
Ecomusée de la Bresse Bourguignonne,2005,BOURGOGNE,PIERRE-DE-BRESSE,30429,6633,37062,
Musée Départemental du Compagnonnage,2005,BOURGOGNE,ROMANECHE-THORINS,2049,1099,3148,
Musée du Terroir,2005,BOURGOGNE,ROMENAY,194,25,219,
Musée Leblanc-Duvernois,2005,BOURGOGNE,AUXERRE,487,1377,1864,
Musée des Arts Naïfs et Populaires de Noyers sur Serein,2005,BOURGOGNE,NOYERS-SUR-SEREIN,1867,892,2759,
Musée du Château de Dinan,2005,BRETAGNE,DINAN,22601,3558,26159,
Musée National de la Marine,2005,BRETAGNE,BREST,26752,26683,53435,
Ecomusée des Monts d'Arrée - Moulins de Kerouat & Maison Cornec de Rivoal,2005,BRETAGNE,COMMANA,19130,7094,26224,
Musée de l'Ecole Rurale en Bretagne,2005,BRETAGNE,TREGARVAN,11085,1073,12158,
Ecomusée du Pays de Montfort,2005,BRETAGNE,MONTFORT-SUR-MEU,2753,435,3188,
Musée des Beaux-Arts,2005,BRETAGNE,RENNES,15634,39606,55240,
"La Cohue, Musée des Beaux-Arts de vannes",2005,BRETAGNE,VANNES,8368,7106,15474,
Musée des Arts Décoratifs,2005,CENTRE,BOURGES,0,15590,15590,
Musée Marcel Proust,2005,CENTRE,ILLIERS-COMBRAY,3327,288,3615,
Musée Archéologique d'Argentomagus,2005,CENTRE,SAINT-MARCEL,10366,11451,21817,
Musée François Rabelais,2005,CENTRE,SEUILLY,14449,0,14449,
Maison de la Magie,2005,CENTRE,BLOIS,44717,15561,60278,
Musée Arthur Rimbaud,2005,CHAMPAGNE-ARDENNES,CHARLEVILLE-MEZIERES,12483,0,12483,
Musée Vauluisant - Musée de la Bonneterie,2005,CHAMPAGNE-ARDENNES,TROYES,3565,4091,7656,
Musée des Beaux-Arts (Musée Pic Saint-Loup),2005,CHAMPAGNE-ARDENNES,TROYES,6798,13186,19984,
Musée d'Art Moderne,2005,CHAMPAGNE-ARDENNES,TROYES,27877,0,27877,
Musée Municipal,2005,CHAMPAGNE-ARDENNES,BOURBONNE-LES-BAINS,0,649,649,
Musée Municipal,2005,CHAMPAGNE-ARDENNES,CHALONS-EN-CHAMPAGNE,15222,0,15222,
Musée Garinet,2005,CHAMPAGNE-ARDENNES,CHALONS-EN-CHAMPAGNE,706,0,706,
Musée Saint-Rémi,2005,CHAMPAGNE-ARDENNES,REIMS,38182,0,38182,
Musée de l'Alta Rocca,2005,CORSE,LEVIE,1248,0,1248,
Musée de Plein Air des Maisons Comtoises,2005,FRANCHE-COMTE,NANCRAY,28312,8111,36423,
Musée-Maison Natale Gustave Courbet,2005,FRANCHE-COMTE,ORNANS,15454,1702,17156,
Musée d'Archéologie,2005,FRANCHE-COMTE,LONS-LE-SAUNIER,6984,0,6984,
Musée des Beaux-Arts,2005,FRANCHE-COMTE,LONS-LE-SAUNIER,1294,4330,5624,
Viséum-Musée de la Lunette,2005,FRANCHE-COMTE,MOREZ HAUTS DE BIENNE,13638,1269,14907,
Musée des Salines,2005,FRANCHE-COMTE,SALINS-LES-BAINS,46504,5254,51758,
Musée des Cultures Guyanaises,2005,GUYANE,CAYENNE,0,9216,9216,
Musée des Années Trente,2005,ILE-DE-FRANCE,BOULOGNE-BILLANCOURT,20085,5777,25862,
Musée René Sordes,2005,ILE-DE-FRANCE,SURESNES,0,706,706,
Grande Galerie de l'Evolution (Muséum National d'Histoire Naturelle),2005,ILE-DE-FRANCE,PARIS,378178,176003,554181,
Musée National Eugène Delacroix,2005,ILE-DE-FRANCE,PARIS,21402,21095,42497,
Musée National Jean-Jacques Henner,2005,ILE-DE-FRANCE,PARIS,0,1543,1543,
Mémorial du Maréchal Leclerc de Hauteclocque et de la Libération de Paris-musée Jean Moulin,2005,ILE-DE-FRANCE,PARIS,4774,10214,14988,
Musée du Louvre,2005,ILE-DE-FRANCE,PARIS,5021000,2490000,7511000,
Musée National Picasso,2005,ILE-DE-FRANCE,PARIS,307368,199953,507321,
Musée Nissim de Camondo (UCAD),2005,ILE-DE-FRANCE,PARIS,33032,11449,44481,
Maison Natale de Louis Braille,2005,ILE-DE-FRANCE,COUPVRAY,2495,958,3453,
Musée d'Art et d'Histoire Militaire,2005,ILE-DE-FRANCE,FONTAINEBLEAU,1200,3644,4844,
Musée départemental Stéphane Mallarmé,2005,ILE-DE-FRANCE,VULAINES-SUR-SEINE,2537,891,3428,
Musée Tavet Delacour,2005,ILE-DE-FRANCE,PONTOISE,3229,4020,7249,
Musée Promenade Marly/Louveciennes,2005,ILE-DE-FRANCE,LOUVECIENNES,7132,1907,9039,
Musée du Jouet Pierre Pinel,2005,ILE-DE-FRANCE,POISSY,14536,3222,17758,
Musée Départemental Maurice Denis,2005,ILE-DE-FRANCE,SAINT-GERMAIN-EN-LAYE,25412,0,25412,
Etablissement Public du Musée et du Domaine National de Versailles,2005,ILE-DE-FRANCE,VERSAILLES,3646133,833948,4480081,
Muséum Agricole et Industriel Stella Matutina,2005,LA REUNION,PITON-SAINT-LEU,37575,4086,41661,
Musée Départemental de la Réunion - Musée Léon Dierx,2005,LA REUNION,SAINT-DENIS,7178,5130,12308,
Musée du Colombier,2005,LANGUEDOC-ROUSSILLON,ALES,0,11433,11433,
Musée d'Histoire Naturelle et de Préhistoire,2005,LANGUEDOC-ROUSSILLON,NIMES,0,36281,36281,
Musée Fabre,2005,LANGUEDOC-ROUSSILLON,MONTPELLIER,13978,18979,32957,
Musée d'Art Moderne - Fonds Peskè,2005,LANGUEDOC-ROUSSILLON,COLLIOURE,5381,1288,6669,
Musée du Castillet Casa Pairal,2005,LANGUEDOC-ROUSSILLON,PERPIGNAN,7191,18995,26186,
Musée Labenche d'Art et d'Histoire,2005,LIMOUSIN,BRIVE-LA-GAILLARDE,2676,11915,14591,
Musée du Pays d'Ussel,2005,LIMOUSIN,USSEL,0,2002,2002,
Musée de l'Histoire du Fer,2005,LORRAINE,JARVILLE-LA-MALGRANGE,2212,4720,6932,
Musée de l'Ecole de Nancy,2005,LORRAINE,NANCY,35844,19338,55182,
Muséum- Aquarium de Nancy,2005,LORRAINE,NANCY,26153,48979,75132,
Musée des Beaux-Arts de Nancy,2005,LORRAINE,NANCY,46110,75037,121147,
Musée d'Argonne,2005,LORRAINE,VARENNES-EN-ARGONNE,2560,0,2560,
Musée de la Princerie,2005,LORRAINE,VERDUN,3547,1704,5251,
Musées de la Cour d'Or,2005,LORRAINE,METZ,15072,28446,43518,
Musée des Mines de fer de Lorraine,2005,LORRAINE,NEUFCHEF,19955,1734,21689,
Musée de la Mine - Carreau Wendel,2005,LORRAINE,PETITE-ROSSELLE,4441,1113,5554,
Musée Départemental Georges de la Tour,2005,LORRAINE,VIC-SUR-SEILLE,6481,6813,13294,
Musée de la Lutherie et de l'Archèterie Française,2005,LORRAINE,MIRECOURT,6727,2916,9643,
Musée Départemental de l'Ariège,2005,MIDI-PYRENEES,FOIX,79930,6769,86699,
Musée de la Préhistoire,2005,MIDI-PYRENEES,LE MAS D'AZIL,10908,0,10908,
Musée du Charroi Rural et de l'Artisanat Traditionnel,2005,MIDI-PYRENEES,SALMIECH,0,2000,2000,
Musée des Amériques,2005,MIDI-PYRENEES,AUCH,6690,3785,10475,
Musée du Pays de Luchon,2005,MIDI-PYRENEES,BAGNERES-DE-LUCHON,2107,268,2375,
Musée du Vieux Toulouse,2005,MIDI-PYRENEES,TOULOUSE,2331,4997,7328,
Muséum d'Histoire Naturelle,2005,MIDI-PYRENEES,BAGNERES-DE-BIGORRE,1901,350,2251,
Musée Pyrénéen,2005,MIDI-PYRENEES,LOURDES,68528,4277,72805,
Musée Henri Martin,2005,MIDI-PYRENEES,CAHORS,2675,5924,8599,
Musée Départemental de Cuzals,2005,MIDI-PYRENEES,SAULIAC-SUR-CELE,7199,1692,8891,
Musée Eugénie et Maurice Guérin,2005,MIDI-PYRENEES,ANDILLAC,2186,3530,5716,
Musée Goya,2005,MIDI-PYRENEES,CASTRES,9172,13440,22612,
Musée du protestantisme en Haut-Languedoc,2005,MIDI-PYRENEES,FERRIERES,1286,913,2199,
Musée du Pays Rabastinois,2005,MIDI-PYRENEES,RABASTENS,1519,3944,5463,
Musée Ingres,2005,MIDI-PYRENEES,MONTAUBAN,38252,0,38252,
Musée Municipal de Cambrai,2005,NORD-PAS-DE-CALAIS,CAMBRAI,4669,12825,17494,
Musée des Beaux-Arts,2005,NORD-PAS-DE-CALAIS,DUNKERQUE,10329,0,10329,
Musée Municipal d'Escaudain,2005,NORD-PAS-DE-CALAIS,ESCAUDAIN,0,712,712,
Musée d'Histoire Locale de Marchiennes,2005,NORD-PAS-DE-CALAIS,MARCHIENNES,240,1210,1450,
Musée d'Art Moderne de Lille Métropole,2005,NORD-PAS-DE-CALAIS,VILLENEUVE-D'ASCQ,91764,26974,118738,
Musée des Beaux-Arts,2005,NORD-PAS-DE-CALAIS,ARRAS,11003,18530,29533,
Musée Municipal,2005,NORD-PAS-DE-CALAIS,BERCK-SUR-MER,12019,0,12019,
Musée de la Céramique,2005,NORD-PAS-DE-CALAIS,DESVRES,8776,4033,12809,
Musée Langlois,2005,BASSE-NORMANDIE,BEAUMONT-EN-AUGE,58,0,58,
Musée des Beaux-Arts,2005,BASSE-NORMANDIE,CAEN,4278,52098,56376,
Musée d'Ethnographie et d'Arts Populaires et Musée de la Marine,2005,BASSE-NORMANDIE,HONFLEUR,18976,0,18976,
Musée d'Art et d'Histoire de Lisieux,2005,BASSE-NORMANDIE,LISIEUX,819,893,1712,
Musée Paléontologique,2005,BASSE-NORMANDIE,VILLERS-SUR-MER,0,26088,26088,
Musée Municipal,2005,BASSE-NORMANDIE,VIRE NORMANDIE,680,1283,1963,
Muséum Emmanuel Liais,2005,BASSE-NORMANDIE,CHERBOURG-EN-COTENTIN,0,18393,18393,
Musée du Granit,2005,BASSE-NORMANDIE,SAINT-MICHEL-DE-MONTJOIE,1871,0,1871,
Musée Municipal - Musée du Jouet,2005,BASSE-NORMANDIE,LA FERTE-MACE,538,0,538,
Musée du Verre et de la Pierre,2005,HAUTE-NORMANDIE,CONCHES-EN-OUCHE,1653,1149,2802,
Maison des Templiers,2005,HAUTE-NORMANDIE,CAUDEBEC-EN-CAUX,400,2100,2500,
Musée des Traditions et Arts Normands,2005,HAUTE-NORMANDIE,MARTAINVILLE-EPREVILLE,8625,8681,17306,
Muséum d'Histoire Naturelle de Nantes,2005,PAYS DE LA LOIRE,NANTES,18666,62329,80995,
Maison de l'Eclusier /Parc Naturel Régional de Brière,2005,PAYS DE LA LOIRE,SAINT-MALO DE GUERSAC,4135,874,5009,
Musée des Beaux-Arts,2005,PAYS DE LA LOIRE,ANGERS,24896,58872,83768,
Musée Jean Lurcat et de la Tapisserie Contemporaine,2005,PAYS DE LA LOIRE,ANGERS,14192,36575,50767,
Musée d'Art et d'Histoire,2005,PAYS DE LA LOIRE,CHOLET,1499,10634,12133,
Musée de Tessé,2005,PAYS DE LA LOIRE,LE MANS,26751,3987,30738,
Musée de la Construction Navale Artisanale,2005,PAYS DE LA LOIRE,NOIRMOUTIER EN L'ILE,6550,826,7376,
Musée Franco-Américain du Château de Blérancourt,2005,PICARDIE,BLERANCOURT,927,726,1653,
Musée d'Art et d'Archéologie,2005,PICARDIE,LAON,1717,5469,7186,
Musée Antoine Lecuyer,2005,PICARDIE,SAINT-QUENTIN,6140,7344,13484,
Musée Municipal de Soissons,2005,PICARDIE,SOISSONS,0,27739,27739,
Musée de la Résistance et de la Déportation,2005,PICARDIE,TERGNIER,3915,0,3915,
Musée Départemental de l'Oise,2005,PICARDIE,BEAUVAIS,4086,10381,14467,
Musée d'Art et d'Archéologie,2005,PICARDIE,SENLIS,6353,4014,10367,
Musée Boucher-de-Perthes,2005,PICARDIE,ABBEVILLE,9147,0,9147,
Musée Alfred Danicourt,2005,PICARDIE,PERONNE,0,783,783,
Musée Régional de Fouras,2005,POITOU-CHARENTES,FOURAS,5380,5000,10380,
Musée d'Art et d'Histoire Georges Turpin,2005,POITOU-CHARENTES,PARTHENAY,870,4315,5185,
Musée Sainte-Croix,2005,POITOU-CHARENTES,POITIERS,4529,13730,18259,
Musée du baptistère Saint-Jean,2005,POITOU-CHARENTES,POITIERS,16838,0,16838,
Collection d'Histoire Naturelle,2005,POITOU-CHARENTES,POITIERS,86962,0,86962,
Musée de Salagon,2005,PROVENCE-ALPES-CÔTE D'AZUR,MANE,21336,5301,26637,
Musée de la Faïence,2005,PROVENCE-ALPES-CÔTE D'AZUR,MOUSTIERS-SAINTE-MARIE,7383,1461,8844,
Musée Renoir,2005,PROVENCE-ALPES-CÔTE D'AZUR,CAGNES-SUR-MER,11192,3383,14575,
Musée de Préhistoire Régionale,2005,PROVENCE-ALPES-CÔTE D'AZUR,MENTON,0,10239,10239,
Muséum d'Histoire Naturelle,2005,PROVENCE-ALPES-CÔTE D'AZUR,NICE,0,46562,46562,
Ecomusée du Pays de la Roudoule,2005,PROVENCE-ALPES-CÔTE D'AZUR,PUGET-ROSTANG,1944,3502,5446,
Musée Camarguais,2005,PROVENCE-ALPES-CÔTE D'AZUR,ARLES,13610,5936,19546,
Musée Ciotaden,2005,PROVENCE-ALPES-CÔTE D'AZUR,LA CIOTAT,4208,4318,8526,
Musée Folklorique du Vieux Lambesc,2005,PROVENCE-ALPES-CÔTE D'AZUR,LAMBESC,437,130,567,
Musée d'Archéologie Méditerranéenne,2005,PROVENCE-ALPES-CÔTE D'AZUR,MARSEILLE,81033,53480,134513,
Muséum d'Histoire Naturelle,2005,PROVENCE-ALPES-CÔTE D'AZUR,MARSEILLE,12277,36135,48412,
Musée Ziem,2005,PROVENCE-ALPES-CÔTE D'AZUR,MARTIGUES,0,7461,7461,
Musée Baroncelli,2005,PROVENCE-ALPES-CÔTE D'AZUR,SAINTES-MARIES-DE-LA-MER,1454,0,1454,
Musée Départemental des Hautes-Alpes,2005,PROVENCE-ALPES-CÔTE D'AZUR,GAP,1712,14397,16109,
Musée du Petit Palais,2005,PROVENCE-ALPES-CÔTE D'AZUR,AVIGNON,21493,8529,30022,
Musée Sobirats,2005,PROVENCE-ALPES-CÔTE D'AZUR,CARPENTRAS,831,463,1294,
Musée International de la Chaussure,2005,RHONE-ALPES,ROMANS,20702,17336,38038,
Musée des Beaux-Arts,2005,RHONE-ALPES,VALENCE,12171,8803,20974,
Musée du site Préhistorique,2005,RHONE-ALPES,VASSIEUX-EN-VERCORS,16318,0,16318,
Musée Alpin,2005,RHONE-ALPES,CHAMONIX,20028,6779,26807,
Musée des Vallées de Thônes,2005,RHONE-ALPES,THONES,2031,1016,3047,
Maison du Patrimoine de Hières-sur-Amby,2005,RHONE-ALPES,HIERES SUR AMBY,6871,326,7197,
Musée Matheysin,2005,RHONE-ALPES,LA MURE,1728,2132,3860,
Musée Hébert,2005,RHONE-ALPES,LA TRONCHE,0,13894,13894,
Musée de la Grande Chartreuse,2005,RHONE-ALPES,SAINT-PIERRE-DE-CHARTREUSE,56759,0,56759,
Château de la Bastie d'Urfé,2005,RHONE-ALPES,SAINT-ETIENNE-LE-MOLARD,12461,0,12461,
Musée des Civilisations : Daniel Pouget,2005,RHONE-ALPES,SAINT-JUST-SAINT-RAMBERT,5220,2541,7761,
Musée des Hospices Civils de Lyon,2005,RHONE-ALPES,LYON,12557,0,12557,
Musée d'Art Contemporain de Lyon,2005,RHONE-ALPES,LYON,146087,0,146087,
Musée des Beaux-Arts,2005,RHONE-ALPES,CHAMBERY,19296,1029,20325,
Muséum d'histoire naturelle,2005,RHONE-ALPES,CHAMBERY,1509,1656,3165,
Musée de la Chartreuse,2006,ALSACE,MOLSHEIM,3597,94,3691,
Musée de l'Image Populaire de Pfaffenhoffen,2006,ALSACE,PFAFFENHOFFEN,2824,626,3450,
Musée du Fer,2006,ALSACE,REICHSHOFFEN,797,435,1232,
Musée du Château des Rohan,2006,ALSACE,SAVERNE,4509,2433,6942,
Musée de l'Œuvre Notre-Dame,2006,ALSACE,STRASBOURG,12272,25212,37484,
Musée de la Bataille du 6 Août 1870,2006,ALSACE,WOERTH,2817,624,3441,
Musée Historique,2006,ALSACE,MULHOUSE,0,35018,35018,
Musée Vauban,2006,ALSACE,NEUF-BRISACH,1379,789,2168,
Musée des Arts et Traditions Populaires du Périgord,2006,AQUITAINE,MUSSIDAN,1167,698,1865,
Musée d'Art et d'Archéologie du Périgord (MAAP),2006,AQUITAINE,PERIGUEUX,4186,18554,22740,
Centre National Jean Moulin,2006,AQUITAINE,BORDEAUX,0,18498,18498,
Musée de Borda,2006,AQUITAINE,DAX,2155,4407,6562,
Atelier-Musée  (Ecomusée de la Grande Landes),2006,AQUITAINE,LUXEY,4014,0,4014,
Musée de la Chalosse,2006,AQUITAINE,MONTFORT-EN-CHALOSSE,9423,2174,11597,
Musée Municipal du Lac,2006,AQUITAINE,SANGUINET,1142,280,1422,
Musée Municipal,2006,AQUITAINE,ARUDY,1079,314,1393,
Muséum d'Histoire Naturelle,2006,AQUITAINE,BAYONNE,639,8228,8867,
Musée Edmond Rostand,2006,AQUITAINE,CAMBO-LES-BAINS,66204,2601,68805,
Musée Municipal des Beaux-Arts,2006,AQUITAINE,PAU,10759,11964,22723,
Musée Crozatier,2006,AUVERGNE,LE PUY-EN-VELAY,12094,11993,24087,
Musée Francisque Mandet,2006,AUVERGNE,RIOM,5688,1828,7516,
Musée Municipal Marcel Sahut,2006,AUVERGNE,VOLVIC,614,2993,3607,
Muséum - Jardin des Sciences,2006,BOURGOGNE,DIJON,59202,67677,126879,
Musée du Grès de Puisaye,2006,BOURGOGNE,SAINT-AMAND-EN-PUISAYE,2628,50,2678,
Musée Auguste Grasset,2006,BOURGOGNE,VARZY,3177,0,3177,
Ecomusée de la Communauté Le Creusot-Monceau-Les-Mines,2006,BOURGOGNE,LE CREUSOT,13595,5813,19408,
Musée Mathurin Meheut,2006,BRETAGNE,LAMBALLE,5080,85,5165,
Musée de Pont-Aven,2006,BRETAGNE,PONT-AVEN,36609,0,36609,
Ecomusée du Pays de Rennes,2006,BRETAGNE,RENNES,10332,24710,35042,
Musée du Château de Vitré,2006,BRETAGNE,VITRE,18043,7701,25744,
Musée de la Résistance Bretonne,2006,BRETAGNE,SAINT-MARCEL - MALESTROIT,26480,3204,29684,
"La Cohue, Musée des Beaux-Arts de vannes",2006,BRETAGNE,VANNES,8473,21974,30447,
Musée des Arts Décoratifs,2006,CENTRE,BOURGES,0,17442,17442,
Musée du Berry,2006,CENTRE,BOURGES,0,15565,15565,
Musée Saint-Vic,2006,CENTRE,SAINT-AMAND-MONTROND,917,2420,3337,
Château Musée,2006,CENTRE,AZAY-LE-FERRON,8607,3248,11855,
Musée de l'Hospice Saint-Roch,2006,CENTRE,ISSOUDUN,289,15610,15899,
"""Maison Musée"" René Descartes",2006,CENTRE,DESCARTES,1245,764,2009,
Musée du Savignéen,2006,CENTRE,SAVIGNE-SUR-LATHAN,1407,251,1658,
Muséum d'Histoire Naturelle,2006,CENTRE,TOURS,5055,7795,12850,
Musée du Compagnonnage,2006,CENTRE,TOURS,35026,11871,46897,
Musée Archéologique,2006,CENTRE,THESEE,1143,348,1491,
Musée de la Marine de Loire,2006,CENTRE,CHATEAUNEUF-SUR-LOIRE,10676,3129,13805,
Musée de la Maison de la Dernière Cartouche,2006,CHAMPAGNE-ARDENNES,BAZEILLES,1930,1704,3634,
Ecomusée de la Montagne de Reims,2006,CHAMPAGNE-ARDENNES,POURCY,768,0,768,
Musée Napoléonien,2006,CORSE,AJACCIO,5527,1597,7124,
Musée de la Corse,2006,CORSE,CORTE,46027,6027,52054,
Musée de la résistance et de la Déportation,2006,FRANCHE-COMTE,BESANCON,56771,0,56771,
Musée Beurnier-Rossel,2006,FRANCHE-COMTE,MONTBELIARD,3124,5670,8794,
Musée du Château des Ducs de Wurtemberg,2006,FRANCHE-COMTE,MONTBELIARD,5483,10462,15945,
Musée de Plein Air des Maisons Comtoises,2006,FRANCHE-COMTE,NANCRAY,30413,5072,35485,
Musée Départemental Victor Schoelcher,2006,GUADELOUPE,POINTE-A-PITRE,3600,455,4055,
Fondation Arp,2006,ILE-DE-FRANCE,CLAMART,1490,593,2083,
Musée Français de la Carte à Jouer,2006,ILE-DE-FRANCE,ISSY-LES-MOULINEAUX,6166,9007,15173,
Musée Municipal de Saint-Cloud,2006,ILE-DE-FRANCE,SAINT-CLOUD,0,7079,7079,
Grande Galerie de l'Evolution (Muséum National d'Histoire Naturelle),2006,ILE-DE-FRANCE,PARIS,434298,208892,643190,
Musée National des Arts et des Traditions Populaires (MuCem),2006,ILE-DE-FRANCE,PARIS,45776,0,45776,
Musée National Gustave Moreau,2006,ILE-DE-FRANCE,PARIS,17595,12038,29633,
Musée de la Vie Romantique,2006,ILE-DE-FRANCE,PARIS,39919,31982,71901,
Musée de la Musique,2006,ILE-DE-FRANCE,PARIS,124155,0,124155,
Musée des Arts Décoratifs (Union Centrale des Arts Décoratifs),2006,ILE-DE-FRANCE,PARIS,201725,86454,288179,
"Musée Cognacq-Jay, Musée du XVIIIe siècle de la ville de Paris",2006,ILE-DE-FRANCE,PARIS,0,33883,33883,
Musée du Louvre,2006,ILE-DE-FRANCE,PARIS,5667000,2647000,8314000,
Musée National des Techniques,2006,ILE-DE-FRANCE,PARIS,184484,0,184484,
Musée des Monnaies et des Médailles,2006,ILE-DE-FRANCE,PARIS,10545,0,10545,
Musée Départemental de l'Ecole de Barbizon - Auberge Ganne,2006,ILE-DE-FRANCE,BARBIZON,21434,7644,29078,
Musée Gatien Bonnet,2006,ILE-DE-FRANCE,LAGNY-SUR-MARNE,1630,3370,5000,
Musée d'Art et d'Histoire de Melun,2006,ILE-DE-FRANCE,MELUN,382,5011,5393,
Musée Départemental de Préhistoire d'Île de France,2006,ILE-DE-FRANCE,NEMOURS,2736,30988,33724,
Musée d'Art et d'Histoire,2006,ILE-DE-FRANCE,SAINT-DENIS,4409,30701,35110,
Musée de la Renaissance - Château d'Ecouen,2006,ILE-DE-FRANCE,ECOUEN,17315,38182,55497,
Musée d'Art et d'Histoire Louis Senlecq,2006,ILE-DE-FRANCE,L'ISLE-ADAM,1660,10161,11821,
Musée de la Batellerie et des Voies Navigables,2006,ILE-DE-FRANCE,CONFLANS-SAINTE-HONORINE,10176,1670,11846,
Musée de l'Hôtel-Dieu,2006,ILE-DE-FRANCE,MANTES-LA-JOLIE,5474,1465,6939,
Musée de la Ville,2006,ILE-DE-FRANCE,MONTIGNY LE BRETONNEUX,4746,6430,11176,
Musée du Jouet Pierre Pinel,2006,ILE-DE-FRANCE,POISSY,15156,4076,19232,
Musée d'Archéologie Nationale (des origines à l'an mille) - Château de st-Germain-en-Laye,2006,ILE-DE-FRANCE,SAINT-GERMAIN-EN-LAYE,18085,60165,78250,
Musée Historique de Villèle,2006,LA REUNION,SAINT-GILLES-LES-HAUTS,6586,15975,22561,
Musée Petiet,2006,LANGUEDOC-ROUSSILLON,LIMOUX,856,3038,3894,
Musée Archéologique,2006,LANGUEDOC-ROUSSILLON,SALLELES D'AUDE,11000,0,11000,
Musée de la Préhistoire des Matelles,2006,LANGUEDOC-ROUSSILLON,LES MATELLES,519,1639,2158,
Ecomusée du Mont Lozère,2006,LANGUEDOC-ROUSSILLON,LE PONT DE MONTVERT,3139,2302,5441,
Musée départemental d'Art Moderne,2006,LANGUEDOC-ROUSSILLON,CERET,74086,0,74086,
Musée Labenche d'Art et d'Histoire,2006,LIMOUSIN,BRIVE-LA-GAILLARDE,2848,11571,14419,
Musée Départemental de la Tapisserie,2006,LIMOUSIN,AUBUSSON,14554,2265,16819,
Musée de l'Evêché,2006,LIMOUSIN,LIMOGES,0,29311,29311,
Musée Municipal des Emaux et Faïences,2006,LORRAINE,LONGWY,4860,1300,6160,
Musée de la Céramique et de l'Ivoire,2006,LORRAINE,COMMERCY,2470,779,3249,
Musée Jules Bastien-Lepage - Musée de la Fortification,2006,LORRAINE,MONTMEDY,12676,1144,13820,
Musée d'Art Sacré de la Meuse,2006,LORRAINE,SAINT-MIHIEL,1323,649,1972,
Musée Jeanne d'Arc,2006,LORRAINE,VAUCOULEURS,796,1008,1804,
La Tour aux Puces - Musée du Pays Thionvillois,2006,LORRAINE,THIONVILLE Cedex,2702,8628,11330,
Musée Départemental Georges de la Tour,2006,LORRAINE,VIC-SUR-SEILLE,29477,0,29477,
Musée Départemental d'Art Ancien et Contemporain,2006,LORRAINE,EPINAL Cedex,2999,11817,14816,
Musée Volcanologique Franck Arnold Perret,2006,MARTINIQUE,SAINT-PIERRE,32833,0,32833,
Musée des Beaux-Arts Denys Puech,2006,MIDI-PYRENEES,RODEZ,1445,10959,12404,
Musée du Vieux Nîmes,2006,MIDI-PYRENEES,NIMES,0,14230,14230,
Musée Archéologique,2006,MIDI-PYRENEES,NIMES,0,39816,39816,
Musée des Beaux-Arts,2006,MIDI-PYRENEES,NIMES,1831,11981,13812,
Musée Pierre de Luxembourg,2006,MIDI-PYRENEES,VILLENEUVE-LES-AVIGNON,4637,2948,7585,
Musée du Pays de Luchon,2006,MIDI-PYRENEES,BAGNERES-DE-LUCHON,2355,695,3050,
Musée Salies,2006,MIDI-PYRENEES,BAGNERES-DE-BIGORRE,6109,210,6319,
Musée-château Gaston Phébus,2006,MIDI-PYRENEES,MAUVEZIN,29982,0,29982,
Musée de Préhistoire Amédée Lémozi,2006,MIDI-PYRENEES,CABRERETS,72779,236,73015,
Musée Toulouse Lautrec,2006,MIDI-PYRENEES,ALBI,109407,28207,137614,
Musée Jean Jaurès,2006,MIDI-PYRENEES,CASTRES,1340,7347,8687,
Musée du Protestantisme en Haut-Languedoc,2006,MIDI-PYRENEES,FERRIERES,1378,732,2110,
Musée du Pays Rabastinois,2006,MIDI-PYRENEES,RABASTENS,812,3520,4332,
Musée de la Chartreuse,2006,NORD-PAS-DE-CALAIS,DOUAI,6945,17618,24563,
Musée Municipal d'Escaudain,2006,NORD-PAS-DE-CALAIS,ESCAUDAIN,0,581,581,
Musée des Beaux-Arts,2006,NORD-PAS-DE-CALAIS,ROUBAIX,165000,0,165000,
Musée du Verre,2006,NORD-PAS-DE-CALAIS,SARS-POTERIES,2706,4332,7038,
Musée de l'Hôtel Sandelin,2006,NORD-PAS-DE-CALAIS,SAINT-OMER,9245,3590,12835,
Musée Municipal Bruno Danvin,2006,NORD-PAS-DE-CALAIS,SAINT-POL-SUR-TERNOISE,0,2920,2920,
Musée Municipal d'Avranches,2006,BASSE-NORMANDIE,AVRANCHES,1022,771,1793,
Musée de l'Abbaye,2006,BASSE-NORMANDIE,CERISY-LA-FORET,6089,0,6089,
Muséum Emmanuel Liais,2006,BASSE-NORMANDIE,CHERBOURG-EN-COTENTIN,0,22567,22567,
Musée Quesnel-Morinière,2006,BASSE-NORMANDIE,COUTANCES,1143,3270,4413,
Musée des Beaux-Arts,2006,BASSE-NORMANDIE,SAINT-LO,9367,0,9367,
Musée du Château de Flers,2006,BASSE-NORMANDIE,FLERS,2393,2537,4930,
Musée Départemental d'Art Sacré,2006,BASSE-NORMANDIE,SEES,1157,0,1157,
Musée Municipal,2006,HAUTE-NORMANDIE,BERNAY,3167,6020,9187,
Musée Alfred Canel,2006,HAUTE-NORMANDIE,PONT-AUDEMER,1431,2343,3774,
"Juliobona, Musée Gallo-Romain de Lillebonne",2006,HAUTE-NORMANDIE,LILLEBONNE,571,1332,1903,
Musée des Marais Salant,2006,PAYS DE LA LOIRE,BATZ-SUR-MER,13339,1677,15016,
Musée du Pays de Retz,2006,PAYS DE LA LOIRE,BOURGNEUF-EN-RETZ,4489,1678,6167,
Musées du Parc Naturel Régional de Brière,2006,PAYS DE LA LOIRE,SAINT-JOACHIM,3120,798,3918,
Musée Jules-Desbois,2006,PAYS DE LA LOIRE,PARCAY-LES-PINS,1475,1945,3420,
Musée Communal Robert Tatin,2006,PAYS DE LA LOIRE,COSSE-LE-VIVIEN,13825,2679,16504,
Musée des Sciences - CCSTI,2006,PAYS DE LA LOIRE,LAVAL,5430,16649,22079,
Musée de Tessé,2006,PAYS DE LA LOIRE,LE MANS,14485,14312,28797,
Musée de l'Abbaye de Sainte-Croix,2006,PAYS DE LA LOIRE,LES SABLES D'OLONNE,4825,12645,17470,
Musée Clemenceau et de Lattre-de-Tassigny,2006,PAYS DE LA LOIRE,MOUILLERON-EN-PAREDS,1722,2140,3862,
Musée Monseigneur Pigneau de Behaine,2006,PICARDIE,ORIGNY-EN-THIERACHE,0,140,140,
Musée de la Vie Rurale et Forestière,2006,PICARDIE,SAINT-MICHEL-EN-THIERACHE,3187,0,3187,
Musée de la Résistance et de la Déportation,2006,PICARDIE,TERGNIER,5922,4184,10106,
Musée Antoine Vivenel,2006,PICARDIE,COMPIEGNE,919,9472,10391,
Musée de la Figurine Historique,2006,PICARDIE,COMPIEGNE,3731,5900,9631,
Musée de la Vénerie,2006,PICARDIE,SENLIS,2229,1276,3505,
Musée Boucher-de-Perthes,2006,PICARDIE,ABBEVILLE,3768,6898,10666,
Musée-Historial de la Grande Guerre,2006,PICARDIE,PERONNE,74510,8861,83371,
Musée Régional de Fouras,2006,POITOU-CHARENTES,FOURAS,5968,5077,11045,
Musée d'Orbigny-Bernon,2006,POITOU-CHARENTES,LA ROCHELLE,1603,4723,6326,
Musée Archéologique,2006,POITOU-CHARENTES,SAINTES,1425,37027,38452,
Musée Dupuy-Mestreau,2006,POITOU-CHARENTES,SAINTES,1110,1838,2948,
Musée de l'Ile d'Oléron,2006,POITOU-CHARENTES,ST-PIERRE D'OLERON,9115,2312,11427,
Musée Bernard d’Agesci,2006,POITOU-CHARENTES,NIORT,2384,7612,9996,
Musée des Ruralies- Conservatoire du Machinisme et des Pratiques Agricoles,2006,POITOU-CHARENTES,PRAHECQ,6703,1571,8274,
"Musée de la Moto, de l'Automobile et du Vélo",2006,POITOU-CHARENTES,CHATELLERAULT,10089,1734,11823,
Musée Charbonneau-Lassay,2006,POITOU-CHARENTES,LOUDUN,192,124,316,
Musée d'Histoire et d'Archéologie,2006,PROVENCE-ALPES-CÔTE D'AZUR,ANTIBES,3105,4412,7517,
Villa-Musée Jean-Honoré Fragonard,2006,PROVENCE-ALPES-CÔTE D'AZUR,GRASSE,4164,4898,9062,
Musée d'Art et d'Histoire de Provence,2006,PROVENCE-ALPES-CÔTE D'AZUR,GRASSE,4829,19345,24174,
Musée Départemental des Arts Asiatiques,2006,PROVENCE-ALPES-CÔTE D'AZUR,NICE,14218,22421,36639,
Musée Archéologique - Site de  Cimiez,2006,PROVENCE-ALPES-CÔTE D'AZUR,NICE,8688,21573,30261,
Musée des Beaux-Arts Jules Chéret,2006,PROVENCE-ALPES-CÔTE D'AZUR,NICE,16998,29510,46508,
Musée Archéologique - Site de Terra Amata,2006,PROVENCE-ALPES-CÔTE D'AZUR,NICE,2459,12055,14514,
Ecomusée du Pays de la Roudoule,2006,PROVENCE-ALPES-CÔTE D'AZUR,PUGET-ROSTANG,954,750,1704,
Musée du Pavillon de Vendôme,2006,PROVENCE-ALPES-CÔTE D'AZUR,AIX-EN-PROVENCE,4563,9033,13596,
Musée Granet,2006,PROVENCE-ALPES-CÔTE D'AZUR,AIX-EN-PROVENCE,400264,88511,488775,
Musée Réattu,2006,PROVENCE-ALPES-CÔTE D'AZUR,ARLES,15490,9385,24875,
Musée Alphonse Daudet,2006,PROVENCE-ALPES-CÔTE D'AZUR,FONTVIEILLE,35492,804,36296,
Musée Folklorique du Vieux Lambesc,2006,PROVENCE-ALPES-CÔTE D'AZUR,LAMBESC,158,324,482,
"Musée d'Arts Africains, Océaniens, Amérindiens",2006,PROVENCE-ALPES-CÔTE D'AZUR,MARSEILLE,4328,17167,21495,
Musée de la Faïence,2006,PROVENCE-ALPES-CÔTE D'AZUR,MARSEILLE,3786,11580,15366,
Musée d'Art Contemporain - Galeries Contemporaines,2006,PROVENCE-ALPES-CÔTE D'AZUR,MARSEILLE,6671,12652,19323,
Musée d'Archéologie Méditerranéenne,2006,PROVENCE-ALPES-CÔTE D'AZUR,MARSEILLE,14697,18989,33686,
Musée des Alpilles,2006,PROVENCE-ALPES-CÔTE D'AZUR,SAINT-REMY-DE-PROVENCE,2163,3016,5179,
Musée de la Société d’Etudes Scientifiques et Achéologiques,2006,PROVENCE-ALPES-CÔTE D'AZUR,DRAGUIGNAN,0,3230,3230,
Musée Municipal,2006,PROVENCE-ALPES-CÔTE D'AZUR,HYERES,0,48614,48614,
Musée Comtadin-Duplessis,2006,PROVENCE-ALPES-CÔTE D'AZUR,CARPENTRAS,713,3059,3772,
Musée Marc Deydier,2006,PROVENCE-ALPES-CÔTE D'AZUR,CUCURON,0,3500,3500,
Musée Archéologique Théo Desplans,2006,PROVENCE-ALPES-CÔTE D'AZUR,VAISON-LA-ROMAINE,66555,2685,69240,
Musée du Brou,2006,RHONE-ALPES,BOURG-EN-BRESSE,50392,20312,70704,
Musée Chintreuil,2006,RHONE-ALPES,PONT-DE-VAUX,6093,505,6598,
Musée Vivarois César Filhol,2006,RHONE-ALPES,ANNONAY,732,1374,2106,
Musée du Château des Adhémars,2006,RHONE-ALPES,MONTELIMAR,10194,0,10194,
Musée d'Huez et de l'Oisans,2006,RHONE-ALPES,ALPE D'HUEZ,4362,190,4552,
Muséum d'Histoire Naturelle de Grenoble,2006,RHONE-ALPES,GRENOBLE,11998,54784,66782,
Musée Dauphinois,2006,RHONE-ALPES,GRENOBLE,0,53516,53516,
Musée Lapidaire Saint-Pierre,2006,RHONE-ALPES,VIENNE,1796,3741,5537,
Musée des Beaux-Arts et d'Archéologie,2006,RHONE-ALPES,VIENNE,1624,1669,3293,
Musée Hospitalier,2006,RHONE-ALPES,CHARLIEU,3769,476,4245,
Musée de la Mine / Site Couriot,2006,RHONE-ALPES,SAINT-ETIENNE,32616,29133,61749,
Château de la Bastie d'Urfé,2006,RHONE-ALPES,SAINT-ETIENNE-LE-MOLARD,11344,0,11344,
Musée Historique des Tissus,2006,RHONE-ALPES,LYON,71678,13544,85222,
Musées Gadagne,2006,RHONE-ALPES,LYON,9007,1825,10832,
Ecomusée du Haut Beaujolais,2006,RHONE-ALPES,THIZY-LES-BOURGS,454,575,1029,
Musée du docteur Faure,2006,RHONE-ALPES,AIX-LES-BAINS,5909,4565,10474,
Musée des Beaux-Arts,2006,RHONE-ALPES,CHAMBERY,3400,14572,17972,
Musée de la Folie Marco,2007,ALSACE,BARR,1550,3475,5025,
Musée de la Poterie,2007,ALSACE,BETSCHDORF,2795,316,3111,
Musée Historique,2007,ALSACE,HAGUENAU,2501,3351,5852,
Musée Historique,2007,ALSACE,STRASBOURG,16263,33102,49365,
Musée d'Art Moderne et Contemporain de Strasbourg,2007,ALSACE,STRASBOURG,38379,84672,123051,
Musée de l'Œuvre Notre-Dame,2007,ALSACE,STRASBOURG,12839,25823,38662,
Musée Sundgauvien d'Altkirch,2007,ALSACE,ALTKIRCH,1491,6511,8002,
Musée d'Histoire Local,2007,ALSACE,KAYSERSBERG,312,85,397,
Musée du Vignoble et des Vins d'Alsace,2007,ALSACE,KAYSERSBERG VIGNOBLE,5030,20,5050,
Musée Minéralogique de la Société Industrielle de Mulhouse,2007,ALSACE,MULHOUSE,0,280,280,
Musée du Dolder,2007,ALSACE,RIQUEWIHR,2892,294,3186,
Musée des Amis de Thann,2007,ALSACE,THANN,648,5822,6470,
Musée National de la Préhistoire,2007,AQUITAINE,LES EYZIES-DE-TAYAC,48629,34745,83374,
Musée d'Aquitaine,2007,AQUITAINE,BORDEAUX,10668,82993,93661,
CAPC Musée d'Art Contemporain de Bordeaux,2007,AQUITAINE,BORDEAUX,21482,77535,99017,
Atelier-Musée  (Ecomusée de la Grande Landes),2007,AQUITAINE,LUXEY,6170,352,6522,
Musée Despiau-Wlérick,2007,AQUITAINE,MONT-DE-MARSAN,1107,13070,14177,
Ecomusée de la Grande Lande,2007,AQUITAINE,SABRES,76274,10944,87218,
Musée Municipal Albert Marzelles,2007,AQUITAINE,MARMANDE,0,5749,5749,
Musée Municipal,2007,AQUITAINE,ARUDY,1429,790,2219,
Musée des Musiques Populaires - MuPop,2007,AUVERGNE,MONTLUCON,1076,3624,4700,
Musée Anne de Beaujeu,2007,AUVERGNE,MOULINS,2405,4046,6451,
Musée Municipal de Souvigny,2007,AUVERGNE,SOUVIGNY,5123,2168,7291,
Musée des Manufactures de Dentelles,2007,AUVERGNE,RETOURNAC,2838,1746,4584,
Musée Municipal Marcel Sahut,2007,AUVERGNE,VOLVIC,904,2583,3487,
Musée François Rude,2007,BOURGOGNE,DIJON,0,33769,33769,
Musée d'Art Sacré,2007,BOURGOGNE,DIJON,0,7708,7708,
Muséum - Jardin des Sciences,2007,BOURGOGNE,DIJON,14363,85754,100117,
Musée des Beaux-Arts,2007,BOURGOGNE,DIJON,0,157511,157511,
Musée des Arts et Traditions des Hautes-Côtes,2007,BOURGOGNE,GEVREY-CHAMBERTIN - Reulle Vergy,200,2500,2700,
Musée Municipal François Pompon,2007,BOURGOGNE,SAULIEU,3033,1151,4184,
Musée d'Art et d'Histoire Romain Rolland,2007,BOURGOGNE,CLAMECY,1892,4316,6208,
Musée de la Loire,2007,BOURGOGNE,COSNE-SUR-LOIRE,1224,2493,3717,
Musée Municipal,2007,BOURGOGNE,LA CHARITE-SUR-LOIRE,455,229,684,
Musée Auguste Grasset,2007,BOURGOGNE,VARZY,1064,733,1797,
Musée de la Mine,2007,BOURGOGNE,BLANZY,10545,1325,11870,
Musée Saint-Nazaire,2007,BOURGOGNE,BOURBON-LANCY,75,1524,1599,
Musée Denon,2007,BOURGOGNE,CHALON-SUR-SAONE,1071,10575,11646,
Musée René Davoine,2007,BOURGOGNE,CHAROLLES,0,150,150,
Musée d'Art et d'Archéologie,2007,BOURGOGNE,CLUNY,86929,21369,108298,
"L'Atelier d'un Journal"" de Louhans - Musée Municipal",2007,BOURGOGNE,LOUHANS,1858,757,2615,
Hôtel Dieu - Musée Greuze,2007,BOURGOGNE,TOURNUS,9995,1431,11426,
Musée d'Art et d'Histoire,2007,BOURGOGNE,AUXERRE,9931,25242,35173,
Musée d'Art et d'Histoire,2007,BRETAGNE,SAINT-BRIEUC,0,38592,38592,
Musée des Beaux-Arts de Brest,2007,BRETAGNE,BREST,2133,12983,15116,
Musée National de la Marine,2007,BRETAGNE,BREST,37572,25489,63061,
Musée Bigouden,2007,BRETAGNE,PONT-L'ABBE,9903,2735,12638,
Musée Départemental Breton,2007,BRETAGNE,QUIMPER,29748,19649,49397,
Ecomusée du Pays de Montfort,2007,BRETAGNE,MONTFORT-SUR-MEU,2005,1725,3730,
Musée des Beaux-Arts,2007,BRETAGNE,RENNES,16232,43084,59316,
Musée de Bretagne,2007,BRETAGNE,RENNES,39444,14837,54281,
Musée des Rochers-Sévigné,2007,BRETAGNE,VITRE,5488,2173,7661,
Ecomusée de Saint-Dégan,2007,BRETAGNE,BREC'H,12042,2487,14529,
Musée de la Compagnie des Indes,2007,BRETAGNE,PORT-LOUIS,41465,20625,62090,
Musée d'Histoire Naturelle Gabriel Foucher,2007,CENTRE,BOURGES,9597,18175,27772,
Musée Emile Chénon,2007,CENTRE,CHATEAUMEILLANT,667,949,1616,
Musée des Beaux-Arts,2007,CENTRE,CHARTRES,8693,5907,14600,
Conservatoire du Machinisme et des Pratiques Agricoles,2007,CENTRE,CHARTRES-MAINVILLIERS,12144,42556,54700,
Château Musée,2007,CENTRE,AZAY-LE-FERRON,10647,4022,14669,
Musée Ornithologique (Ecomusée de la Brenne),2007,CENTRE,LE BLANC,3968,2589,6557,
Musée Archéologique d'Argentomagus,2007,CENTRE,SAINT-MARCEL,9323,7808,17131,
Musée Municipal,2007,CENTRE,SAINTE-MAURE-DE-TOURAINE,65,30,95,
Ecomusée du Véron,2007,CENTRE,SAVIGNY-EN-VERON,9023,0,9023,
Musée des Vins de Touraine,2007,CENTRE,TOURS,2066,824,2890,
Musée des Beaux-Arts,2007,CENTRE,TOURS,19524,34051,53575,
Musée de l'Hôtel Goüin,2007,CENTRE,TOURS,622,14084,14706,
Musée Girodet,2007,CENTRE,MONTARGIS,2871,3342,6213,
Musée des Sciences Naturelles,2007,CENTRE,ORLEANS,7141,53756,60897,
Musée Arthur Rimbaud,2007,CHAMPAGNE-ARDENNES,CHARLEVILLE-MEZIERES,11303,5549,16852,
Musée de l'Ardenne,2007,CHAMPAGNE-ARDENNES,CHARLEVILLE-MEZIERES,3937,40176,44113,
Musée de la Coutellerie,2007,CHAMPAGNE-ARDENNES,NOGENT,4539,1133,5672,
Musée Municipal,2007,CHAMPAGNE-ARDENNES,CHALONS-EN-CHAMPAGNE,2840,9252,12092,
Musée Napoléonien,2007,CORSE,AJACCIO,9281,3221,12502,
Musée Beurnier-Rossel,2007,FRANCHE-COMTE,MONTBELIARD,1055,4105,5160,
Musée du Château des Ducs de Wurtemberg,2007,FRANCHE-COMTE,MONTBELIARD,9217,17199,26416,
Musée-Maison Natale Gustave Courbet,2007,FRANCHE-COMTE,ORNANS,17021,2681,19702,
Musée Départemental de la Montagne Albert Demard,2007,FRANCHE-COMTE,LE HAUT-DU-THEM,4446,3582,8028,
Musée Georges Garret,2007,FRANCHE-COMTE,VESOUL,0,3531,3531,
Musée d'Archéologie,2007,FRANCHE-COMTE,LONS-LE-SAUNIER,905,383,1288,
Musée des Beaux-Arts,2007,FRANCHE-COMTE,LONS-LE-SAUNIER,878,3363,4241,
Viséum-Musée de la Lunette,2007,FRANCHE-COMTE,MOREZ HAUTS DE BIENNE,12393,2229,14622,
Musée des Salines,2007,FRANCHE-COMTE,SALINS-LES-BAINS,44045,5009,49054,
Musée de l'Artisanat Jurassien,2007,FRANCHE-COMTE,VOITEUR,0,10115,10115,
Musée Frédéric Japy,2007,FRANCHE-COMTE,BEAUCOURT,1391,940,2331,
Musée Départemental Victor Schoelcher,2007,GUADELOUPE,POINTE-A-PITRE,3100,779,3879,
Musée du Château,2007,ILE-DE-FRANCE,DOURDAN,10455,7496,17951,
Musée National des Châteaux de Malmaison et de Bois-Préau,2007,ILE-DE-FRANCE,RUEIL-MALMAISON,35524,25158,60682,
Musée Municipal de Saint-Cloud,2007,ILE-DE-FRANCE,SAINT-CLOUD,0,3675,3675,
Musée de l'Île-de-France,2007,ILE-DE-FRANCE,SCEAUX,0,93311,93311,
Grande Galerie de l'Evolution (Muséum National d'Histoire Naturelle),2007,ILE-DE-FRANCE,PARIS,375168,170032,545200,
Galerie d'Anatomie Comparée et de Paléontologie (Muséum d'Histoire Naturelle),2007,ILE-DE-FRANCE,PARIS,189700,50755,240455,
Galerie de Minéralogie et de Géologie (Muséum d'Histoire Naturelle),2007,ILE-DE-FRANCE,PARIS,32308,8713,41021,
Maison de Victor Hugo,2007,ILE-DE-FRANCE,PARIS,18398,111464,129862,
Musée National Gustave Moreau,2007,ILE-DE-FRANCE,PARIS,18751,13841,32592,
Musée National de la Légion d'Honneur et des Ordres de Chevalerie,2007,ILE-DE-FRANCE,PARIS,0,45000,45000,
Musée de la Vie Romantique,2007,ILE-DE-FRANCE,PARIS,23460,39157,62617,
Maison de Balzac,2007,ILE-DE-FRANCE,PARIS,3728,17071,20799,
Musée Zadkine,2007,ILE-DE-FRANCE,PARIS,7840,9600,17440,
Musée Galliera - Musée de la Mode de la ville de Paris,2007,ILE-DE-FRANCE,PARIS,53819,22850,76669,
Musée National Auguste Rodin,2007,ILE-DE-FRANCE,PARIS,468452,222223,690675,
Musée du Service de Santé des Armées du Val-de-Grâce,2007,ILE-DE-FRANCE,PARIS,5350,6296,11646,
Musée Départemental de l'Ecole de Barbizon - Auberge Ganne,2007,ILE-DE-FRANCE,BARBIZON,18182,6975,25157,
Musée Municipal de Chelles Alfred Bonno,2007,ILE-DE-FRANCE,CHELLES,0,2955,2955,
Musée Municipal des Capucins,2007,ILE-DE-FRANCE,COULOMMIERS,1293,2037,3330,
Musée d'Art et d'Histoire Militaire,2007,ILE-DE-FRANCE,FONTAINEBLEAU,992,5022,6014,
Musée d'Art et d'Histoire de Melun,2007,ILE-DE-FRANCE,MELUN,6802,0,6802,
Musée de Provins et du Provinois,2007,ILE-DE-FRANCE,PROVINS,21180,0,21180,
Musée de l'Histoire Vivante,2007,ILE-DE-FRANCE,MONTREUIL-SOUS-BOIS,2320,2000,4320,
Musée de Saint-Maur - Villa Médicis,2007,ILE-DE-FRANCE,LA VARENNE-SAINT-HILAIRE,0,8828,8828,
Musée de la Batellerie et des Voies Navigables,2007,ILE-DE-FRANCE,CONFLANS-SAINTE-HONORINE,9514,2074,11588,
Musée du Jouet Pierre Pinel,2007,ILE-DE-FRANCE,POISSY,13333,4813,18146,
Musée Départemental Maurice Denis,2007,ILE-DE-FRANCE,SAINT-GERMAIN-EN-LAYE,30293,5950,36243,
Etablissement Public du Musée et du Domaine National de Versailles,2007,ILE-DE-FRANCE,VERSAILLES,4310884,1015433,5326317,
Musée Archéologique,2007,LANGUEDOC-ROUSSILLON,SALLELES D'AUDE,10050,0,10050,
Musée des Corbières,2007,LANGUEDOC-ROUSSILLON,SIGEAN,55,231,286,
Musée Municipal de la Vignasse,2007,LANGUEDOC-ROUSSILLON,BEAUCAIRE,513,2323,2836,
Musée Municipal Georges Borias,2007,LANGUEDOC-ROUSSILLON,UZES,1149,967,2116,
Musée Pierre de Luxembourg,2007,LANGUEDOC-ROUSSILLON,VILLENEUVE-LES-AVIGNON,4991,3049,8040,
Musée des Beaux-Arts de Béziers,2007,LANGUEDOC-ROUSSILLON,BEZIERS,2858,13607,16465,
Muséum d'Histoire Naturelle,2007,LANGUEDOC-ROUSSILLON,PERPIGNAN,808,2518,3326,
Musée du Cloître de Tulle André Mazeyrie,2007,LIMOUSIN,TULLE,2873,26224,29097,
Musée du Pays d'Ussel,2007,LIMOUSIN,USSEL,0,2322,2322,
Musée Départemental de la Tapisserie,2007,LIMOUSIN,AUBUSSON,20900,4546,25446,
Musée Municipal des Emaux et Faïences,2007,LORRAINE,LONGWY,6874,0,6874,
Musée de la Bière et du Pays de Stenay,2007,LORRAINE,STENAY,5735,5054,10789,
Musée du Pays de Sarrebourg,2007,LORRAINE,SARREBOURG,4391,6352,10743,
"Jardin d'Hiver, Musée de La Faïence",2007,LORRAINE,SARREGUEMINES,5790,5357,11147,
Musée de la Lutherie et de l'Archèterie Française,2007,LORRAINE,MIRECOURT,6260,3783,10043,
Musée Charles de Bruyères,2007,LORRAINE,REMIREMONT,1547,6688,8235,
Ecomusée de la Martinique,2007,MARTINIQUE,RIVIERE-PILOTE,8351,1719,10070,
Musée Volcanologique Franck Arnold Perret,2007,MARTINIQUE,SAINT-PIERRE,32566,55,32621,
Musée des Beaux-Arts Denys Puech,2007,MIDI-PYRENEES,RODEZ,3210,13651,16861,
Musée Archéologique,2007,MIDI-PYRENEES,EAUZE,4813,1162,5975,
Musée Municipal,2007,MIDI-PYRENEES,MARTRES-TOLOSANE,0,3878,3878,
Musée des Augustins,2007,MIDI-PYRENEES,TOULOUSE,41863,58209,100072,
Muséum d'Histoire Naturelle,2007,MIDI-PYRENEES,BAGNERES-DE-BIGORRE,2148,560,2708,
Musée Salies,2007,MIDI-PYRENEES,BAGNERES-DE-BIGORRE,5205,560,5765,
Musée Pyrénéen,2007,MIDI-PYRENEES,LOURDES,75580,3612,79192,
Musée Municipal - Musée Trésor,2007,MIDI-PYRENEES,LUZ-SAINT-SAUVEUR,757,0,757,
Musée Henri Martin,2007,MIDI-PYRENEES,CAHORS,3374,5236,8610,
Musée Murat,2007,MIDI-PYRENEES,CŒUR DE CAUSSE,945,0,945,
Musée du Vieux Figeac,2007,MIDI-PYRENEES,FIGEAC,1193,391,1584,
Musée Départemental de Cuzals,2007,MIDI-PYRENEES,SAULIAC-SUR-CELE,8139,2295,10434,
Musée de l'Automate,2007,MIDI-PYRENEES,SOUILLAC,23108,5024,28132,
Musée Goya,2007,MIDI-PYRENEES,CASTRES,14895,12865,27760,
Musée du Pays Vaurais,2007,MIDI-PYRENEES,LAVAUR,500,0,500,
Musée d'Histoire Naturelle Victor Brun,2007,MIDI-PYRENEES,MONTAUBAN,897,4473,5370,
Musée Benoît de Puydt,2007,NORD-PAS-DE-CALAIS,BAILLEUL,7952,0,7952,
Musée de l'Ostrevant,2007,NORD-PAS-DE-CALAIS,BOUCHAIN,251,452,703,
Musée d'Archéologie et d'Histoire Locale,2007,NORD-PAS-DE-CALAIS,DENAIN,0,2600,2600,
Musée Portuaire,2007,NORD-PAS-DE-CALAIS,DUNKERQUE,28287,21425,49712,
Musée des Beaux-Arts,2007,NORD-PAS-DE-CALAIS,ROUBAIX,115735,103669,219404,
Musée des Beaux-Arts,2007,NORD-PAS-DE-CALAIS,ARRAS,9144,19184,28328,
Musée Municipal,2007,NORD-PAS-DE-CALAIS,LE TOUQUET-PARIS-PLAGE,4614,4913,9527,
Musée Baron Gérard,2007,BASSE-NORMANDIE,BAYEUX,5531,16007,21538,
Musée de Trouville - Villa Montebello,2007,BASSE-NORMANDIE,TROUVILLE-SUR-MER,4448,6695,11143,
Musée Municipal,2007,BASSE-NORMANDIE,EQUEURDREVILLLE-HAINNEVILLE,0,3980,3980,
Musée du Vieux Granville,2007,BASSE-NORMANDIE,GRANVILLE,7049,4874,11923,
"Musée du Bocage Normand, ferme du bois Jugan",2007,BASSE-NORMANDIE,SAINT-LO,3089,2853,5942,
Musée Maritime de l'Ile de Tatihou,2007,BASSE-NORMANDIE,SAINT-VAAST-LA-HOUGUE,53995,3148,57143,
Musée des Beaux-Arts et de la Dentelle,2007,BASSE-NORMANDIE,ALENCON,10277,4378,14655,
Musée Municipal - Musée du Jouet,2007,BASSE-NORMANDIE,LA FERTE-MACE,821,26,847,
Musée Départemental des Arts et Traditions Populaires du Perche,2007,BASSE-NORMANDIE,SAINT-CYR LA ROSIERE,12581,8176,20757,
Musée Municipal Nicolas Poussin,2007,HAUTE-NORMANDIE,LES ANDELYS,933,1553,2486,
Musée Municipal,2007,HAUTE-NORMANDIE,LOUVIERS,164,6942,7106,
Pavillon Flaubert,2007,HAUTE-NORMANDIE,CANTELEU,0,614,614,
Musée Départemental Pierre Corneille,2007,HAUTE-NORMANDIE,LE PETIT-COURONNE,902,3030,3932,
Muséum d'Histoire Naturelle,2007,HAUTE-NORMANDIE,ROUEN,18617,60056,78673,
Musée Municipal des Ivoires,2007,HAUTE-NORMANDIE,YVETOT,1021,528,1549,
Musée des Marais Salant,2007,PAYS DE LA LOIRE,BATZ-SUR-MER,14273,1718,15991,
Musée du Pays de Guérande et de la Porte Saint Michel,2007,PAYS DE LA LOIRE,GUERANDE,18655,7125,25780,
Musée du Vignoble Nantais,2007,PAYS DE LA LOIRE,LE PALLET,5020,1623,6643,
Musée du Château des Ducs de Bretagne,2007,PAYS DE LA LOIRE,NANTES,179893,104738,284631,
Muséum des Sciences Naturelles,2007,PAYS DE LA LOIRE,ANGERS,3346,11207,14553,
Musée du Textile,2007,PAYS DE LA LOIRE,CHOLET,5667,6580,12247,
Château-Musée,2007,PAYS DE LA LOIRE,SAUMUR,22829,9048,31877,
Musée Archéologique Départemental de Jublains,2007,PAYS DE LA LOIRE,JUBLAINS,9289,23141,32430,
Musée de l'Ardoise et de la Géologie,2007,PAYS DE LA LOIRE,RENAZE,1504,1340,2844,
Musée Municipal,2007,PAYS DE LA LOIRE,LA ROCHE-SUR-YON,0,8395,8395,
Familistère de Guise,2007,PICARDIE,GUISE,28482,0,28482,
Musée de La Thiérache,2007,PICARDIE,VERVINS,0,1551,1551,
Musée Départemental de l'Oise,2007,PICARDIE,BEAUVAIS,0,21185,21185,
Musée Jean Calvin,2007,PICARDIE,NOYON,1837,1264,3101,
Musée d'Art et d'Archéologie,2007,PICARDIE,SENLIS,3234,0,3234,
Musée Boucher-de-Perthes,2007,PICARDIE,ABBEVILLE,5486,3230,8716,
Musée Alfred Danicourt,2007,PICARDIE,PERONNE,0,900,900,
Musée Municipal de Cognac,2007,POITOU-CHARENTES,COGNAC,2122,15515,17637,
Musée de la Mytiliculture,2007,POITOU-CHARENTES,ESNANDES,3440,58,3498,
Musée du Nouveau Monde,2007,POITOU-CHARENTES,LA ROCHELLE,3938,5048,8986,
Musée Protestant,2007,POITOU-CHARENTES,LA ROCHELLE,1412,658,2070,
Musée Archéologique,2007,POITOU-CHARENTES,SAINTES,1373,62100,63473,
Musée du Présidial,2007,POITOU-CHARENTES,SAINTES,810,2070,2880,
Musée Dupuy-Mestreau,2007,POITOU-CHARENTES,SAINTES,1631,2126,3757,
Musée ethnographique et archéologique du Donjon,2007,POITOU-CHARENTES,NIORT,1049,3275,4324,
Musée Bernard d’Agesci,2007,POITOU-CHARENTES,NIORT,3795,10070,13865,
Musée Rupert de Chièvres,2007,POITOU-CHARENTES,POITIERS,616,2596,3212,
Musée Sainte-Croix,2007,POITOU-CHARENTES,POITIERS,4162,17813,21975,
Musée Archéologique,2007,PROVENCE-ALPES-CÔTE D'AZUR,RIEZ-LA-ROMAINE,919,194,1113,
Musée d'Histoire Locale,2007,PROVENCE-ALPES-CÔTE D'AZUR,BIOT,3723,4595,8318,
Musée du Vieux-Logis de Nice,2007,PROVENCE-ALPES-CÔTE D'AZUR,NICE,0,242,242,
Musée du Palais Lascaris,2007,PROVENCE-ALPES-CÔTE D'AZUR,NICE,0,66363,66363,
Musée Matisse,2007,PROVENCE-ALPES-CÔTE D'AZUR,NICE,42140,29436,71576,
Musée- Atelier de Paul Cézanne,2007,PROVENCE-ALPES-CÔTE D'AZUR,AIX-EN-PROVENCE,74338,0,74338,
Musée Ciotaden,2007,PROVENCE-ALPES-CÔTE D'AZUR,LA CIOTAT,4160,4165,8325,
Musée Grobet-Labadié,2007,PROVENCE-ALPES-CÔTE D'AZUR,MARSEILLE,2274,6506,8780,
Musée Municipal Paul Lafran,2007,PROVENCE-ALPES-CÔTE D'AZUR,SAINT-CHAMAS,0,2035,2035,
Musée du Pays Brignolais,2007,PROVENCE-ALPES-CÔTE D'AZUR,BRIGNOLES,2792,1784,4576,
Musée Archéologique,2007,PROVENCE-ALPES-CÔTE D'AZUR,SAINT-RAPHAËL,0,17749,17749,
Muséum d'Histoire Naturelle de Toulon,2007,PROVENCE-ALPES-CÔTE D'AZUR,TOULON,0,43666,43666,
Musée du Brou,2007,RHONE-ALPES,BOURG-EN-BRESSE,50224,15538,65762,
Musée de la Résistance et de la Déportation de l'Ain,2007,RHONE-ALPES,NANTUA,6800,1739,8539,
Cité de Préhistoire,2007,RHONE-ALPES,ORGNAC-L'AVEN,130448,6889,137337,
Musée d'Histoire et d'Archéologie,2007,RHONE-ALPES,DIE,720,1733,2453,
Musée d'Archéologie Tricastine,2007,RHONE-ALPES,SAINT-PAUL-TROIS-CHATEAUX,395,2887,3282,
Musée Jadis Allevard,2007,RHONE-ALPES,ALLEVARD-LES-BAINS,1177,3212,4389,
Musée de Bourgoin-Jallieu,2007,RHONE-ALPES,BOURGOIN-JALLIEU,6951,0,6951,
Musée - Parc Archéologique du Lac de Paladru,2007,RHONE-ALPES,CHARAVINES,13029,0,13029,
Musée Géo-Charles,2007,RHONE-ALPES,ECHIROLLES,0,5505,5505,
Musée de la Résistance de la Déportation de l'Isère,2007,RHONE-ALPES,GRENOBLE,0,22702,22702,
Musée Hébert,2007,RHONE-ALPES,LA TRONCHE,0,25785,25785,
Musée des Beaux-Arts et d'Archéologie J. Dechelette,2007,RHONE-ALPES,ROANNE,3167,11508,14675,
Musée d'Art Moderne et Contemporain,2007,RHONE-ALPES,SAINT-ETIENNE,31531,18937,50468,
Musée de la Mine / Site Couriot,2007,RHONE-ALPES,SAINT-ETIENNE,30311,22083,52394,
Lugdunum - Musée et Théâtres Romains,2007,RHONE-ALPES,LYON,26354,58601,84955,
Musée Henri Malartre,2007,RHONE-ALPES,ROCHETAILLEE-SUR-SAONE,39397,0,39397,
Ecomusée du Haut Beaujolais,2007,RHONE-ALPES,THIZY-LES-BOURGS,860,643,1503,
Musée archéologique et minéralogique Pierre Borrione,2007,RHONE-ALPES,AIME-EN-TARENTAISE,984,506,1490,
Musée du docteur Faure,2007,RHONE-ALPES,AIX-LES-BAINS,6466,5325,11791,
Musée Savoisien,2007,RHONE-ALPES,CHAMBERY,4885,11408,16293,
Musée des Charmettes,2007,RHONE-ALPES,CHAMBERY,0,11572,11572,
Musée d'Art Moderne et Contemporain de Strasbourg,2008,ALSACE,STRASBOURG,39666,88215,127881,
Musée Zoologique de Strasbourg,2008,ALSACE,STRASBOURG,11024,31553,42577,
Musée Tomi Ungerer,2008,ALSACE,STRASBOURG,25921,34592,60513,
Musée J.F. Oberlin,2008,ALSACE,WALDERSBACH,19575,3889,23464,
Musée Sundgauvien d'Altkirch,2008,ALSACE,ALTKIRCH,3048,2494,5542,
Musée de la Porte de Thann,2008,ALSACE,CERNAY,260,620,880,
Musée du Florival,2008,ALSACE,GUEBWILLER,2278,4146,6424,
Musée Historique,2008,ALSACE,MULHOUSE,0,35478,35478,
Musée Vauban,2008,ALSACE,NEUF-BRISACH,4275,0,4275,
Ecomusée d'Alsace,2008,ALSACE,UNGERSHEIM,154557,20431,174988,
Musée Fernand Desmoulin,2008,AQUITAINE,BRANTOME,17984,989,18973,
Musée du Site Médiéval,2008,AQUITAINE,SAINT-AVIT-SENIEUR,874,0,874,
Musée des Beaux-Arts,2008,AQUITAINE,BORDEAUX,49945,72235,122180,
Atelier-Musée  (Ecomusée de la Grande Landes),2008,AQUITAINE,LUXEY,2502,181,2683,
Musée Despiau-Wlérick,2008,AQUITAINE,MONT-DE-MARSAN,0,10807,10807,
Musée d'Art et d'Histoire du Cap de Gascogne,2008,AQUITAINE,SAINT-SEVER,0,1500,1500,
Musée de la Faïence et des arts de la table,2008,AQUITAINE,SAMADET,0,7472,7472,
Musée du Château Henri IV,2008,AQUITAINE,NERAC,16684,4986,21670,
Musée Bonnat,2008,AQUITAINE,BAYONNE,13665,15464,29129,
Musée Municipal de Guéthary,2008,AQUITAINE,GUETHARY,1137,1642,2779,
Musée Bernadotte,2008,AQUITAINE,PAU,2360,1766,4126,
Musée Anne de Beaujeu,2008,AUVERGNE,MOULINS,2807,4899,7706,
Musée de Paléontologie,2008,AUVERGNE,CHILHAC,1438,20,1458,
Musée de la Dentelle,2008,AUVERGNE,ARLANC,1142,47,1189,
Musée Lapidaire,2008,AUVERGNE,MOZAC,295,678,973,
Musée Municipal Marcel Sahut,2008,AUVERGNE,VOLVIC,587,795,1382,
Musée Bonaparte,2008,BOURGOGNE,AUXONNE,0,2091,2091,
Musée François Rude,2008,BOURGOGNE,DIJON,0,35454,35454,
Musée Archéologique,2008,BOURGOGNE,DIJON,0,23630,23630,
Musée des Beaux-Arts,2008,BOURGOGNE,DIJON,0,160263,160263,
Musée Municipal François Pompon,2008,BOURGOGNE,SAULIEU,2992,1281,4273,
Musée Municipal,2008,BOURGOGNE,SEMUR-EN-AUXOIS,76,4924,5000,
Musée du Septennat,2008,BOURGOGNE,CHATEAU-CHINON,14433,2258,16691,
Musée du Costume,2008,BOURGOGNE,CHATEAU-CHINON,5650,1051,6701,
Musée Municipal,2008,BOURGOGNE,LA CHARITE-SUR-LOIRE,508,268,776,
Musée Saint-Nazaire,2008,BOURGOGNE,BOURBON-LANCY,83,2024,2107,
Musée Nicéphore Niepce,2008,BOURGOGNE,CHALON-SUR-SAONE,1876,19519,21395,
Ecomusée de la Communauté Le Creusot-Monceau-Les-Mines,2008,BOURGOGNE,LE CREUSOT,13350,5089,18439,
Maison du Blé et du Pain,2008,BOURGOGNE,VERDUN-SUR-LE-DOUBS,3058,1100,4158,
Musée Villeneuvien,2008,BOURGOGNE,VILLENEUVE-SUR-YONNE,0,2300,2300,
Musée du Château de Dinan,2008,BRETAGNE,DINAN,13158,8237,21395,
Musée d'Art et d'Histoire,2008,BRETAGNE,SAINT-BRIEUC,0,35859,35859,
Le Port-Musée,2008,BRETAGNE,DOUARNENEZ,31132,13364,44496,
Musée des Beaux-Arts,2008,BRETAGNE,QUIMPER,28949,26695,55644,
Ecomusée du Pays de Rennes,2008,BRETAGNE,RENNES,12377,26649,39026,
Musée de Préhistoire J. Miln- Z. Le-Rouzic,2008,BRETAGNE,CARNAC,25157,6157,31314,
Ecomusée de l'Île de Groix,2008,BRETAGNE,ILE DE GROIX,7168,1028,8196,
Musée d'Art et d'Histoire de Dreux,2008,CENTRE,DREUX,1971,6164,8135,
Musée Marcel Proust,2008,CENTRE,ILLIERS-COMBRAY,4141,352,4493,
Musée de l'Histoire du Perche,2008,CENTRE,NOGENT-LE-ROTROU,10924,6728,17652,
"""Maison Musée"" René Descartes",2008,CENTRE,DESCARTES,1469,1196,2665,
Musée Balzac,2008,CENTRE,SACHE,17844,5374,23218,
Musée de Sologne,2008,CENTRE,ROMORANTIN-LANTHENAY,16987,0,16987,
Musée de l'Ardenne,2008,CHAMPAGNE-ARDENNES,CHARLEVILLE-MEZIERES,3626,38084,41710,
Musée du Feutre,2008,CHAMPAGNE-ARDENNES,MOUZON,3971,1680,5651,
Musée Paul Dubois-Alfred Boucher,2008,CHAMPAGNE-ARDENNES,NOGENT-SUR-SEINE,1538,1956,3494,
Pharmacie Musée de l'Hôtel-Dieu,2008,CHAMPAGNE-ARDENNES,TROYES,3343,4443,7786,
Musée de la Coutellerie,2008,CHAMPAGNE-ARDENNES,NOGENT,4579,746,5325,
Planétarium/Musée de l'Ancien Collège des Jésuites,2008,CHAMPAGNE-ARDENNES,REIMS,2816,24073,26889,
Musée Départemental Pascal Paoli,2008,CORSE,MOROSAGLIA,7000,1930,8930,
Musée des Beaux-Arts et d'Archéologie,2008,FRANCHE-COMTE,BESANCON,12572,52688,65260,
Musée Beurnier-Rossel,2008,FRANCHE-COMTE,MONTBELIARD,1077,3630,4707,
Musée des Beaux-Arts,2008,FRANCHE-COMTE,DOLE,0,23258,23258,
Viséum-Musée de la Lunette,2008,FRANCHE-COMTE,MOREZ HAUTS DE BIENNE,9710,4596,14306,
Musée Français de la Photographie,2008,ILE-DE-FRANCE,BIEVRES,3620,842,4462,
Musée du Château,2008,ILE-DE-FRANCE,DOURDAN,10288,5610,15898,
Fondation Arp,2008,ILE-DE-FRANCE,CLAMART,1310,290,1600,
Musée Municipal d'Art et d'Histoire,2008,ILE-DE-FRANCE,COLOMBES,0,4966,4966,
Musée du Moyen Age-Thermes et Hôtel de Cluny,2008,ILE-DE-FRANCE,PARIS,87761,272339,360100,
Musée de l'Orangerie,2008,ILE-DE-FRANCE,PARIS,408459,135295,543754,
Musée de la Vie Romantique,2008,ILE-DE-FRANCE,PARIS,32504,47295,79799,
Musée de Montmartre,2008,ILE-DE-FRANCE,PARIS,38923,3936,42859,
Etablissement Public du Musée des Arts Asiatiques Guimet,2008,ILE-DE-FRANCE,PARIS,153011,207005,360016,
Musée des Monuments Français,2008,ILE-DE-FRANCE,PARIS,185958,137657,323615,
Mémorial du Maréchal Leclerc de Hauteclocque et de la Libération de Paris-musée Jean Moulin,2008,ILE-DE-FRANCE,PARIS,0,16926,16926,
Etablissement public de la Porte Dorée - Cité Nationale de l’Histoire de l’Immigration,2008,ILE-DE-FRANCE,PARIS,34126,59499,93625,
Musée du Louvre,2008,ILE-DE-FRANCE,PARIS,5699810,2722397,8422207,
Musée des Arts Décoratifs (Union Centrale des Arts Décoratifs),2008,ILE-DE-FRANCE,PARIS,282551,133044,415595,
Musée Départemental de l'Ecole de Barbizon - Auberge Ganne,2008,ILE-DE-FRANCE,BARBIZON,13561,7839,21400,
Musée Départemental de Préhistoire d'Île de France,2008,ILE-DE-FRANCE,NEMOURS,3470,21597,25067,
Musée de l'Histoire Vivante,2008,ILE-DE-FRANCE,MONTREUIL-SOUS-BOIS,1176,1922,3098,
Ecomusée du Val de Bièvre,2008,ILE-DE-FRANCE,FRESNES,0,11659,11659,
Musée Fragonard,2008,ILE-DE-FRANCE,MAISONS-ALFORT,1949,1099,3048,
Musée Archéologique du Val d'Oise,2008,ILE-DE-FRANCE,GUIRY-EN-VEXIN,9903,2688,12591,
Musée jean-Jacques Rousseau,2008,ILE-DE-FRANCE,MONTMORENCY,770,1972,2742,
Musée Camille Pissarro,2008,ILE-DE-FRANCE,PONTOISE,0,4634,4634,
Musée Promenade Marly/Louveciennes,2008,ILE-DE-FRANCE,LOUVECIENNES,4706,2301,7007,
Musée Départemental Maurice Denis,2008,ILE-DE-FRANCE,SAINT-GERMAIN-EN-LAYE,20716,3499,24215,
Musée des Beaux-Arts,2008,LANGUEDOC-ROUSSILLON,CARCASSONNE,0,66062,66062,
Musée Léon Alègre,2008,LANGUEDOC-ROUSSILLON,BAGNOLS-SUR-CEZE,0,1472,1472,
Musée Départemental d'Art Sacré du Gard,2008,LANGUEDOC-ROUSSILLON,PONT-SAINT-ESPRIT,93,9863,9956,
Musée de la Maison Romane,2008,LANGUEDOC-ROUSSILLON,SAINT-GILLES-DU-GARD,0,6689,6689,
Musée des Vallées Cévenoles,2008,LANGUEDOC-ROUSSILLON,SAINT-JEAN DU GARD,9061,7124,16185,
Site Archéologique Lattara - Musée Henri Prades de Montpellier Agglomération,2008,LANGUEDOC-ROUSSILLON,LATTES,7159,8676,15835,
Musée Fleury,2008,LANGUEDOC-ROUSSILLON,LODEVE,38735,11613,50348,
Agropolis-Muséum,2008,LANGUEDOC-ROUSSILLON,MONTPELLIER,10052,0,10052,
Musée de Vulliod Saint-Germain,2008,LANGUEDOC-ROUSSILLON,PEZENAS,2104,1733,3837,
Muséum d'Histoire Naturelle,2008,LANGUEDOC-ROUSSILLON,PERPIGNAN,1093,5015,6108,
Musée de l'Histoire du Fer,2008,LORRAINE,JARVILLE-LA-MALGRANGE,2246,5034,7280,
Maison du Verre et du Cristal,2008,LORRAINE,MEISENTHAL,15256,492,15748,
Musée Départemental Georges de la Tour,2008,LORRAINE,VIC-SUR-SEILLE,4128,10045,14173,
Musée de La Canne,2008,MARTINIQUE,LES TROIS ILETS,12100,2641,14741,
Musée du Textile et du Peigne en Corne,2008,MIDI-PYRENEES,LAVELANET,2189,0,2189,
Musée Municipal de Millau,2008,MIDI-PYRENEES,MILLAU,6610,12051,18661,
Musée Fenaille,2008,MIDI-PYRENEES,RODEZ,9396,14067,23463,
Musée Joseph Abeilhé,2008,MIDI-PYRENEES,MARCIAC,220,150,370,
Musée Municipal,2008,MIDI-PYRENEES,MARTRES-TOLOSANE,2194,6369,8563,
Musée Paul Dupuy,2008,MIDI-PYRENEES,TOULOUSE,7997,8329,16326,
Musée Georges Labit,2008,MIDI-PYRENEES,TOULOUSE,6161,14909,21070,
Musée Toulouse Lautrec,2008,MIDI-PYRENEES,ALBI,104528,28233,132761,
Musée Départemental du Textile,2008,MIDI-PYRENEES,LA-BASTIDE-ROUAIROUX,1427,1909,3336,
Musée du Pays Rabastinois,2008,MIDI-PYRENEES,RABASTENS,984,3519,4503,
Ecomusée de la Région,2008,NORD-PAS-DE-CALAIS,FOURMIES,36821,12811,49632,
Musée de l'Hospice Comtesse,2008,NORD-PAS-DE-CALAIS,LILLE,40000,27000,67000,
Palais des Beaux-Arts de Lille,2008,NORD-PAS-DE-CALAIS,LILLE,166311,60056,226367,
Musée Municipal,2008,NORD-PAS-DE-CALAIS,BERCK-SUR-MER,3046,4614,7660,
Musée de la Céramique,2008,NORD-PAS-DE-CALAIS,DESVRES,8075,1052,9127,
Musée d'Histoire et d'Archéologie,2008,NORD-PAS-DE-CALAIS,HARNES,0,1101,1101,
Musée de l'Hôtel Sandelin,2008,NORD-PAS-DE-CALAIS,SAINT-OMER,10990,0,10990,
Musée de la Poste et des Techniques de communication,2008,BASSE-NORMANDIE,CAEN,3884,3114,6998,
Musée d'Ethnographie et d'Arts Populaires et Musée de la Marine,2008,BASSE-NORMANDIE,HONFLEUR,17793,0,17793,
Musée de la Mine,2008,BASSE-NORMANDIE,LE MOLAY-LITTRY,4168,480,4648,
Château de Saint-Germain de Livet,2008,BASSE-NORMANDIE,SAINT-GERMAIN DE LIVET,7777,14655,22432,
Musée Municipal,2008,BASSE-NORMANDIE,VIRE NORMANDIE,1818,4965,6783,
Musée Départemental d'Art Sacré,2008,BASSE-NORMANDIE,SEES,603,415,1018,
Musée Municipal,2008,HAUTE-NORMANDIE,BERNAY,1880,7167,9047,
Musée Artisanal et Industriel d'Instruments à Vent,2008,HAUTE-NORMANDIE,LA COUTURE-BOUSSEY,3790,1216,5006,
Musée Municipal,2008,HAUTE-NORMANDIE,LOUVIERS,0,6144,6144,
Musée Alfred Canel,2008,HAUTE-NORMANDIE,PONT-AUDEMER,4074,1246,5320,
Muséum d'Histoire Naturelle,2008,HAUTE-NORMANDIE,LE HAVRE,0,49636,49636,
"Juliobona, Musée Gallo-Romain de Lillebonne",2008,HAUTE-NORMANDIE,LILLEBONNE,611,1831,2442,
Musée des Traditions et Arts Normands,2008,HAUTE-NORMANDIE,MARTAINVILLE-EPREVILLE,8998,11544,20542,
"Musée de la Fève, Crèches et Traditions Populaires",2008,PAYS DE LA LOIRE,BLAIN,2120,277,2397,
Musée du Vignoble Nantais,2008,PAYS DE LA LOIRE,LE PALLET,4116,2130,6246,
Musée d'Art de Nantes,2008,PAYS DE LA LOIRE,NANTES,66896,45502,112398,
Musée d'Art et d'Histoire,2008,PAYS DE LA LOIRE,CHOLET,1544,16109,17653,
Musée des Tisserands Mayennais,2008,PAYS DE LA LOIRE,AMBRIERES-LES-VALLEES,800,587,1387,
Musée de l'Ardoise et de la Géologie,2008,PAYS DE LA LOIRE,RENAZE,1389,724,2113,
Ecomusée du Marais Breton Vendéen,2008,PAYS DE LA LOIRE,LA BARRE-DE-MONTS,20375,11459,31834,
Musée municipal de Chauny,2008,PICARDIE,CHAUNY,0,3500,3500,
Musée Alexandre Dumas,2008,PICARDIE,VILLERS COTTERETS,2050,92,2142,
Musée du Château de Compiègne,2008,PICARDIE,COMPIEGNE,37679,49232,86911,
Musée Jean Calvin,2008,PICARDIE,NOYON,2015,1227,3242,
Musée de la Vénerie,2008,PICARDIE,SENLIS,8876,0,8876,
Cité International de la Bande Dessinée et de l'Image - Musée de la Bande Dessinée,2008,POITOU-CHARENTES,ANGOULEME,17237,4754,21991,
Musée Municipal de Cognac,2008,POITOU-CHARENTES,COGNAC,2303,12108,14411,
Musée Napoléonien et Africain,2008,POITOU-CHARENTES,ILE D'AIX,13016,10672,23688,
Muséum d'Histoire Naturelle,2008,POITOU-CHARENTES,LA ROCHELLE,13937,31613,45550,
Musée de l'Echevinage,2008,POITOU-CHARENTES,SAINTES,1859,6755,8614,
Musée du Présidial,2008,POITOU-CHARENTES,SAINTES,593,2267,2860,
Musée Dupuy-Mestreau,2008,POITOU-CHARENTES,SAINTES,1383,1732,3115,
Musée Municipal des Cordeliers,2008,POITOU-CHARENTES,SAINT-JEAN-D'ANGELY,1120,2062,3182,
Musée des Tumulus de Bougon,2008,POITOU-CHARENTES,BOUGON,21856,4002,25858,
Musée des Traditions Populaires et d'Archéologie,2008,POITOU-CHARENTES,CHAUVIGNY,8256,2827,11083,
Musée-Château de Cagnes,2008,PROVENCE-ALPES-CÔTE D'AZUR,CAGNES-SUR-MER,19524,19719,39243,
Villa-Musée Jean-Honoré Fragonard,2008,PROVENCE-ALPES-CÔTE D'AZUR,GRASSE,2409,1092,3501,
Musée d'Art et d'Histoire de Provence,2008,PROVENCE-ALPES-CÔTE D'AZUR,GRASSE,3691,8443,12134,
Musée des Beaux-Arts,2008,PROVENCE-ALPES-CÔTE D'AZUR,MENTON,0,19571,19571,
Musée du Vieux-Logis de Nice,2008,PROVENCE-ALPES-CÔTE D'AZUR,NICE,0,262,262,
Musée Matisse,2008,PROVENCE-ALPES-CÔTE D'AZUR,NICE,33027,92456,125483,
Musée Paul Arbaud,2008,PROVENCE-ALPES-CÔTE D'AZUR,AIX-EN-PROVENCE,680,1500,2180,
Musée Camarguais,2008,PROVENCE-ALPES-CÔTE D'AZUR,ARLES,16390,7084,23474,
Musée Départemental de l'Arles Antique,2008,PROVENCE-ALPES-CÔTE D'AZUR,ARLES,19860,53797,73657,
Musée Alphonse Daudet,2008,PROVENCE-ALPES-CÔTE D'AZUR,FONTVIEILLE,28601,0,28601,
Fondation Louis Jou,2008,PROVENCE-ALPES-CÔTE D'AZUR,LES-BAUX-DE-PROVENCE,282,650,932,
Cabinet des Monnaies et Médailles de Marseille,2008,PROVENCE-ALPES-CÔTE D'AZUR,MARSEILLE,0,973,973,
Musée des Docks Romains,2008,PROVENCE-ALPES-CÔTE D'AZUR,MARSEILLE,2855,2366,5221,
Musée des Beaux-Arts de Marseille,2008,PROVENCE-ALPES-CÔTE D'AZUR,MARSEILLE,111881,63077,174958,
Musée Estrine - Présence Van Gogh,2008,PROVENCE-ALPES-CÔTE D'AZUR,SAINT-REMY-DE-PROVENCE,9112,4412,13524,
Musée Départemental des Hautes-Alpes,2008,PROVENCE-ALPES-CÔTE D'AZUR,GAP,0,16630,16630,
Musée Municipal,2008,PROVENCE-ALPES-CÔTE D'AZUR,DRAGUIGNAN,0,13598,13598,
Musée de l'Artillerie,2008,PROVENCE-ALPES-CÔTE D'AZUR,DRAGUIGNAN,0,18134,18134,
Musée Municipal Camille Pautet,2008,PROVENCE-ALPES-CÔTE D'AZUR,MAZAN,0,1686,1686,
Musée Municipal,2008,PROVENCE-ALPES-CÔTE D'AZUR,ORANGE,57328,0,57328,
Cité de Préhistoire,2008,RHONE-ALPES,ORGNAC-L'AVEN,99257,9318,108575,
Musée Léon Marès,2008,RHONE-ALPES,LOVAGNY,19268,3041,22309,
Musée Gallo-Romain,2008,RHONE-ALPES,AOSTE,5407,1444,6851,
Maison du Patrimoine de Hières-sur-Amby,2008,RHONE-ALPES,HIERES SUR AMBY,7208,610,7818,
Musée Matheysin,2008,RHONE-ALPES,LA MURE,1187,2036,3223,
Musée Hébert,2008,RHONE-ALPES,LA TRONCHE,0,36127,36127,
Musée Hector Berlioz,2008,RHONE-ALPES,LA-COTE-SAINT-ANDRE,0,10865,10865,
Musée des Beaux-Arts et d'Archéologie,2008,RHONE-ALPES,VIENNE,784,2593,3377,
Musée Lucien Mainssieux,2008,RHONE-ALPES,VOIRON,0,3218,3218,
Musée Hospitalier,2008,RHONE-ALPES,CHARLIEU,3078,1393,4471,
Musée d'Archéologie,2008,RHONE-ALPES,FEURS,1023,4080,5103,
Lugdunum - Musée et Théâtres Romains,2008,RHONE-ALPES,LYON,21078,49953,71031,
Centre d'Histoire de la Résistance et de la Déportation,2008,RHONE-ALPES,LYON,18927,38822,57749,
Musée des Beaux-Arts,2008,RHONE-ALPES,LYON,96826,153312,250138,
Musée des Sapeurs-Pompiers de Lyon,2008,RHONE-ALPES,LYON,0,7055,7055,
Ecomusée du Haut Beaujolais,2008,RHONE-ALPES,THIZY-LES-BOURGS,680,379,1059,
Musée Savoisien,2008,RHONE-ALPES,CHAMBERY,3660,11800,15460,
Musée Historique,2009,ALSACE,HAGUENAU,2004,5732,7736,
Musée des Arts Décoratifs,2009,ALSACE,STRASBOURG,8946,32043,40989,
Musée des Beaux-Arts,2009,ALSACE,STRASBOURG,8673,38181,46854,
Musée J.F. Oberlin,2009,ALSACE,WALDERSBACH,17226,7426,24652,
Musée de la Bataille du 6 Août 1870,2009,ALSACE,WOERTH,2923,409,3332,
Musée Sundgauvien d'Altkirch,2009,ALSACE,ALTKIRCH,2471,1571,4042,
Musée Gallo-Romain,2009,ALSACE,BIESHEIM,1049,1987,3036,
Musée d'Histoire Local,2009,ALSACE,KAYSERSBERG,304,354,658,
Musée EDF Electropolis,2009,ALSACE,MULHOUSE,27272,10777,38049,
Musée Fernand Desmoulin,2009,AQUITAINE,BRANTOME,16549,1338,17887,
Musée Paul Reclus,2009,AQUITAINE,DOMME,122,13018,13140,
Musée des Arts et Traditions Populaires du Périgord,2009,AQUITAINE,MUSSIDAN,1409,1597,3006,
Musée Militaire - Souvenir du Périgord,2009,AQUITAINE,PERIGUEUX,2127,573,2700,
Musée Gallo-Romain de Vesunna,2009,AQUITAINE,PERIGUEUX,14510,12593,27103,
Musée d'Aquitaine,2009,AQUITAINE,BORDEAUX,12019,114699,126718,
Musée de Borda,2009,AQUITAINE,DAX,9866,0,9866,
Musée de la Chalosse,2009,AQUITAINE,MONTFORT-EN-CHALOSSE,7546,2674,10220,
Musée d'Art et d'Histoire du Cap de Gascogne,2009,AQUITAINE,SAINT-SEVER,0,1800,1800,
Musée Municipal du Lac,2009,AQUITAINE,SANGUINET,1574,0,1574,
Musée Basque et de l'Histoire de Bayonne,2009,AQUITAINE,BAYONNE,19172,13968,33140,
Musée Bernadotte,2009,AQUITAINE,PAU,2158,2864,5022,
Centre National du Costume de Scène et de la Scénographie,2009,AUVERGNE,MOULINS,53243,12042,65285,
Musée d'art et d'histoire Alfred Douët,2009,AUVERGNE,SAINT-FLOUR,1146,1965,3111,
Musée des Peintres de l'Ecole de Murols,2009,AUVERGNE,MUROL,3851,83,3934,
"Musée de la Vie Bourguignonne, Perrin de Puycousin",2009,BOURGOGNE,DIJON,0,34550,34550,
Musée Archéologique,2009,BOURGOGNE,DIJON,0,27811,27811,
Musée Noisot,2009,BOURGOGNE,FIXIN,312,207,519,
Musée de la Loire,2009,BOURGOGNE,COSNE-SUR-LOIRE,1678,3063,4741,
Musée Archéologique du Nivernais (Porte du Croux),2009,BOURGOGNE,NEVERS,0,123,123,
Musée Denon,2009,BOURGOGNE,CHALON-SUR-SAONE,0,14552,14552,
Musée du Prieuré de Charolles,2009,BOURGOGNE,CHAROLLES,1341,656,1997,
"L'Atelier d'un Journal"" de Louhans - Musée Municipal",2009,BOURGOGNE,LOUHANS,1766,2801,4567,
Musée Départemental de Préhistoire de Solutré,2009,BOURGOGNE,SOLUTRE-POUILLY,17567,16358,33925,
Musée des Arts Naïfs et Populaires de Noyers sur Serein,2009,BOURGOGNE,NOYERS-SUR-SEREIN,1355,643,1998,
Musée Villeneuvien,2009,BOURGOGNE,VILLENEUVE-SUR-YONNE,0,2116,2116,
Ecomusée d'Ouessant - Vivre sur une Ile,2009,BRETAGNE,OUESSANT,5889,3975,9864,
Musée des Phares et Balises,2009,BRETAGNE,OUESSANT,12714,3460,16174,
Musée Bigouden,2009,BRETAGNE,PONT-L'ABBE,11151,3495,14646,
Musée des Beaux-Arts,2009,BRETAGNE,QUIMPER,32864,32184,65048,
Musée du Château de Suscinio,2009,BRETAGNE,SARZEAU,103472,0,103472,
Musée d'Histoire Naturelle Gabriel Foucher,2009,CENTRE,BOURGES,8215,21569,29784,
Musée de la Chemiserie et de l'Elégance Masculine,2009,CENTRE,ARGENTON-SUR-CREUSE,3745,4041,7786,
Musées de Châteauroux - Hôtel Bertrand,2009,CENTRE,CHATEAUROUX,0,22133,22133,
Musée du Savignéen,2009,CENTRE,SAVIGNE-SUR-LATHAN,1243,239,1482,
Muséum d'Histoire Naturelle,2009,CENTRE,BLOIS,6610,9491,16101,
Maison de la Magie,2009,CENTRE,BLOIS,54844,11980,66824,
Musée Municipal Théâtre Forain et Archéologique,2009,CENTRE,ARTENAY,4305,5811,10116,
Musée d'Art et d'Archéologie,2009,CENTRE,CHATILLON-COLIGNY,285,298,583,
Château-Musée de Gien,2009,CENTRE,GIEN,16308,2110,18418,
Musée des Beaux-Arts,2009,CENTRE,ORLEANS,5968,47594,53562,
Musée du Château-Fort,2009,CHAMPAGNE-ARDENNES,SEDAN,56426,1161,57587,
Musée Paul Dubois-Alfred Boucher,2009,CHAMPAGNE-ARDENNES,NOGENT-SUR-SEINE,585,1138,1723,
Musée Vauluisant - Musée de la Bonneterie,2009,CHAMPAGNE-ARDENNES,TROYES,2551,4575,7126,
Musée de l'Alta Rocca,2009,CORSE,LEVIE,6336,5025,11361,
Musée Départemental Pascal Paoli,2009,CORSE,MOROSAGLIA,1500,910,2410,
Musée de la résistance et de la Déportation,2009,FRANCHE-COMTE,BESANCON,58848,251,59099,
Musée des Beaux-Arts et d'Archéologie,2009,FRANCHE-COMTE,BESANCON,5169,48754,53923,
Musée Départemental Albert-et-Félicie Demard - ATP,2009,FRANCHE-COMTE,CHAMPLITTE,6392,10166,16558,
Musée du Jouet,2009,FRANCHE-COMTE,MOIRANS-EN-MONTAGNE,18799,1223,20022,
Musée Français de la Carte à Jouer,2009,ILE-DE-FRANCE,ISSY-LES-MOULINEAUX,1425,13586,15011,
Galerie d'Anatomie Comparée et de Paléontologie (Muséum d'Histoire Naturelle),2009,ILE-DE-FRANCE,PARIS,157110,144689,301799,
"Petit Palais, Musée des Beaux-Arts de la ville de Paris",2009,ILE-DE-FRANCE,PARIS,151376,324558,475934,
Musée Bourdelle,2009,ILE-DE-FRANCE,PARIS,17167,31559,48726,
Musée Zadkine,2009,ILE-DE-FRANCE,PARIS,13543,12815,26358,
Musée des Monuments Français,2009,ILE-DE-FRANCE,PARIS,121695,211109,332804,
"Musée Cognacq-Jay, Musée du XVIIIe siècle de la ville de Paris",2009,ILE-DE-FRANCE,PARIS,11028,39748,50776,
Musée des Arts d'Afrique et d'Océanie - Aquarium,2009,ILE-DE-FRANCE,PARIS,127247,82086,209333,
Musée du Louvre,2009,ILE-DE-FRANCE,PARIS,5747911,2639756,8387667,
Musée de la Poste,2009,ILE-DE-FRANCE,PARIS,22291,54238,76529,
Maison Natale de Louis Braille,2009,ILE-DE-FRANCE,COUPVRAY,5173,1675,6848,
Musée d'Art et d'Histoire Militaire,2009,ILE-DE-FRANCE,FONTAINEBLEAU,1018,2025,3043,
Musée Gatien Bonnet,2009,ILE-DE-FRANCE,LAGNY-SUR-MARNE,144,1392,1536,
Musée Henri Chapu,2009,ILE-DE-FRANCE,LE MEE-SUR-SEINE,0,910,910,
Musée de l'Air et de l'Espace,2009,ILE-DE-FRANCE,LE BOURGET,176487,83052,259539,
Musée d'Art et d'Histoire,2009,ILE-DE-FRANCE,SAINT-DENIS,3029,26472,29501,
Musée Fragonard,2009,ILE-DE-FRANCE,MAISONS-ALFORT,5202,4122,9324,
Musée du Jouet Pierre Pinel,2009,ILE-DE-FRANCE,POISSY,11724,4819,16543,
Musée Départemental Maurice Denis,2009,ILE-DE-FRANCE,SAINT-GERMAIN-EN-LAYE,10682,16180,26862,
Muséum Agricole et Industriel Stella Matutina,2009,LA REUNION,PITON-SAINT-LEU,40066,6992,47058,
Musée Départemental de la Réunion - Musée Léon Dierx,2009,LA REUNION,SAINT-DENIS,5250,14044,19294,
Musée d'Art et d'Histoire - Ensemble monumental de Narbonne,2009,LANGUEDOC-ROUSSILLON,NARBONNE,305450,0,305450,
Musée Albert André,2009,LANGUEDOC-ROUSSILLON,BAGNOLS-SUR-CEZE,175,3788,3963,
Musée du Vieux Nîmes,2009,LANGUEDOC-ROUSSILLON,NIMES,0,29619,29619,
Musée Archéologique,2009,LANGUEDOC-ROUSSILLON,NIMES,0,49631,49631,
Carré d'Art Musée d'Art Contemporain de Nîmes,2009,LANGUEDOC-ROUSSILLON,NIMES,12834,26315,39149,
Musée Municipal Georges Borias,2009,LANGUEDOC-ROUSSILLON,UZES,1013,1484,2497,
Musée du Vieux Montpellier,2009,LANGUEDOC-ROUSSILLON,MONTPELLIER,248,4687,4935,
Musée d'Art Moderne - Fonds Peskè,2009,LANGUEDOC-ROUSSILLON,COLLIOURE,6962,1504,8466,
Musée Hyacinthe Rigaud,2009,LANGUEDOC-ROUSSILLON,PERPIGNAN,3733,6041,9774,
Musée de la Mémoire et des Industries Tullistes,2009,LIMOUSIN,TULLE,0,2822,2822,
Musée du Pays d'Ussel,2009,LIMOUSIN,USSEL,0,3052,3052,
Musée National Adrien Dubouché,2009,LIMOUSIN,LIMOGES,11341,7244,18585,
Musée de l'Histoire du Fer,2009,LORRAINE,JARVILLE-LA-MALGRANGE,1665,4608,6273,
Musée Barrois,2009,LORRAINE,BAR-LE-DUC,2295,7809,10104,
Musée d'Art Sacré de la Meuse,2009,LORRAINE,SAINT-MIHIEL,812,494,1306,
Musée de la Mine - Carreau Wendel,2009,LORRAINE,PETITE-ROSSELLE,23724,8461,32185,
Musée du Pays de Sarrebourg,2009,LORRAINE,SARREBOURG,15473,5135,20608,
Musée Départemental Georges de la Tour,2009,LORRAINE,VIC-SUR-SEILLE,37426,16158,53584,
Musée Louis Français,2009,LORRAINE,PLOMBIERES-LES-BAINS,264,110,374,
Musée de la Forge,2009,MIDI-PYRENEES,MONTGAILHARD,27389,2802,30191,
Musée des Arts et Métiers Traditionnels,2009,MIDI-PYRENEES,SALLES-LA-SOURCE,6610,1055,7665,
Musée d'Archéologie,2009,MIDI-PYRENEES,LECTOURE,2872,672,3544,
Musée Joseph Abeilhé,2009,MIDI-PYRENEES,MARCIAC,127,135,262,
Musée Municipal d'Art et d'Histoire,2009,MIDI-PYRENEES,SAINT-GAUDENS,482,1792,2274,
Musée des Transports et des Communications,2009,MIDI-PYRENEES,TOULOUSE,0,372,372,
"Les Abattoirs, Musée d'Art Moderne et Contemporain",2009,MIDI-PYRENEES,TOULOUSE,35016,96072,131088,
Musée Salies,2009,MIDI-PYRENEES,BAGNERES-DE-BIGORRE,3990,458,4448,
Musée Pyrénéen,2009,MIDI-PYRENEES,LOURDES,73888,4937,78825,
Musée-château Gaston Phébus,2009,MIDI-PYRENEES,MAUVEZIN,28677,0,28677,
Musée Henri Martin,2009,MIDI-PYRENEES,CAHORS,2013,8617,10630,
Musée Eugénie et Maurice Guérin,2009,MIDI-PYRENEES,ANDILLAC,2360,1789,4149,
Ecomusée du Marais Breton Vendéen,2017,PAYS DE LA LOIRE,LA BARRE-DE-MONTS,6375,20190,26565,
Musée Municipal,2017,PAYS DE LA LOIRE,LA ROCHE-SUR-YON,0,11090,11090,
Musée La Bourrine du Bois-Juquaud,2017,PAYS DE LA LOIRE,SAINT-HILAIRE-DE-RIEZ,12906,2337,15243,
Musée de la vallée,2017,PROVENCE-ALPES-CÔTE D'AZUR,BARCELONNETTE,8589,2255,10844,
Musée de la Mer,2017,PROVENCE-ALPES-CÔTE D'AZUR,CANNES,45690,34837,80527,
Musée International de la Parfumerie,2017,PROVENCE-ALPES-CÔTE D'AZUR,GRASSE,75236,45262,120498,
Musée des Beaux-Arts,2017,PROVENCE-ALPES-CÔTE D'AZUR,MENTON,0,3734,3734,
Musée Jean Cocteau Collection Séverin Wunderman,2017,PROVENCE-ALPES-CÔTE D'AZUR,MENTON,31998,16823,48821,
Musée National Marc Chagall,2017,PROVENCE-ALPES-CÔTE D'AZUR,NICE,98185,54361,152546,
Musées de la Citadelle,2017,PROVENCE-ALPES-CÔTE D'AZUR,VILLEFRANCHE-SUR-MER,0,61428,61428,
Musée- Atelier de Paul Cézanne,2017,PROVENCE-ALPES-CÔTE D'AZUR,AIX-EN-PROVENCE,59851,8162,68013,
Musée Alphonse Daudet,2017,PROVENCE-ALPES-CÔTE D'AZUR,FONTVIEILLE,2915,610,3525,
Musée des Civilisations de l'Europe et de la Méditerranée - MuCem,2017,PROVENCE-ALPES-CÔTE D'AZUR,MARSEILLE,234883,214026,448909,
Musée Municipal Paul Lafran,2017,PROVENCE-ALPES-CÔTE D'AZUR,SAINT-CHAMAS,0,3940,3940,
Musée des A.T.P. de Moyenne Provence,2017,PROVENCE-ALPES-CÔTE D'AZUR,DRAGUIGNAN,1157,9147,10304,
Musée des Troupes de Marine,2017,PROVENCE-ALPES-CÔTE D'AZUR,FREJUS,0,18240,18240,
Musée Archéologique,2017,PROVENCE-ALPES-CÔTE D'AZUR,SAINT-RAPHAËL,0,20000,20000,
Musée Comtadin-Duplessis,2017,PROVENCE-ALPES-CÔTE D'AZUR,CARPENTRAS,10,142,152,
Musée Jean Garcin 39-45 : L'appel de la Liberté,2017,PROVENCE-ALPES-CÔTE D'AZUR,FONTAINE-DE-VAUCLUSE,2427,6655,9082,
Musée Municipal,2017,PROVENCE-ALPES-CÔTE D'AZUR,ORANGE,56334,0,56334,
Musée du Bugey-Valmorey,2018,AUVERGNE-RHONE-ALPES,LOCHIEU,2880,2520,5400,
Musée Municipal de Gannat,2018,AUVERGNE-RHONE-ALPES,GANNAT,609,604,1213,
Musée Anne de Beaujeu,2018,AUVERGNE-RHONE-ALPES,MOULINS,18081,11972,30053,
Centre National du Costume de Scène et de la Scénographie,2018,AUVERGNE-RHONE-ALPES,MOULINS,72733,21431,94164,
Musée Rieckotter,2018,AUVERGNE-RHONE-ALPES,NERIS-LES-BAINS,409,618,1027,
Musée des Vans,2018,AUVERGNE-RHONE-ALPES,LES VANS,766,1328,2094,
Cité de Préhistoire,2018,AUVERGNE-RHONE-ALPES,ORGNAC-L'AVEN,118975,26468,145443,
Musée Crozatier,2018,AUVERGNE-RHONE-ALPES,LE PUY-EN-VELAY,14172,7528,21700,
Musée des Vallées de Thônes,2018,AUVERGNE-RHONE-ALPES,THONES,804,1312,2116,
Musée Gallo-Romain,2018,AUVERGNE-RHONE-ALPES,AOSTE,5114,1433,6547,
Muséum d'Histoire Naturelle de Grenoble,2018,AUVERGNE-RHONE-ALPES,GRENOBLE,20799,84025,104824,
Musée de la Grande Chartreuse,2018,AUVERGNE-RHONE-ALPES,SAINT-PIERRE-DE-CHARTREUSE,31275,1646,32921,
Conservatoire - Musée des Industries Hydroélectriques,2018,AUVERGNE-RHONE-ALPES,VAUJANY,0,7448,7448,
Atelier - Musée du Chapeau,2018,AUVERGNE-RHONE-ALPES,CHAZELLES-SUR-LYON,15716,5611,21327,
Musée d'Histoire du  20ème Siècle - Résistance et Déportation,2018,AUVERGNE-RHONE-ALPES,ESTIVAREILLES,1963,1634,3597,
Musée Francisque Mandet,2018,AUVERGNE-RHONE-ALPES,RIOM,3203,12805,16008,
Musée Régional d'Auvergne,2018,AUVERGNE-RHONE-ALPES,RIOM,0,2276,2276,
Musée Municipal de la Coutellerie,2018,AUVERGNE-RHONE-ALPES,THIERS,18541,3673,22214,
Centre d'Histoire de la Résistance et de la Déportation,2018,AUVERGNE-RHONE-ALPES,LYON,21080,39843,60923,
Musée Paul Dini,2018,AUVERGNE-RHONE-ALPES,VILLEFRANCHE-SUR-SAONE,13983,8446,22429,
Musée du Vin de Bourgogne,2018,BOURGOGNE-FRANCHE-COMTE,BEAUNE,20487,4597,25084,
Musée du Pays Châtillonnais - Trésor de Vix,2018,BOURGOGNE-FRANCHE-COMTE,CHATILLON-SUR-SEINE,12233,4925,17158,
"Musée de la Vie Bourguignonne, Perrin de Puycousin",2018,BOURGOGNE-FRANCHE-COMTE,DIJON,0,36161,36161,
Muséum de Besançon,2018,BOURGOGNE-FRANCHE-COMTE,BESANCON,187034,0,187034,
Musée du Temps,2018,BOURGOGNE-FRANCHE-COMTE,BESANCON,8081,32326,40407,
Musée-Maison Natale Gustave Courbet,2018,BOURGOGNE-FRANCHE-COMTE,ORNANS,21820,16365,38185,
Musée des Beaux-Arts,2018,BOURGOGNE-FRANCHE-COMTE,LONS-LE-SAUNIER,1019,3348,4367,
Musée de l'Artisanat Jurassien,2018,BOURGOGNE-FRANCHE-COMTE,VOITEUR,0,19000,19000,
Musée du Septennat,2018,BOURGOGNE-FRANCHE-COMTE,CHATEAU-CHINON,6963,1633,8596,
Musée de la Mine,2018,BOURGOGNE-FRANCHE-COMTE,LA MACHINE,5923,885,6808,
Musée de la Faïence et des Beaux-Arts,2018,BOURGOGNE-FRANCHE-COMTE,NEVERS,6493,4399,10892,
Musée Archéologique du Nivernais (Porte du Croux),2018,BOURGOGNE-FRANCHE-COMTE,NEVERS,255,851,1106,
Museum d'Histoire Naturelle Jacques de La Comble,2018,BOURGOGNE-FRANCHE-COMTE,AUTUN,556,2384,2940,
Musée Saint-Nazaire,2018,BOURGOGNE-FRANCHE-COMTE,BOURBON-LANCY,0,250,250,
Musée Départemental du Compagnonnage,2018,BOURGOGNE-FRANCHE-COMTE,ROMANECHE-THORINS,1895,2121,4016,
Hôtel Dieu - Musée Greuze,2018,BOURGOGNE-FRANCHE-COMTE,TOURNUS,4848,2119,6967,
Maison du Blé et du Pain,2018,BOURGOGNE-FRANCHE-COMTE,VERDUN-SUR-LE-DOUBS,3432,236,3668,
Musée d'Art et d'Histoire,2018,BOURGOGNE-FRANCHE-COMTE,BELFORT,3227,13151,16378,
Donation Maurice Jardot,2018,BOURGOGNE-FRANCHE-COMTE,BELFORT,945,6004,6949,
Musée Muncipal,2018,BOURGOGNE-FRANCHE-COMTE,SENS,7492,22740,30232,
Musée d'Art et d'Histoire du Puisaye,2018,BOURGOGNE-FRANCHE-COMTE,VILLIERS-SAINT-BENOIT,339,974,1313,
Musée d'Art et d'Histoire,2018,BRETAGNE,SAINT-BRIEUC,0,24195,24195,
Musée de la Pêche,2018,BRETAGNE,CONCARNEAU,21695,16345,38040,
Musée de Morlaix,2018,BRETAGNE,MORLAIX,7757,3131,10888,
Ecomusée d'Ouessant - Vivre sur une Ile,2018,BRETAGNE,OUESSANT,6202,732,6934,
Musée des Rochers-Sévigné,2018,BRETAGNE,VITRE,2496,503,2999,
Ecomusée de l'Île de Groix,2018,BRETAGNE,ILE DE GROIX,4691,2250,6941,
Ecomusée Industriel des Forges,2018,BRETAGNE,INZINZAC-LOCHRIST,1673,1935,3608,
Musée d'Histoire Naturelle Gabriel Foucher,2018,CENTRE-VAL DE LOIRE,BOURGES,21319,12247,33566,
Musée Emile Chénon,2018,CENTRE-VAL DE LOIRE,CHATEAUMEILLANT,854,786,1640,
Musée Saint-Vic,2018,CENTRE-VAL DE LOIRE,SAINT-AMAND-MONTROND,0,4960,4960,
Musée des Beaux-Arts et d'Histoire Naturelle,2018,CENTRE-VAL DE LOIRE,CHATEAUDUN,2425,6226,8651,
Musée de la Chemiserie et de l'Elégance Masculine,2018,CENTRE-VAL DE LOIRE,ARGENTON-SUR-CREUSE,2919,3889,6808,
Château Musée,2018,CENTRE-VAL DE LOIRE,AZAY-LE-FERRON,14776,4522,19298,
Musée de la Corbillière,2018,CENTRE-VAL DE LOIRE,MER,0,6016,6016,
Musée Archéologique,2018,CENTRE-VAL DE LOIRE,THESEE,870,0,870,
"Hôtel Cabu, Musée d'Histoire et d'Archéologie",2018,CENTRE-VAL DE LOIRE,ORLEANS,10629,2531,13160,
Musée du Feutre,2018,GRAND EST,MOUZON,2854,1109,3963,
Musée du Rethelois et du Porcien,2018,GRAND EST,RETHEL,0,299,299,
Musée du Château-Fort,2018,GRAND EST,SEDAN,47560,7697,55257,
Maison de l'Outil  et de la Pensée Ouvrière,2018,GRAND EST,TROYES,17574,2818,20392,
Musée Alsacien,2018,GRAND EST,HAGUENAU,948,231,1179,
Musée Historique,2018,GRAND EST,STRASBOURG,33524,28427,61951,
Musée Alsacien,2018,GRAND EST,STRASBOURG,38258,27531,65789,
"Musée de l'Affiche - Le Signe, Centre national du Graphisme",2018,GRAND EST,CHAUMONT,0,21048,21048,
Musée d'Art et d'Histoire,2018,GRAND EST,LANGRES,5415,6966,12381,
Musée d'Histoire Local,2018,GRAND EST,KAYSERSBERG,0,2707,2707,
Musée Electropolis,2018,GRAND EST,MULHOUSE,11536,23047,34583,
Musée Minéralogique de la Société Industrielle de Mulhouse,2018,GRAND EST,MULHOUSE,0,60,60,
Musée Vauban,2018,GRAND EST,NEUF-BRISACH,2257,281,2538,
Musée des Amis de Thann,2018,GRAND EST,THANN,466,1360,1826,
Musée Garinet,2018,GRAND EST,CHALONS-EN-CHAMPAGNE,490,872,1362,
Musée du Château de Montaigu,2018,GRAND EST,LANEUVEVILLE-DEVANT-NANCY,634,1256,1890,
Muséum- Aquarium de Nancy,2018,GRAND EST,NANCY,32219,68617,100836,
Musée des Beaux-Arts de Nancy,2018,GRAND EST,NANCY,39963,68910,108873,
Musée Barrois,2018,GRAND EST,BAR-LE-DUC,3105,7592,10697,
Musée Jules Bastien-Lepage - Musée de la Fortification,2018,GRAND EST,MONTMEDY,2599,9023,11622,
Musée d'Art Sacré de la Meuse,2018,GRAND EST,SAINT-MIHIEL,1404,610,2014,
Musée de la Bière et du Pays de Stenay,2018,GRAND EST,STENAY,9295,13617,22912,
Musées de la Cour d'Or,2018,GRAND EST,METZ,24869,33541,58410,
Musée de la Lutherie et de l'Archèterie Française,2018,GRAND EST,MIRECOURT,6133,3283,9416,
Musée Départemental Victor Schoelcher,2018,GUADELOUPE,POINTE-A-PITRE,0,7961,7961,
Musée Jean de la Fontaine,2018,HAUTS-DE-FRANCE,CHATEAU-THIERRY,8598,2655,11253,
Musée Alexandre Dumas,2018,HAUTS-DE-FRANCE,VILLERS COTTERETS,917,994,1911,
Musée Benoît de Puydt,2018,HAUTS-DE-FRANCE,BAILLEUL,2169,2801,4970,
Musée Municipal de Cambrai,2018,HAUTS-DE-FRANCE,CAMBRAI,706,7885,8591,
Musée Départemental Matisse,2018,HAUTS-DE-FRANCE,LE CATEAU-CAMBRESIS,38843,11541,50384,
Musée d'Histoire Locale de Marchiennes,2018,HAUTS-DE-FRANCE,MARCHIENNES,143,396,539,
MusVerre,2018,HAUTS-DE-FRANCE,SARS-POTERIES,15724,17935,33659,
Musée des Beaux-Arts,2018,HAUTS-DE-FRANCE,VALENCIENNES,65635,22885,88520,
Musée de l'Archerie et de l'Art Sacré,2018,HAUTS-DE-FRANCE,CREPY-EN-VALOIS,3331,4023,7354,
Musée du Noyonnais,2018,HAUTS-DE-FRANCE,NOYON,990,1532,2522,
Musée des Beaux-Arts et de la Dentelle,2018,HAUTS-DE-FRANCE,CALAIS,11405,14088,25493,
Cité Internationale de la Dentelle et de la Mode de Calais,2018,HAUTS-DE-FRANCE,CALAIS,38001,17901,55902,
Louvre-Lens (collections nationales decentralisées),2018,HAUTS-DE-FRANCE,LENS,71544,411215,482759,
Musée Jean-Charles Cazin,2018,HAUTS-DE-FRANCE,SAMER,0,54,54,
Musée Roybet Fould,2018,ILE-DE-FRANCE,COURBEVOIE,1089,9099,10188,
Musée des Avelines - Musée d'Art et d'Histoire,2018,ILE-DE-FRANCE,SAINT-CLOUD,4127,10174,14301,
Grande Galerie de l'Evolution (Muséum National d'Histoire Naturelle),2018,ILE-DE-FRANCE,PARIS,404497,344572,749069,
Musée du Louvre,2018,ILE-DE-FRANCE,PARIS,5988065,4117897,10105962,
Musée National de la Légion d'Honneur et des Ordres de Chevalerie,2018,ILE-DE-FRANCE,PARIS,0,50240,50240,
"Petit Palais, Musée des Beaux-Arts de la ville de Paris",2018,ILE-DE-FRANCE,PARIS,397257,806553,1203810,
Etablissement Public du Musée des Arts Asiatiques Guimet,2018,ILE-DE-FRANCE,PARIS,115595,159201,274796,
Musée National Auguste Rodin,2018,ILE-DE-FRANCE,PARIS,390870,169105,559975,
"Établissement Public de la Porte Dorée - Musée de National de l’Histoire de l’Immigration? Aquarium, Palais)",2018,ILE-DE-FRANCE,PARIS,190452,269424,459876,
Musée Nissim de Camondo (MAD),2018,ILE-DE-FRANCE,PARIS,32832,15348,48180,
Musée Municipal des Capucins,2018,ILE-DE-FRANCE,COULOMMIERS,3303,1540,4843,
Maison Natale de Louis Braille,2018,ILE-DE-FRANCE,COUPVRAY,5021,963,5984,
Musée Gatien Bonnet,2018,ILE-DE-FRANCE,LAGNY-SUR-MARNE,0,5302,5302,
Musée de la Grande Guerre du Pays de Meaux,2018,ILE-DE-FRANCE,MEAUX,76938,43062,120000,
Musée de la Résistance Nationale,2018,ILE-DE-FRANCE,CHAMPIGNY-SUR-MARNE,0,165,165,
Musée Emile Jean,2018,ILE-DE-FRANCE,VILLIERS-SUR-MARNE,0,52,52,
ARCHEA - Archéologie en Pays de France,2018,ILE-DE-FRANCE,LOUVRES,7293,6082,13375,
Musée Départemental Maurice Denis,2018,ILE-DE-FRANCE,SAINT-GERMAIN-EN-LAYE,8432,3164,11596,
Muséum d'Histoire Naturelle,2018,LA REUNION,SAINT-DENIS,5282,25523,30805,
Ecomusée de la Martinique,2018,MARTINIQUE,RIVIERE-PILOTE,6775,1708,8483,
Tapisserie de Bayeux - MAHB Musée d'Art et d'Histoire Baron Gérard,2018,NORMANDIE,BAYEUX,358607,60495,419102,
Musée de la Bataille de Tilly-Sur-Seulles 1944,2018,NORMANDIE,TILLY-SUR-SEULLES,766,703,1469,
Paléospace / Musée Paléontologique,2018,NORMANDIE,VILLERS-SUR-MER,52927,7152,60079,
Musée du Poiré,2018,NORMANDIE,BARENTON,998,4094,5092,
Musée de l'Abbaye,2018,NORMANDIE,CERISY-LA-FORET,4309,1054,5363,
Musée de la Guerre et de la Libération,2018,NORMANDIE,CHERBOURG-EN-COTENTIN,2951,5026,7977,
Musée du Granit,2018,NORMANDIE,SAINT-MICHEL-DE-MONTJOIE,64,2078,2142,
Musée de la Poeslerie,2018,NORMANDIE,VILLEDIEU-LES-POELES-ROUFFIGNY,3772,1056,4828,
Musée Municipal d'Archéologie,2018,NORMANDIE,L'AIGLE,370,607,977,
Musée Départemental d'Art Sacré,2018,NORMANDIE,SEES,505,270,775,
MUNAE - Musée National de l'Education,2018,NORMANDIE,ROUEN,9941,11780,21721,
Musée de la Céramique,2018,NORMANDIE,ROUEN,0,10046,10046,
Musée des Beaux-Arts,2018,NOUVELLE-AQUITAINE,ANGOULEME,11111,30801,41912,
Musée Municipal de Cognac,2018,NOUVELLE-AQUITAINE,COGNAC,2841,3700,6541,
Musée Régional de Fouras,2018,NOUVELLE-AQUITAINE,FOURAS,7669,1698,9367,
Musée Napoléonien et Africain,2018,NOUVELLE-AQUITAINE,ILE D'AIX,13070,10594,23664,
Muséum d'Histoire Naturelle,2018,NOUVELLE-AQUITAINE,LA ROCHELLE,17704,45353,63057,
Hôtel Hèbre de Saint-Clément - Musée d'Art et d'Histoire,2018,NOUVELLE-AQUITAINE,ROCHEFORT,11024,12516,23540,
Musée de l'Echevinage,2018,NOUVELLE-AQUITAINE,SAINTES,1295,3364,4659,
Musée de l'Ile d'Oléron,2018,NOUVELLE-AQUITAINE,ST-PIERRE D'OLERON,8118,3441,11559,
Musée du Pays d'Ussel,2018,NOUVELLE-AQUITAINE,USSEL,387,2204,2591,
Musée Départemental de la Tapisserie,2018,NOUVELLE-AQUITAINE,AUBUSSON,26967,10307,37274,
Musée Municipal,2018,NOUVELLE-AQUITAINE,VILLANDRAUT,144,200,344,
Musée d'Art et d'Histoire du Cap de Gascogne,2018,NOUVELLE-AQUITAINE,SAINT-SEVER,0,2400,2400,
Musée Départemental de la Faïence et des Arts de la table,2018,NOUVELLE-AQUITAINE,SAMADET,3597,1146,4743,
Musée Municipal Albert Marzelles,2018,NOUVELLE-AQUITAINE,MARMANDE,0,4128,4128,
Musée Bonnat-Helleu - Musée des Beaux-Arts de Bayonne,2018,NOUVELLE-AQUITAINE,BAYONNE,0,1050,1050,
Musée Basque et de l'Histoire de Bayonne,2018,NOUVELLE-AQUITAINE,BAYONNE,20874,43592,64466,
Musée Municipal des Beaux-Arts,2018,NOUVELLE-AQUITAINE,PAU,7936,12188,20124,
Musée Bernadotte,2018,NOUVELLE-AQUITAINE,PAU,1365,2247,3612,
Musée de l'hypogée des Dunes,2018,NOUVELLE-AQUITAINE,POITIERS,0,481,481,
Musée du Palais des Evêques,2018,OCCITANIE,SAINT-LIZIER,10134,1414,11548,
Musée des Corbières,2018,OCCITANIE,SIGEAN,180,959,1139,
"Musée des Mœurs et Coutumes, Musée du Rouergue",2018,OCCITANIE,ESPALION,639,386,1025,
Musée Joseph Vaylet,2018,OCCITANIE,ESPALION,2065,3274,5339,
Musée Municipal de la Vignasse,2018,OCCITANIE,BEAUCAIRE,1978,537,2515,
Musée Cévenol,2018,OCCITANIE,LE VIGAN,1383,1994,3377,
Musée Départemental d'Art Sacré du Gard,2018,OCCITANIE,PONT-SAINT-ESPRIT,130,8075,8205,
Maison Rouge - Musée des Vallées Cévenoles,2018,OCCITANIE,SAINT-JEAN DU GARD,28645,12349,40994,
Musée Pierre de Luxembourg,2018,OCCITANIE,VILLENEUVE-LES-AVIGNON,2931,3231,6162,
Musée d'Archéologie,2018,OCCITANIE,LECTOURE,1901,1718,3619,
Musée Georges Labit,2018,OCCITANIE,TOULOUSE,6292,23425,29717,
Musée Agathois,2018,OCCITANIE,AGDE,1552,2004,3556,
Musée de l'Etang de Thau,2018,OCCITANIE,BOUZIGUES,3110,8860,11970,
Musée Archéologique Paul Soyris,2018,OCCITANIE,MURVIEL-LES-MONTPELLIER,523,1474,1997,
Musée du Pays Vaurais,2018,OCCITANIE,LAVAUR,1734,4936,6670,
Musée Raymond Lafage,2018,OCCITANIE,LISLE-SUR-TARN,2140,5166,7306,
Musée Théodore Calbet,2018,OCCITANIE,GRISOLLES,0,2548,2548,
Musée Ingres,2018,OCCITANIE,MONTAUBAN,0,13133,13133,
Musée de Préhistoire,2018,OCCITANIE,SAINT-ANTONIN-NOBLE-VAL,0,37,37,
"Musée de la Fève, Crèches et Traditions Populaires",2018,PAYS DE LA LOIRE,BLAIN,212,2371,2583,
Musée du Vignoble Nantais,2018,PAYS DE LA LOIRE,LE PALLET,3263,5544,8807,
Musée du Château des Ducs de Bretagne,2018,PAYS DE LA LOIRE,NANTES,148735,184005,332740,
Musée  Départemental Dobrée,2018,PAYS DE LA LOIRE,NANTES,7610,14731,22341,
Muséum des Sciences Naturelles,2018,PAYS DE LA LOIRE,ANGERS,5428,20811,26239,
Musée Jules-Desbois,2018,PAYS DE LA LOIRE,PARCAY-LES-PINS,3396,1015,4411,
Château-Musée,2018,PAYS DE LA LOIRE,SAUMUR,78477,15549,94026,
Musée des Tisserands Mayennais,2018,PAYS DE LA LOIRE,AMBRIERES-LES-VALLEES,136,171,307,
Centre Minier de Faymoreau,2018,PAYS DE LA LOIRE,FAYMOREAU,9945,2728,12673,
Musée ornithologique Charles-Payraudeau,2018,PAYS DE LA LOIRE,LA-CHAIZE-LE-VICOMTE,215,294,509,
Musée de la vallée,2018,PROVENCE-ALPES-CÔTE D'AZUR,BARCELONNETTE,8541,2668,11209,
Musée de Salagon,2018,PROVENCE-ALPES-CÔTE D'AZUR,MANE,26221,6187,32408,
Musée Fernand Léger,2018,PROVENCE-ALPES-CÔTE D'AZUR,BIOT,14892,17953,32845,
Musée-Château de Cagnes,2018,PROVENCE-ALPES-CÔTE D'AZUR,CAGNES-SUR-MER,13286,10872,24158,
Musée Bonnard,2018,PROVENCE-ALPES-CÔTE D'AZUR,LE CANNET,28968,10178,39146,
Musée National Marc Chagall,2018,PROVENCE-ALPES-CÔTE D'AZUR,NICE,108132,64757,172889,
Musées de la Citadelle,2018,PROVENCE-ALPES-CÔTE D'AZUR,VILLEFRANCHE-SUR-MER,0,45958,45958,
Muséum d'Histoire Naturelle,2018,PROVENCE-ALPES-CÔTE D'AZUR,AIX-EN-PROVENCE,2107,15830,17937,
Musée des Tapisseries,2018,PROVENCE-ALPES-CÔTE D'AZUR,AIX-EN-PROVENCE,3243,11728,14971,
Musée Camarguais,2018,PROVENCE-ALPES-CÔTE D'AZUR,ARLES,10260,11670,21930,
Musée Départemental de l'Arles Antique,2018,PROVENCE-ALPES-CÔTE D'AZUR,ARLES,29828,94462,124290,
Musée Municipal Méditerranéen de Cassis A.T.P.,2018,PROVENCE-ALPES-CÔTE D'AZUR,CASSIS,7,5310,5317,
Musée Grobet-Labadié,2018,PROVENCE-ALPES-CÔTE D'AZUR,MARSEILLE,0,3313,3313,
Musée Municipal Paul Lafran,2018,PROVENCE-ALPES-CÔTE D'AZUR,SAINT-CHAMAS,0,3395,3395,
Musée Estrine - Présence Van Gogh,2018,PROVENCE-ALPES-CÔTE D'AZUR,SAINT-REMY-DE-PROVENCE,12339,4156,16495,
Musée de l'Artillerie,2018,PROVENCE-ALPES-CÔTE D'AZUR,DRAGUIGNAN,0,16580,16580,
Musée Jean Aicard,2018,PROVENCE-ALPES-CÔTE D'AZUR,LE POUVEREL LA GARDE,0,2662,2662,
Musée de l'Annonciade,2018,PROVENCE-ALPES-CÔTE D'AZUR,SAINT-TROPEZ,26040,5729,31769,
Musée National de la Marine de Toulon,2018,PROVENCE-ALPES-CÔTE D'AZUR,TOULON,26463,30346,56809,
Musée d'Apt,2018,PROVENCE-ALPES-CÔTE D'AZUR,APT,2834,4751,7585,
Musée du Petit Palais,2018,PROVENCE-ALPES-CÔTE D'AZUR,AVIGNON,2708,32403,35111,
Musée Marc Deydier,2018,PROVENCE-ALPES-CÔTE D'AZUR,CUCURON,0,180,180,
Musée-Bibliothèque François Pétrarque,2018,PROVENCE-ALPES-CÔTE D'AZUR,FONTAINE-DE-VAUCLUSE,1566,1800,3366,
Musée de la Bresse - Domaine des Planons,2019,AUVERGNE-RHONE-ALPES,SAINT-CYR-SUR-MENTHON,10704,6203,16907,M0972
Musée Départemental du Revermont,2019,AUVERGNE-RHONE-ALPES,VAL-REVERMONT,2611,7151,9762,M0975
Musée Anne de Beaujeu,2019,AUVERGNE-RHONE-ALPES,MOULINS,18343,12229,30572,M0106
MuséAL - Musée Archéologique d'Alba,2019,AUVERGNE-RHONE-ALPES,ALBA-LA-ROMAINE,13528,3011,16539,M1174
Musée de la Batellerie du Rhône,2019,AUVERGNE-RHONE-ALPES,SERRIERES,512,132,644,M0979
Musée des Vans,2019,AUVERGNE-RHONE-ALPES,LES VANS,766,1328,2094,M0977
Ecomusée de Margeride-Haute-Auvergne,2019,AUVERGNE-RHONE-ALPES,RUYNES-EN-MARGERIDE,12676,644,13320,M0112
Musée d'art et d'histoire Alfred Douët,2019,AUVERGNE-RHONE-ALPES,SAINT-FLOUR,1604,2484,4088,M0114
Musée d'Archéologie Tricastine,2019,AUVERGNE-RHONE-ALPES,SAINT-PAUL-TROIS-CHATEAUX,2841,7982,10823,M0987
Musée du site Préhistorique,2019,AUVERGNE-RHONE-ALPES,VASSIEUX-EN-VERCORS,10554,711,11265,M0989
Musée Crozatier,2019,AUVERGNE-RHONE-ALPES,LE PUY-EN-VELAY,26702,15857,42559,M0116
Musée du Patrimoine de l'Oisans,2019,AUVERGNE-RHONE-ALPES,ALPE D'HUEZ,0,3254,3254,M1000
Musée Gallo-Romain,2019,AUVERGNE-RHONE-ALPES,AOSTE,3388,1821,5209,M0990
Musée - Parc Archéologique du Lac de Paladru,2019,AUVERGNE-RHONE-ALPES,CHARAVINES,0,0,0,M1187
Conservatoire - Musée des Industries Hydroélectriques,2019,AUVERGNE-RHONE-ALPES,VAUJANY,0,7417,7417,M0993
Musée des Beaux-Arts et d'Archéologie,2019,AUVERGNE-RHONE-ALPES,VIENNE,2189,3344,5533,M1005
Musée d'Art Roger-Quillot,2019,AUVERGNE-RHONE-ALPES,CLERMONT-FERRAND,3620,18922,22542,M0121
Musée des Pénitents Blancs,2019,AUVERGNE-RHONE-ALPES,MARSAC-EN-LIVRADOIS,147,0,147,M0124
Musée des Beaux-Arts,2019,AUVERGNE-RHONE-ALPES,LYON,139166,144515,283681,M1031
Musée Historique des Tissus et des Arts Décoratifs,2019,AUVERGNE-RHONE-ALPES,LYON,42334,26177,68511,M1038
Musée des Confluences,2019,AUVERGNE-RHONE-ALPES,LYON,303630,367447,671077,M7042
Musée archéologique et minéralogique Pierre Borrione,2019,AUVERGNE-RHONE-ALPES,AIME-EN-TARENTAISE Cedex,390,232,622,M1043
Musée Municipal d'Albertville-Conflans,2019,AUVERGNE-RHONE-ALPES,ALBERTVILLE,2695,2115,4810,M1046
Muséum d'histoire naturelle,2019,AUVERGNE-RHONE-ALPES,CHAMBERY CEDEX,0,2847,2847,M7029
Musée du Pays Châtillonnais - Trésor de Vix,2019,BOURGOGNE-FRANCHE-COMTE,CHATILLON-SUR-SEINE,13326,5995,19321,M0136
Musée des Beaux-Arts,2019,BOURGOGNE-FRANCHE-COMTE,DIJON,0,310819,310819,M0137
Musée Municipal François Pompon,2019,BOURGOGNE-FRANCHE-COMTE,SAULIEU,3136,5824,8960,M0146
Musée Comtois,2019,BOURGOGNE-FRANCHE-COMTE,BESANCON,36567,0,36567,M0334
Musée-Maison Natale Gustave Courbet,2019,BOURGOGNE-FRANCHE-COMTE,ORNANS,41245,30444,71689,M0339
Musée Départemental Albert-et-Félicie Demard - ATP,2019,BOURGOGNE-FRANCHE-COMTE,CHAMPLITTE,4019,13424,17443,M0354
Musée des Beaux-Arts,2019,BOURGOGNE-FRANCHE-COMTE,LONS-LE-SAUNIER,1011,3683,4694,M0345
Viséum-Musée de la Lunette,2019,BOURGOGNE-FRANCHE-COMTE,MOREZ HAUTS DE BIENNE,8480,5060,13540,M0350
Musée d'Art et d'Histoire Romain Rolland,2019,BOURGOGNE-FRANCHE-COMTE,CLAMECY,2117,2186,4303,M0150
Musée Archéologique de la Porte du Croux,2019,BOURGOGNE-FRANCHE-COMTE,NEVERS,263,959,1222,M0156
Musée Lapidaire Saint-Nicolas,2019,BOURGOGNE-FRANCHE-COMTE,AUTUN,0,500,500,M0160
Musée de la Mine,2019,BOURGOGNE-FRANCHE-COMTE,BLANZY,10168,1901,12069,M0163
Musée de Bibracte,2019,BOURGOGNE-FRANCHE-COMTE,SAINT-LEGER-SOUS-BEUVRAY,40321,7846,48167,M1199
Forge-Musée,2019,BOURGOGNE-FRANCHE-COMTE,ETUEFFONT,469,611,1080,M0362
Muséum - Maison de l'Eau,2019,BOURGOGNE-FRANCHE-COMTE,AUXERRE,0,17423,17423,M7020
Musée d'Art et d'Histoire Saint-Germain,2019,BOURGOGNE-FRANCHE-COMTE,AUXERRE,0,32166,32166,M0184
Musée Muncipal,2019,BOURGOGNE-FRANCHE-COMTE,SENS,7368,22983,30351,M0189
Musée d'Art et d'Histoire,2019,BRETAGNE,SAINT-BRIEUC,0,23151,23151,M0196
Musée des Beaux-Arts de Brest,2019,BRETAGNE,BREST,9721,13966,23687,M0197
Musée de la Pêche,2019,BRETAGNE,CONCARNEAU,21409,21071,42480,M0199
Musée des Beaux-Arts,2019,BRETAGNE,QUIMPER,51589,42026,93615,M0207
Ecomusée Industriel des Forges,2019,BRETAGNE,INZINZAC-LOCHRIST,1929,2205,4134,M0223
Musée National de la Marine,2019,BRETAGNE,PORT-LOUIS,45488,32734,78222,M5026
Musée de la Résistance Bretonne,2019,BRETAGNE,SAINT-MARCEL,9811,2104,11915,M0225
"La Cohue, Musée des Beaux-Arts de vannes",2019,BRETAGNE,VANNES,12544,270706,283250,M0228
Musée des Beaux-Arts,2019,CENTRE-VAL DE LOIRE,CHARTRES,0,28183,28183,M0238
Musée d'Art et d'Histoire de Dreux,2019,CENTRE-VAL DE LOIRE,DREUX,350,13776,14126,M0241
Musée de l'Hospice Saint-Roch,2019,CENTRE-VAL DE LOIRE,ISSOUDUN,0,23003,23003,M0248
"Le Carroi, Musée d’Arts et d’Histoire",2019,CENTRE-VAL DE LOIRE,CHINON,386,553,939,M0255
Musée de la Corbillière,2019,CENTRE-VAL DE LOIRE,MER,0,5781,5781,M0273
Musée de la Marine de Loire,2019,CENTRE-VAL DE LOIRE,CHÂTEAUNEUF-SUR-LOIRE,7583,4611,12194,M0280
"Château-Musée de Gien : chasse, histoire et nature en Val de Loire",2019,CENTRE-VAL DE LOIRE,GIEN,12980,5525,18505,M0282
Musée Girodet,2019,CENTRE-VAL DE LOIRE,MONTARGIS,6350,11070,17420,M0284
Musée Arthur Rimbaud,2019,GRAND EST,CHARLEVILLE-MEZIERES,6503,13543,20046,M0291
Musée du Rethelois et du Porcien,2019,GRAND EST,RETHEL,0,1207,1207,M0295
Musée Napoléon Ier,2019,GRAND EST,BRIENNE-LE-CHATEAU,7306,1931,9237,M0299
Cabinet des Estampes et des Dessins,2019,GRAND EST,STRASBOURG,0,41,41,M0013
Musée Alsacien,2019,GRAND EST,STRASBOURG,40782,30658,71440,M0014
Musée J.F. Oberlin,2019,GRAND EST,WALDERSBACH,16415,7172,23587,M0021
Musée de la Bataille du 6 Août 1870,2019,GRAND EST,WŒRTH,1246,1899,3145,M0023
Musée Municipal,2019,GRAND EST,BOURBONNE-LES-BAINS,0,1937,1937,M0317
Musée Sundgauvien d'Altkirch,2019,GRAND EST,ALTKIRCH,934,3257,4191,M0024
Musée d'Unterlinden,2019,GRAND EST,COLMAR,127491,37993,165484,M0028
Musée de l'Impression sur Etoffes,2019,GRAND EST,MULHOUSE,12956,0,12956,M0037
Maison du Sundgau - Musée Paysan,2019,GRAND EST,OLTINGUE,595,130,725,M0041
Musée du Cloître de Notre-Dame-en-Vaux,2019,GRAND EST,CHÂLONS-EN-CHAMPAGNE,946,2112,3058,M1178
Musée Municipal d'Epernay,2019,GRAND EST,EPERNAY,0,386,386,M0309
Musée Hôtel le Vergeur,2019,GRAND EST,REIMS,10552,0,10552,M0314
Musée de l'Ecole de Nancy,2019,GRAND EST,NANCY,27128,16393,43521,M0513
Palais des ducs de Lorraine - Musée Historique Lorrain,2019,GRAND EST,NANCY,0,85841,85841,M0514
"Musée ""au Fil du Papier""",2019,GRAND EST,PONT-A-MOUSSON,2549,3651,6200,M1080
Musée d'Art et d'Histoire de Toul,2019,GRAND EST,TOUL,0,12800,12800,M0515
Maison du Verre et du Cristal,2019,GRAND EST,MEISENTHAL,15457,2202,17659,M0528
Centre Pompidou de Metz,2019,GRAND EST,METZ,127515,176093,303608,
Musée de la Mine - Carreau Wendel,2019,GRAND EST,PETITE-ROSSELLE,28970,5411,34381,M1089
Musée Départemental Georges de la Tour,2019,GRAND EST,VIC-SUR-SEILLE,3017,4632,7649,M1085
Musée des Cultures Guyanaises,2019,GUYANE,CAYENNE,883,4518,5401,M1064
Musée Territorial Alexandre Franconie,2019,GUYANE,CAYENNE,3052,4122,7174,M1063
Musée - Centre de Documentation Alfred Desmasures,2019,HAUTS-DE-France,HIRSON,0,0,0,M0788
Musée Jeanne d'Aboville,2019,HAUTS-DE-France,LA FERE,774,1327,2101,M0789
Musée Entomologique,2019,HAUTS-DE-France,SAINT-QUENTIN,5593,8556,14149,M7060
Musée Alexandre Dumas,2019,HAUTS-DE-France,VILLERS COTTERETS,966,1176,2142,M0796
Musée de la Chartreuse,2019,HAUTS-DE-France,DOUAI,10055,16251,26306,M0619
Musée Portuaire,2019,HAUTS-DE-France,DUNKERQUE,39288,31449,70737,M0622
Musée du Dessin et de l'Estampe Originale,2019,HAUTS-DE-France,GRAVELINES,4657,6505,11162,M0625
Musée Municipal d'Hazebrouck,2019,HAUTS-DE-France,HAZEBROUCK,767,5116,5883,M0626
Musée de l'Hospice Comtesse,2019,HAUTS-DE-France,LILLE,27377,27377,54754,M0631
Musée Henri Boez,2019,HAUTS-DE-France,MAUBEUGE,0,300,300,M0633
Musée des Beaux-Arts,2019,HAUTS-DE-France,VALENCIENNES,16853,15690,32543,M0638
Musée de la Figurine Historique,2019,HAUTS-DE-France,COMPIEGNE,2625,5291,7916,M0804
Musée d'Art et d'Archéologie,2019,HAUTS-DE-France,SENLIS,4161,7304,11465,M0809
Musée de l'Hôtel Sandelin,2019,HAUTS-DE-France,SAINT-OMER,2139,11261,13400,M0650
Musée Intercommunal d'Etampes,2019,ILE-DE-France,ETAMPES,580,8350,8930,M0405
Musée d'Art et d'Histoire,2019,ILE-DE-France,MEUDON,3281,12784,16065,M0412
Musée des Avelines - Musée d'Art et d'Histoire,2019,ILE-DE-France,SAINT-CLOUD,4536,14364,18900,M0416
Sèvres - Cité de la Céramique,2019,ILE-DE-France,SEVRES,19969,20117,40086,M5019
MUS - Musée d'Histoire Urbaine et Sociale,2019,ILE-DE-France,SURESNES,5752,6256,12008,M0418
Grande Galerie de l'Evolution (Muséum National d'Histoire Naturelle),2019,ILE-DE-France,PARIS,525703,312883,838586,M7006
Musée de l'Homme (Muséum National d'Histoire Naturelle),2019,ILE-DE-France,PARIS,126355,78211,204566,M7008
Galerie de Minéralogie et de Géologie (Muséum d'Histoire Naturelle),2019,ILE-DE-France,PARIS,30148,38526,68674,M7004
Musées des Arts Décoratifs - MAD,2019,ILE-DE-France,PARIS,168465,127954,296419,M5021
Musée Zadkine,2019,ILE-DE-France,PARIS,16440,22347,38787,M1115
Musée National Auguste Rodin,2019,ILE-DE-France,PARIS,360654,189985,550639,M5044
Musée du Moyen Age-Thermes et Hôtel de Cluny,2019,ILE-DE-France,PARIS,100869,116958,217827,M5003
Musée d'Art Moderne de la ville de Paris,2019,ILE-DE-France,PARIS,146018,143449,289467,M1101
Palais Galliera - Musée de la Mode de la ville de Paris,2019,ILE-DE-France,PARIS,118165,0,118165,M1108
Musée Bossuet,2019,ILE-DE-France,MEAUX,2500,8000,10500,M0378
Musée départemental Stéphane Mallarmé,2019,ILE-DE-France,VULAINES-SUR-SEINE,1938,4049,5987,M0386
Musée de Saint-Maur - Villa Médicis,2019,ILE-DE-France,LA VARENNE-SAINT-HILAIRE,0,6938,6938,M0429
Musée Archéologique du Val d'Oise,2019,ILE-DE-France,GUIRY-EN-VEXIN,0,20440,20440,M0434
Musée Camille Pissarro,2019,ILE-DE-France,PONTOISE,3183,2355,5538,M0439
Musée de la Batellerie et des Voies Navigables,2019,ILE-DE-France,CONFLANS-SAINTE-HONORINE,11771,4117,15888,M0387
Musée de l'Hôtel-Dieu,2019,ILE-DE-France,MANTES-LA-JOLIE,4078,1620,5698,M0389
Musée-Maison Maurice Ravel,2019,ILE-DE-France,MONTFORT-L'AMAURY,1888,187,2075,M0392
MuMa - Musée de Mayotte,2019,MAYOTTE,DZAOUDZI,0,6583,6583,M1212
Tapisserie de Bayeux - MAHB Musée d'Art et d'Histoire Baron Gérard,2019,NORMANDIE,BAYEUX,386861,58728,445589,M0655
Musée d'Ethnographie et d'Arts Populaires et Musée de la Marine,2019,NORMANDIE,HONFLEUR,13997,10292,24289,M0662
Musée des Instruments à Vent,2019,NORMANDIE,LA COUTURE-BOUSSEY,0,2644,2644,M0704
Musée Municipal Nicolas Poussin,2019,NORMANDIE,LES ANDELYS,0,2575,2575,M0705
Musée du Poiré,2019,NORMANDIE,BARENTON,856,4789,5645,M0674
Muséum Emmanuel Liais,2019,NORMANDIE,CHERBOURG-EN-COTENTIN,2091,7173,9264,M0678
Musée Quesnel-Morinière,2019,NORMANDIE,COUTANCES,365,5651,6016,M0680
Musée Richard Anacréon,2019,NORMANDIE,GRANVILLE,12565,7900,20465,M0683
Ferme-Musée du Cotentin,2019,NORMANDIE,SAINTE-MERE-EGLISE,6585,2385,8970,M1190
Musée Régional du Cidre et du Calvados,2019,NORMANDIE,VALOGNES,1232,871,2103,M0691
Musée Municipal - Musée du Jouet,2019,NORMANDIE,LA FERTE-MACE,1343,61,1404,M0697
Musée Départemental d'Art Sacré,2019,NORMANDIE,SEES,573,180,753,M0700
Château-Musée de Dieppe,2019,NORMANDIE,DIEPPE,18720,17754,36474,M0712
Musée de l'Hôtel Dubocage de Bléville,2019,NORMANDIE,LE HAVRE,0,11935,11935,M0718
Musée Mathon-Durand,2019,NORMANDIE,NEUFCHÂTEL-EN-BRAY,1308,452,1760,M0727
Musée Industriel de la Corderie Vallois,2019,NORMANDIE,NOTRE-DAME-DE-BONDEVILLE,0,11613,11613,M0728
Musée Archéologique et Historique,2019,NOUVELLE-AQUITAINE,ANGOULEME,111,421,532,M0821
Cité International de la Bande Dessinée et de l'Image - Musée de la Bande Dessinée,2019,NOUVELLE-AQUITAINE,ANGOULEME,17631,32795,50426,M0820
Musée de la Mytiliculture,2019,NOUVELLE-AQUITAINE,ESNANDES,3887,1991,5878,M0823
Muséum d'Histoire Naturelle et d'Ethnographie,2019,NOUVELLE-AQUITAINE,LA ROCHELLE,17501,53750,71251,M7040
Musée du Président Jacques Chirac,2019,NOUVELLE-AQUITAINE,SARRAN,18000,7000,25000,M1084
Musée Bernard d’Agesci,2019,NOUVELLE-AQUITAINE,NIORT,6207,12964,19171,M0841
Musée d'Art et d'Histoire Georges Turpin,2019,NOUVELLE-AQUITAINE,PARTHENAY,0,7266,7266,M0843
Château de Bourdeilles,2019,NOUVELLE-AQUITAINE,BOURDEILLES,28908,2007,30915,M0050
Musée Paul Reclus,2019,NOUVELLE-AQUITAINE,DOMME,319,13421,13740,M0052
Musée Municipal,2019,NOUVELLE-AQUITAINE,ARUDY,1307,1417,2724,M0092
Musée des Beaux-Arts,2019,NOUVELLE-AQUITAINE,PAU,6807,12836,19643,M0098
Musée du baptistère Saint-Jean,2019,NOUVELLE-AQUITAINE,POITIERS,10744,7376,18120,M0855
Musée du Textile et du Peigne en Corne,2019,OCCITANIE,LAVELANET,2138,534,2672,M1090
Musée Archéologique du Lauragais,2019,OCCITANIE,CASTELNAUDARY,385,330,715,M0441
Musée Joseph Vaylet,2019,OCCITANIE,ESPALION,3031,2924,5955,M0548
Musée Soulages,2019,OCCITANIE,RODEZ,96734,38923,135657,M1129
Musée du Charroi Rural et de l'Artisanat Traditionnel,2019,OCCITANIE,SALMIECH,0,500,500,M0554
Musée Cévenol,2019,OCCITANIE,LE VIGAN,1248,1868,3116,M0452
Musée des Cultures Taurines (Annexe musée du Vieux Nîmes),2019,OCCITANIE,NÎMES,2135,7709,9844,M0458
Muséum d'Histoire Naturelle et de Préhistoire,2019,OCCITANIE,NÎMES,6650,8598,15248,M7051
Musée d'Archéologie,2019,OCCITANIE,LECTOURE,2612,1296,3908,M0572
Musée Campanaire,2019,OCCITANIE,L'ISLE-JOURDAIN,8778,1334,10112,M0573
Le Musée - Arts et Figures des Pyrénées Centrales,2019,OCCITANIE,SAINT-GAUDENS,981,173,1154,M0561
Musée du Biterrois,2019,OCCITANIE,BEZIERS,262,1152,1414,M0468
Musée de Lodève - Hôtel du cardinal de Fleury,2019,OCCITANIE,LODEVE,25707,12120,37827,M0474
Musée du Vieux Montpellier,2019,OCCITANIE,MONTPELLIER,655,4644,5299,M0478
Musée départemental d'Art Moderne,2019,OCCITANIE,CERET,47553,9392,56945,M0488
Musée des Monnaies et Médailles Joseph Puig,2019,OCCITANIE,PERPIGNAN Cedex,0,1912,1912,M0492
Musée Raymond Lafage,2019,OCCITANIE,LISLE-SUR-TARN,1774,6820,8594,M0602
Musée d'Histoire Naturelle Victor Brun,2019,OCCITANIE,MONTAUBAN,1903,8305,10208,M7046
Musée Ingres-Bourdelles,2019,OCCITANIE,MONTAUBAN,3051,7777,10828,M0607
Musée de Préhistoire,2019,OCCITANIE,SAINT-ANTONIN-NOBLE-VAL,0,43,43,M0608
Muséum d'Histoire Naturelle de Nantes,2019,PAYS DE LA LOIRE,NANTES,85000,42000,127000,M7049
Ecomusée de Saint-Nazaire,2019,PAYS DE LA LOIRE,SAINT-NAZAIRE,28876,10749,39625,M0747
Musée d'Art et d'Histoire,2019,PAYS DE LA LOIRE,BAUGE,0,6000,6000,M0752
Musée du Vieux Château,2019,PAYS DE LA LOIRE,LAVAL,7378,34717,42095,M0766
Musée Vert Véron-de-Forbonnais,2019,PAYS DE LA LOIRE,LE MANS,9815,14533,24348,M1192
Musée Espace Faïence de Malicorne,2019,PAYS DE LA LOIRE,MALICORNE-SUR-SARTHE,5563,7447,13010,M1172
Musée des Traditions de l'Île,2019,PAYS DE LA LOIRE,LA GUERINIERE,3973,1093,5066,M0775
Musée de l'Abbaye de Sainte-Croix,2019,PAYS DE LA LOIRE,LES SABLES-D'OLONNE,6912,28339,35251,M0778
Musée National Clemenceau-de Lattre,2019,PAYS DE LA LOIRE,MOUILLERON-EN-PAREDS,4349,4431,8780,M5049
Musée Départemental Gassendi,2019,PROVENCE-ALPES-CÔTE D'AZUR,DIGNE-LES-BAINS,6054,3714,9768,M0857
Musée Gallo-Romain Sisteron,2019,PROVENCE-ALPES-CÔTE D'AZUR,SISTERON,0,16090,16090,M0863
Musée d'Histoire Locale,2019,PROVENCE-ALPES-CÔTE D'AZUR,BIOT,2708,0,2708,M0869
Musée-Château de Cagnes,2019,PROVENCE-ALPES-CÔTE D'AZUR,CAGNES-SUR-MER,13262,12426,25688,M0870
Villa-Musée Jean-Honoré Fragonard,2019,PROVENCE-ALPES-CÔTE D'AZUR,GRASSE,0,4852,4852,M0876
Musée de Préhistoire Régionale,2019,PROVENCE-ALPES-CÔTE D'AZUR,MENTON,2038,6287,8325,M0874
Musée National Message Biblique Marc Chagall,2019,PROVENCE-ALPES-CÔTE D'AZUR,NICE,110793,67632,178425,M5029
Musée d'Art Moderne et d'Art Contemporain,2019,PROVENCE-ALPES-CÔTE D'AZUR,NICE,63456,71609,135065,M0888
Ecomusée du Pays de la Roudoule,2019,PROVENCE-ALPES-CÔTE D'AZUR,PUGET-ROSTANG,1300,3700,5000,M0890
Musée Granet,2019,PROVENCE-ALPES-CÔTE D'AZUR,AIX-EN-PROVENCE,111094,64002,175096,M0894
Musée Camarguais,2019,PROVENCE-ALPES-CÔTE D'AZUR,ARLES,13926,8104,22030,M0903
Musée d'Archéologie Méditerranéenne,2019,PROVENCE-ALPES-CÔTE D'AZUR,MARSEILLE,43723,162558,206281,M0919
Musée du Pays Brignolais,2019,PROVENCE-ALPES-CÔTE D'AZUR,BRIGNOLES,1496,1876,3372,M0932
Musée des Arts et Traditions Populaires de Moyenne Provence,2019,PROVENCE-ALPES-CÔTE D'AZUR,DRAGUIGNAN,1374,9905,11279,M0935
Musée d'Art de Toulon - M.A.T.,2019,PROVENCE-ALPES-CÔTE D'AZUR,TOULON,0,30181,30181,M0943
Muséum d'Histoire Naturelle Esprit Requien,2019,PROVENCE-ALPES-CÔTE D'AZUR,AVIGNON,0,18057,18057,M7021
Musée de l'Hôtel Dieu,2019,PROVENCE-ALPES-CÔTE D'AZUR,CAVAILLON,541,592,1133,M0952
Musée de l'Arche,2019,ST PIERRE ET MIQUELON,SAINT-PIERRE,4303,0,4303,M1071
Musée Municipal de Gannat,2020,AUVERGNE-RHONE-ALPES,GANNAT,412,158,570,M0103
Musée Municipal de Souvigny - Musée Saint-Marc,2020,AUVERGNE-RHONE-ALPES,SOUVIGNY,4307,936,5243,M0108
Cité de Préhistoire,2020,AUVERGNE-RHONE-ALPES,ORGNAC-L'AVEN,98074,6513,104587,M0978
Musée du Rhône,2020,AUVERGNE-RHONE-ALPES,TOURNON-SUR-RHÔNE,8140,2162,10302,M0981
Musée International de la Chaussure,2020,AUVERGNE-RHONE-ALPES,ROMANS-SUR-ISERE,9681,2409,12090,M0986
Musée d'Archéologie Tricastine,2020,AUVERGNE-RHONE-ALPES,SAINT-PAUL-TROIS-CHATEAUX,1124,2357,3481,M0987
Musée Archéologique Grenoble Saint-Laurent,2020,AUVERGNE-RHONE-ALPES,GRENOBLE,0,14841,14841,M0997
Musée Dauphinois,2020,AUVERGNE-RHONE-ALPES,GRENOBLE Cedex 1,0,30579,30579,M0996
Muséum d'Histoire Naturelle,2020,AUVERGNE-RHONE-ALPES,GRENOBLE Cedex 1,15179,45213,60392,M7038
Musée Hébert,2020,AUVERGNE-RHONE-ALPES,LA TRONCHE,0,15895,15895,M1003
Musée de la Grande Chartreuse,2020,AUVERGNE-RHONE-ALPES,SAINT-PIERRE-DE-CHARTREUSE,19846,951,20797,M1004
Musée Alice Taverne,2020,AUVERGNE-RHONE-ALPES,AMBIERLE,1512,476,1988,M1009
Musée d'Art et d'Industrie,2020,AUVERGNE-RHONE-ALPES,SAINT-ETIENNE Cedex 1,5875,5294,11169,M1023
Musée d'Archéologie Bargoin,2020,AUVERGNE-RHONE-ALPES,CLERMONT-FERRAND,2245,6811,9056,M0120
Musée Francisque Mandet,2020,AUVERGNE-RHONE-ALPES,RIOM,975,732,1707,M0127
Musée Municipal Marcel Sahut,2020,AUVERGNE-RHONE-ALPES,VOLVIC,288,471,759,M0130
Musées Gadagne,2020,AUVERGNE-RHONE-ALPES,LYON,13912,12162,26074,M1032
Musée d'Art Sacré,2020,BOURGOGNE-FRANCHE-COMTE,DIJON,0,5196,5196,M1208
Musée des Beaux-Arts,2020,BOURGOGNE-FRANCHE-COMTE,MONTBARD,0,117,117,M0142
Musée Municipal,2020,BOURGOGNE-FRANCHE-COMTE,SEMUR-EN-AUXOIS,448,1013,1461,M0147
Muséum d'Histoire Naturelle de Besançon,2020,BOURGOGNE-FRANCHE-COMTE,BESANCON,126006,0,126006,M7011
Musée du Temps,2020,BOURGOGNE-FRANCHE-COMTE,BESANCON,3783,27167,30950,M0333
Musée Beurnier-Rossel,2020,BOURGOGNE-FRANCHE-COMTE,MONTBELIARD,70,1085,1155,M0336
Musée Baron Martin,2020,BOURGOGNE-FRANCHE-COMTE,GRAY,2402,1574,3976,M0357
Musée Départemental de la Montagne Albert Demard,2020,BOURGOGNE-FRANCHE-COMTE,LE HAUT-DU-THEM-CHÂTEAU-LAMBERT,2442,2084,4526,M0355
Musée de la Tour des Echevins,2020,BOURGOGNE-FRANCHE-COMTE,LUXEUIL-LES-BAINS,859,297,1156,M0358
Musée Georges Garret,2020,BOURGOGNE-FRANCHE-COMTE,VESOUL,0,1725,1725,M0359
Musée des Beaux-Arts et d'Archéologie,2020,BOURGOGNE-FRANCHE-COMTE,DOLE,0,7362,7362,M0347
Musée du Jouet,2020,BOURGOGNE-FRANCHE-COMTE,MOIRANS-EN-MONTAGNE,27389,6043,33432,M0348
Musée de la Mine,2020,BOURGOGNE-FRANCHE-COMTE,LA MACHINE,1457,403,1860,M0153
Musée de la Faïence Frédéric Blandin,2020,BOURGOGNE-FRANCHE-COMTE,NEVERS,2471,2407,4878,M0155
Musée Rolin,2020,BOURGOGNE-FRANCHE-COMTE,AUTUN,8406,3733,12139,M0161
Musée Vivant Denon,2020,BOURGOGNE-FRANCHE-COMTE,CHALON-SUR-SAONE,0,6399,6399,M0165
Musée Nicéphore Niepce,2020,BOURGOGNE-FRANCHE-COMTE,CHALON-SUR-SAONE,0,12839,12839,M0166
"L'Atelier d'un Journal"" de Louhans - Musée Municipal",2020,BOURGOGNE-FRANCHE-COMTE,LOUHANS,0,879,879,M0171
Musée Départemental de Préhistoire de Solutré,2020,BOURGOGNE-FRANCHE-COMTE,SOLUTRE-POUILLY,8476,7594,16070,M0180
Musée Zervos - Maison Romain Rolland,2020,BOURGOGNE-FRANCHE-COMTE,VEZELAY,4479,1859,6338,M0191
Musée de Pont-Aven,2020,BRETAGNE,PONT-AVEN,33115,11617,44732,M0205
Musée Départemental Breton,2020,BRETAGNE,QUIMPER,10101,10670,20771,M0208
Musée des Beaux-Arts,2020,BRETAGNE,RENNES,7711,49893,57604,M0211
Ecomusée de l'Île de Groix,2020,BRETAGNE,ILE DE GROIX,1596,678,2274,M0222
Musée des Arts Décoratifs,2020,CENTRE-VAL DE LOIRE,BOURGES,1158,3652,4810,M0229
Musée des Beaux-Arts,2020,CENTRE-VAL DE LOIRE,CHARTRES,0,16394,16394,M0238
Conservatoire du Machinisme et des Pratiques Agricoles,2020,CENTRE-VAL DE LOIRE,CHARTRES-MAINVILLIERS,4302,0,4302,M0239
Musée d'Art et d'Histoire de Dreux,2020,CENTRE-VAL DE LOIRE,DREUX,748,5758,6506,M0241
Ecomusée du Véron,2020,CENTRE-VAL DE LOIRE,SAVIGNY-EN-VERON,2489,0,2489,M1088
Château Musées de Blois,2020,CENTRE-VAL DE LOIRE,BLOIS,166403,31982,198385,M0271
Musée des Beaux-Arts,2020,CENTRE-VAL DE LOIRE,ORLEANS,5776,17214,22990,M0286
"Hôtel Cabu, Musée d'Histoire et d'Archéologie",2020,CENTRE-VAL DE LOIRE,ORLEANS,1717,6101,7818,M0287
Musée de l'Alta Rocca,2020,CORSE,LEVIE,2470,704,3174,M0326
Musée de Préhistoire Corse,2020,CORSE,SARTENE,2587,1824,4411,M0327
Maison des Ailleurs - Arthur Rimbaud,2020,GRAND EST,CHARLEVILLE-MEZIERES,3048,1148,4196,M0291
Musée du Château-Fort,2020,GRAND EST,SEDAN Cedex,27746,2477,30223,M0296
Musée des Beaux-Arts,2020,GRAND EST,TROYES,3457,13629,17086,M0303
Musée Tomi Ungerer,2020,GRAND EST,STRASBOURG,9601,10744,20345,M1098
Maison des Lumières Denis Diderot,2020,GRAND EST,LANGRES,2554,3943,6497,M0320
Musée Municipal,2020,GRAND EST,SAINT-DIZIER,0,2135,2135,M0323
Musée Sundgauvien d'Altkirch,2020,GRAND EST,ALTKIRCH,226,430,656,M0024
Musée Gallo-Romain,2020,GRAND EST,BIESHEIM,267,413,680,M0025
Musée d'Unterlinden,2020,GRAND EST,COLMAR,39648,15003,54651,M0028
Musée Electropolis,2020,GRAND EST,MULHOUSE,11956,1638,13594,M0039
Musée de l'Impression sur Etoffes,2020,GRAND EST,MULHOUSE,4029,1367,5396,M0037
Maison du Sundgau - Musée Paysan,2020,GRAND EST,OLTINGUE,281,121,402,M0041
Musée de l'Argonne Viard-Morel,2020,GRAND EST,SAINTE-MENEHOULD,421,312,733,M0315
Musée Les Sources d'Hercule,2020,GRAND EST,DENEUVRE,17,68,85,M0507
Musée de l'Histoire du Fer,2020,GRAND EST,JARVILLE-LA-MALGRANGE,1480,2638,4118,M0509
"Musée ""au Fil du Papier""",2020,GRAND EST,PONT-A-MOUSSON,1129,1251,2380,M1080
Musée de la Céramique et de l'Ivoire,2020,GRAND EST,COMMERCY,224,656,880,M0518
Musée Départemental Georges de la Tour,2020,GRAND EST,VIC-SUR-SEILLE,188,3405,3593,M1085
Musée de l'Image,2020,GRAND EST,EPINAL,3308,8691,11999,M0537
Musée Départemental d'Art Ancien et Contemporain,2020,GRAND EST,EPINAL Cedex,2430,5793,8223,M0536
Musée de la Lutherie et de l'Archèterie Française,2020,GRAND EST,MIRECOURT,2315,825,3140,M0538
Musée Charles Friry,2020,GRAND EST,REMIREMONT,231,773,1004,M0541
Musée Pierre Noël - Musée de la Vie dans les Hautes-Vosges,2020,GRAND EST,SAINT-DIE-DES-VOSGES,1271,4225,5496,M0542
Musée des Beaux-Arts Antoine Lecuyer,2020,HAUTS-DE-France,SAINT-QUENTIN,4828,188,5016,M0793
Musée Départemental de Flandre,2020,HAUTS-DE-France,CASSEL,10391,5712,16103,M0617
Musée des Dentelles et Broderies,2020,HAUTS-DE-France,CAUDRY,3766,1467,5233,M1197
Ecomusée de la Région,2020,HAUTS-DE-France,FOURMIES-TRELON,5393,2328,7721,M0624
Musée Municipal d'Hazebrouck,2020,HAUTS-DE-France,HAZEBROUCK,160,3066,3226,M0626
"Centre Historique Minier, Musée de la Mine, Centre d'Archives, Centre de Culture Scientifique de l'Energie",2020,HAUTS-DE-France,LEWARDE,58476,2789,61265,M0628
Musée Henri Boez,2020,HAUTS-DE-France,MAUBEUGE Cedex,0,300,300,M0633
MusVerre,2020,HAUTS-DE-France,SARS-POTERIES,6075,8653,14728,M0636
Musée du Noyonnais,2020,HAUTS-DE-France,NOYON,647,490,1137,M0807
Musée Jean Calvin,2020,HAUTS-DE-France,NOYON,597,377,974,M0808
Musée des Beaux-Arts,2020,HAUTS-DE-France,ARRAS,236,11569,11805,M0640
Musée Communautaire Opale-Sud,2020,HAUTS-DE-France,BERCK-SUR-MER,1709,1448,3157,M0641
Musée de la Céramique,2020,HAUTS-DE-France,DESVRES,2739,369,3108,M0645
Musée du Touquet Paris-Plage,2020,HAUTS-DE-France,LE TOUQUET-PARIS-PLAGE,5028,4932,9960,M0648
Musée de l'Hôtel Sandelin,2020,HAUTS-DE-France,SAINT-OMER,2000,4648,6648,M0650
Musée Municipal Bruno Danvin,2020,HAUTS-DE-France,SAINT-POL-SUR-TERNOISE,0,845,845,M0652
Musée-Historial de la Grande Guerre,2020,HAUTS-DE-France,PERONNE Cédex,18903,4982,23885,M0816
Musée Intercommunal d'Etampes,2020,ILE-DE-France,ETAMPES,85,1727,1812,M0405
Musée des Années Trente,2020,ILE-DE-France,BOULOGNE-BILLANCOURT,11182,10555,21737,M0406
Musée Municipal d'Art et d'Histoire,2020,ILE-DE-France,COLOMBES,0,2021,2021,M0409
Musée d'Art et d'Histoire,2020,ILE-DE-France,MEUDON,3971,4881,8852,M0412
Galerie de Minéralogie et de Géologie (Muséum d'Histoire Naturelle),2020,ILE-DE-France,PARIS,9302,16537,25839,M7004
Grande Galerie de l'Evolution (Muséum National d'Histoire Naturelle),2020,ILE-DE-France,PARIS,180710,153938,334648,M7006
Établissement public du musée d'Orsay et du musée de l'Orangerie - Valéry Giscard d'Estaing - Musée d'Orsay,2020,ILE-DE-France,PARIS,424192,443082,867274,M5060
Établissement public du musée d'Orsay et du musée de l'Orangerie - Valéry Giscard d'Estaing - Musée de l'Orangerie,2020,ILE-DE-France,PARIS,119888,111268,231156,M5030
Musée de la Libération de Paris - Musée du Général Leclerc - Musée Jean Moulin,2020,ILE-DE-France,PARIS,10232,31075,41307,M1109
Musée d'Ennery,2020,ILE-DE-France,PARIS,0,260,260,M5040
Musée National d'Art Moderne (Centre National d'Art et de Culture Georges Pompidou),2020,ILE-DE-France,PARIS,648090,264713,912803,M5050
Maison Natale de Louis Braille,2020,ILE-DE-France,COUPVRAY,1465,339,1804,M0373
Musée du Château de Fontainebleau,2020,ILE-DE-France,FONTAINEBLEAU,63430,72763,136193,M5013
Musée de la Grande Guerre du Pays de Meaux,2020,ILE-DE-France,MEAUX,21061,17969,39030,M1171
Château-musée de Nemours,2020,ILE-DE-France,NEMOURS,3142,880,4022,M0381
Musée des Pays de Seine-et-Marne,2020,ILE-DE-France,SAINT-CYR-SUR-MORIN,1471,1610,3081,M0384
Musée départemental Stéphane Mallarmé,2020,ILE-DE-France,VULAINES-SUR-SEINE,888,867,1755,M0386
"MAC VAL, Musée d'Art Contemporain du Val-de-Marne",2020,ILE-DE-France,VITRY SUR SEINE,1852,17808,19660,M0431
Musée de la Renaissance - Château d'Ecouen,2020,ILE-DE-France,ECOUEN,3644,20652,24296,M5012
Musée de la Batellerie et des Voies Navigables,2020,ILE-DE-France,CONFLANS-SAINTE-HONORINE,3248,671,3919,M0387
Muséum d'Histoire Naturelle,2020,LA REUNION,SAINT-DENIS,1416,15984,17400,M7014
Musée du Père Pinchon,2020,MARTINIQUE,FORT-DE-France,0,1716,1716,M1181
Ecomusée de la Martinique,2020,MARTINIQUE,RIVIERE-PILOTE,2787,190,2977,M1081
Musée Municipal,2020,NORMANDIE,ORBEC,29,1112,1141,M0666
Musée des Instruments à Vent,2020,NORMANDIE,LA COUTURE-BOUSSEY,0,1019,1019,M0704
Musée Alphonse-Georges Poulain,2020,NORMANDIE,VERNON,2938,2839,5777,M0708
Musée de l'Abbaye,2020,NORMANDIE,CERISY-LA-FORÊT,3788,548,4336,M0676
Muséum Emmanuel Liais,2020,NORMANDIE,CHERBOURG-EN-COTENTIN,286,963,1249,M0678
Ferme-Musée du Cotentin,2020,NORMANDIE,SAINTE-MERE-EGLISE,3746,1286,5032,M1190
Musée Départemental d'Art Sacré,2020,NORMANDIE,SEES,0,1044,1044,M0700
Château-Musée de Dieppe,2020,NORMANDIE,DIEPPE,25537,0,25537,M0712
Musée Louis-Philippe du Château d'Eu,2020,NORMANDIE,EU,9391,2111,11502,M0714
"Juliobona, Musée Gallo-Romain de Lillebonne",2020,NORMANDIE,LILLEBONNE,1303,500,1803,M0724
Maison des Templiers,2020,NORMANDIE,RIVES-EN-SEINE,0,1300,1300,M0710
Musée-Maison Natale Pierre Corneille,2020,NORMANDIE,ROUEN,0,1021,1021,M0731
Atelier - Musée du Papier,2020,NOUVELLE-AQUITAINE,ANGOULEME,2113,13574,15687,M0819
Musée Napoléonien et Africain,2020,NOUVELLE-AQUITAINE,ÎLE-D'AIX,7317,4648,11965,M5048
Hôtel Hèbre de Saint-Clément - Musée d'Art et d'Histoire,2020,NOUVELLE-AQUITAINE,ROCHEFORT,6311,2099,8410,M0830
Musée Municipal des Cordeliers,2020,NOUVELLE-AQUITAINE,SAINT-JEAN-D'ANGELY,583,3806,4389,M0832
Musée du Président Jacques Chirac,2020,NOUVELLE-AQUITAINE,SARRAN,17358,2275,19633,M1084
Musée des Tumulus de Bougon,2020,NOUVELLE-AQUITAINE,BOUGON,6532,1627,8159,M0839
Musée Bernard d’Agesci,2020,NOUVELLE-AQUITAINE,NIORT,6207,4366,10573,M0841
Muséum d'Histoire Naturelle de Bordeaux,2020,NOUVELLE-AQUITAINE,BORDEAUX,33573,95727,129300,M7026
Musée de la Voiture à Cheval. Au temps des calèches,2020,NOUVELLE-AQUITAINE,BOURG-SUR-GIRONDE,669,180,849,M0070
Musée Départemental d'Art Contemporain,2020,NOUVELLE-AQUITAINE,ROCHECHOUART,4913,3039,7952,M0506
Musée d'Art et d'Histoire du Cap de Gascogne,2020,NOUVELLE-AQUITAINE,SAINT-SEVER,383,0,383,M0084
Musée des Beaux-Arts,2020,NOUVELLE-AQUITAINE,AGEN Cedex 9,15333,10854,26187,M0087
Musée Municipal (Moulin de Gajac),2020,NOUVELLE-AQUITAINE,VILLENEUVE-SUR-LOT,1330,1241,2571,M0091
Musée Municipal de Guéthary,2020,NOUVELLE-AQUITAINE,GUETHARY,838,541,1379,M0096
Musée National du Château,2020,NOUVELLE-AQUITAINE,PAU,27300,19811,47111,M5017
Musée des Traditions Populaires et d'Archéologie,2020,NOUVELLE-AQUITAINE,CHAUVIGNY,4490,1096,5586,M0848
Musée Charbonneau-Lassay,2020,NOUVELLE-AQUITAINE,LOUDUN,0,271,271,M0850
Musée de la Préhistoire,2020,OCCITANIE,LE MAS-D'AZIL,30220,3475,33695,M0544
Eburomagus Musée Archéologique,2020,OCCITANIE,BRAM,322,279,601,M1176
Palais-Musée des Archevêques de Narbonne,2020,OCCITANIE,NARBONNE,14362,10925,25287,M0445
Musée Municipal de la Vignasse,2020,OCCITANIE,BEAUCAIRE,281,524,805,M0451
Musée des Cultures Taurines,2020,OCCITANIE,NÎMES,843,2747,3590,M0458
Maison Rouge - Musée des Vallées Cévenoles,2020,OCCITANIE,SAINT-JEAN-DU-GARD,12037,4547,16584,M1079
Musée-Forum de l'Aurignacien,2020,OCCITANIE,AURIGNAC,2344,3634,5978,M0556
Musée du Pays de Luchon,2020,OCCITANIE,BAGNERES-DE-LUCHON,517,0,517,M0557
Muséum d'Histoire Naturelle,2020,OCCITANIE,TOULOUSE,79739,52129,131868,M7013
Musée du Vieux Toulouse,2020,OCCITANIE,TOULOUSE,3235,144,3379,M0567
Musée de l'Etang de Thau,2020,OCCITANIE,BOUZIGUES,3397,1883,5280,M0469
Musée Archéologique,2020,OCCITANIE,MINERVE,1806,0,1806,M0475
Musée d'Histoire de Figeac,2020,OCCITANIE,FIGEAC,179,47,226,M0577
"Musée Archéologique ""Armand-Viré""",2020,OCCITANIE,LUZECH,340,215,555,M0580
Musée Départemental de Cuzals,2020,OCCITANIE,SAULIAC-SUR-CELE,4859,1943,6802,M0583
Musée de Cerdagne,2020,OCCITANIE,SAINTE-LEOCADIE,1894,242,2136,M0497
Musée du Vieil Auvillar,2020,OCCITANIE,AUVILLAR,484,171,655,M0604
Musée des arts et traditions populaires (Abbaye),2020,OCCITANIE,MOISSAC,34156,3984,38140,M0606
Musée du Vignoble Nantais,2020,PAYS DE LA LOIRE,LE PALLET,1819,1109,2928,M0742
Musées du Parc Naturel Régional de Brière,2020,PAYS DE LA LOIRE,SAINT-JOACHIM,0,519,519,M0746
Ecomusée de Saint-Nazaire,2020,PAYS DE LA LOIRE,SAINT-NAZAIRE,7945,1611,9556,M0747
Musée des Beaux-Arts et Galerie David d'Angers,2020,PAYS DE LA LOIRE,ANGERS,12261,33667,45928,M0748
Musée du Textile,2020,PAYS DE LA LOIRE,CHOLET,881,4519,5400,M0756
Musée de la Vigne et du Vin d'Anjou,2020,PAYS DE LA LOIRE,SAINT LAMBERT-DU-LATTAY - VAL-DU-LAYON,1262,160,1422,M0758
Musée de la Reine Bérengère,2020,PAYS DE LA LOIRE,LE MANS,1100,1393,2493,M0771
Musée Espace Faïence de Malicorne,2020,PAYS DE LA LOIRE,MALICORNE-SUR-SARTHE,2827,2259,5086,M1172
Musée ornithologique Charles-Payraudeau,2020,PAYS DE LA LOIRE,LA CHAIZE-LE-VICOMTE,31,76,107,M7039
Musée des Traditions de l'Île,2020,PAYS DE LA LOIRE,LA GUERINIERE,2017,504,2521,M0775
Musée du Château,2020,PAYS DE LA LOIRE,NOIRMOUTIER-EN-L'ILE,29624,2978,32602,M0782
Musée Gallo-Romain Sisteron,2020,PROVENCE-ALPES-CÔTE D'AZUR,SISTERON,0,6337,6337,M0863
Musée d'Histoire Locale,2020,PROVENCE-ALPES-CÔTE D'AZUR,BIOT,1053,487,1540,M0869
Villa-Musée Jean-Honoré Fragonard,2020,PROVENCE-ALPES-CÔTE D'AZUR,GRASSE,285,1762,2047,M0876
Musée d'Art et d'Histoire de Provence,2020,PROVENCE-ALPES-CÔTE D'AZUR,GRASSE,1632,3880,5512,M0875
Musée du Palais Lascaris,2020,PROVENCE-ALPES-CÔTE D'AZUR,NICE,8175,11659,19834,M0887
Musée Archéologique - Site de Terra Amata,2020,PROVENCE-ALPES-CÔTE D'AZUR,NICE,1063,5433,6496,M0885
Musée du Pavillon de Vendôme,2020,PROVENCE-ALPES-CÔTE D'AZUR,AIX-EN-PROVENCE,2517,4719,7236,M0896
Musée du Parlement de Provence et du Vieil Aix,2020,PROVENCE-ALPES-CÔTE D'AZUR,AIX-EN-PROVENCE,2617,3489,6106,M0898
Musée Camarguais,2020,PROVENCE-ALPES-CÔTE D'AZUR,ARLES,7305,4154,11459,M0903
Musée Alphonse Daudet,2020,PROVENCE-ALPES-CÔTE D'AZUR,FONTVIEILLE,1324,219,1543,M0905
Musée des Beaux-Arts de Marseille,2020,PROVENCE-ALPES-CÔTE D'AZUR,MARSEILLE,29301,0,29301,M0913
Musée des Arts et Traditions Populaires de Moyenne Provence,2020,PROVENCE-ALPES-CÔTE D'AZUR,DRAGUIGNAN,978,4424,5402,M0935
Musée Jean Aicard,2020,PROVENCE-ALPES-CÔTE D'AZUR,LE POUVEREL LA GARDE,0,927,927,M0938
Musée d'Art de Toulon - M.A.T.,2020,PROVENCE-ALPES-CÔTE D'AZUR,TOULON,0,58383,58383,M0943
Muséum d'Histoire Naturelle de Toulon et du Var,2020,PROVENCE-ALPES-CÔTE D'AZUR,TOULON,0,25679,25679,M7061
Musée de l'Hôtel Dieu,2020,PROVENCE-ALPES-CÔTE D'AZUR,CAVAILLON,211,228,439,M0952
Musée Municipal,2020,PROVENCE-ALPES-CÔTE D'AZUR,ORANGE,22054,0,22054,M0959
Maison de l'Archéologie des Vosges du Nord,2001,ALSACE,NIEDERBRONN-LES-BAINS,3182,271,3453,
Musée du Fer,2001,ALSACE,REICHSHOFFEN,677,250,927,
Musée de l'Œuvre Notre-Dame,2001,ALSACE,STRASBOURG,21117,19097,40214,
Musée Alsacien,2001,ALSACE,STRASBOURG,30837,27247,58084,
Musée du Florival,2001,ALSACE,GUEBWILLER,3334,2066,5400,
Musée EDF Electropolis,2001,ALSACE,MULHOUSE,27931,5775,33706,
Musée du Dolder,2001,ALSACE,RIQUEWIHR,5424,640,6064,
Musée Paul Reclus,2001,AQUITAINE,DOMME,22096,0,22096,
Musée des Arts et Traditions Populaires du Périgord,2001,AQUITAINE,MUSSIDAN,1801,1350,3151,
Ecomusée de la Grande Lande,2001,AQUITAINE,SABRES,94770,9433,104203,
Musée des Beaux-Arts,2001,AQUITAINE,AGEN,5482,9403,14885,
Musée du Château Henri IV,2001,AQUITAINE,NERAC,15158,2730,17888,
Musée de Préhistoire Mésolithique Laurent Coulonges,2001,AQUITAINE,SAUVETERRE-LA-LEMANCE,752,0,752,
Musée National du Château,2001,AQUITAINE,PAU,57410,25920,83330,
Musée Rural de la Sologne Bourbonnaise,2001,AUVERGNE,BEAULON,100,0,100,
Musée d'Art et d'Archéologie,2001,AUVERGNE,AURILLAC,944,30741,31685,
Musée de Paléontologie,2001,AUVERGNE,CHILHAC,2883,153,3036,
Musée des Manufactures de Dentelles,2001,AUVERGNE,RETOURNAC,2693,0,2693,
Musée Paléontologique,2001,AUVERGNE,MENAT,944,0,944,
Musée Municipal de la Coutellerie,2001,AUVERGNE,THIERS,42894,5936,48830,
Musée des Beaux-Arts,2001,BOURGOGNE,DIJON,68167,98180,166347,
Musée Noisot,2001,BOURGOGNE,FIXIN,445,563,1008,
Musée Municipal,2001,BOURGOGNE,SEMUR-EN-AUXOIS,2364,2951,5315,
Musée de la Loire,2001,BOURGOGNE,COSNE-SUR-LOIRE,997,1390,2387,
Musée Rolin,2001,BOURGOGNE,AUTUN,19321,3800,23121,
Museum d'Histoire Naturelle Jacques de La Comble,2001,BOURGOGNE,AUTUN,735,3720,4455,
Musée Nicéphore Niepce,2001,BOURGOGNE,CHALON-SUR-SAONE,8526,10466,18992,
Musée Mathurin Meheut,2001,BRETAGNE,LAMBALLE,5901,0,5901,
Musée d'Art et d'Histoire,2001,BRETAGNE,SAINT-BRIEUC,0,17127,17127,
Musée de la Pêche,2001,BRETAGNE,CONCARNEAU,44000,4500,48500,
Musée de Pont-Aven,2001,BRETAGNE,PONT-AVEN,38713,3978,42691,
Musée de l'Ecole Rurale en Bretagne,2001,BRETAGNE,TREGARVAN,13521,0,13521,
Musée International du Long-Cours Cap-Hornier,2001,BRETAGNE,SAINT-MALO,9038,3558,12596,
Musée des Rochers-Sévigné,2001,BRETAGNE,VITRE,9505,1410,10915,
Ecomusée de Saint-Dégan,2001,BRETAGNE,BREC'H,9501,0,9501,
Musée de la Compagnie des Indes,2001,BRETAGNE,PORT-LOUIS,66137,0,66137,
Musée des Arts Décoratifs,2001,CENTRE,BOURGES,0,19307,19307,
Muséum des Sciences Naturelles et de Préhistoire,2001,CENTRE,CHARTRES,0,17114,17114,
Musée d'Art et d'Histoire de Dreux,2001,CENTRE,DREUX,461,4890,5351,
Musée Marcel Proust,2001,CENTRE,ILLIERS-COMBRAY,4799,0,4799,
Musée Archéologique d'Argentomagus,2001,CENTRE,SAINT-MARCEL,19553,0,19553,
"""Maison Musée"" René Descartes",2001,CENTRE,DESCARTES,809,0,809,
Musée du Compagnonnage,2001,CENTRE,TOURS,40393,8282,48675,
Muséum d'Histoire Naturelle,2001,CENTRE,BLOIS,6324,6226,12550,
Château Musées de Blois,2001,CENTRE,BLOIS,290615,0,290615,
Musée de Vendôme,2001,CENTRE,VENDOME,2484,8185,10669,
Musée des Beaux-Arts,2001,CENTRE,ORLEANS,9106,22463,31569,
Musée Vauluisant - Musée de la Bonneterie,2001,CHAMPAGNE-ARDENNES,TROYES,4641,4546,9187,
Musée d'Art Moderne,2001,CHAMPAGNE-ARDENNES,TROYES,14940,16210,31150,
Musée des Beaux-Arts et d'Archéologie,2001,CHAMPAGNE-ARDENNES,CHAUMONT,881,6664,7545,
Musée Municipal,2001,CHAMPAGNE-ARDENNES,SAINT-DIZIER,0,2780,2780,
Musée de la Maison Bonaparte,2001,CORSE,AJACCIO,50266,15840,66106,
Musée d'archéologie d'Aleria - Jérôme Carcopino,2001,CORSE,ALERIA,30675,18184,48859,
Musée Comtois,2001,FRANCHE-COMTE,BESANCON,65213,0,65213,
Musée de Plein Air des Maisons Comtoises,2001,FRANCHE-COMTE,NANCRAY,35246,7551,42797,
Musée Sarret de Grozon,2001,FRANCHE-COMTE,ARBOIS,0,295,295,
Musée Municipal d'Archéologie,2001,FRANCHE-COMTE,CHAMPAGNOLE,650,468,1118,
Musée Municipal Saint-John Perse,2001,GUADELOUPE,POINTE-A-PITRE,9112,684,9796,
Musée des Cultures Guyanaises,2001,GUYANE,CAYENNE,0,5520,5520,
Musée National des Châteaux de Malmaison et de Bois-Préau,2001,ILE-DE-FRANCE,RUEIL-MALMAISON,39307,22000,61307,
Musée National de la Marine,2001,ILE-DE-FRANCE,PARIS,338577,0,338577,
Musée National Jean-Jacques Henner,2001,ILE-DE-FRANCE,PARIS,2013,2424,4437,
"Petit Palais, Musée des Beaux-Arts de la ville de Paris",2001,ILE-DE-FRANCE,PARIS,60093,39584,99677,
Musée de la Vie Romantique,2001,ILE-DE-FRANCE,PARIS,28403,17706,46109,
Musée des Arts Asiatiques Guimet,2001,ILE-DE-FRANCE,PARIS,319747,117807,437554,
Musée des Arts d'Afrique et d'Océanie,2001,ILE-DE-FRANCE,PARIS,110207,164333,274540,
Musée National des Techniques,2001,ILE-DE-FRANCE,PARIS,149442,0,149442,
Musée des Pays de Seine-et-Marne,2001,ILE-DE-FRANCE,SAINT-CYR-SUR-MORIN,2151,4231,6382,
Musée départemental Stéphane Mallarmé,2001,ILE-DE-FRANCE,VULAINES-SUR-SEINE,3648,694,4342,
Musée d'Art et d'Histoire,2001,ILE-DE-FRANCE,SAINT-DENIS,23299,0,23299,
Musée Archéologique du Val d'Oise,2001,ILE-DE-FRANCE,GUIRY-EN-VEXIN,20912,0,20912,
Musée d'Art et d'Histoire Louis Senlecq,2001,ILE-DE-FRANCE,L'ISLE-ADAM,2609,11793,14402,
Musée Départemental Maurice Denis,2001,ILE-DE-FRANCE,SAINT-GERMAIN-EN-LAYE,20155,1474,21629,
Musée Lambinet,2001,ILE-DE-FRANCE,VERSAILLES,5670,6132,11802,
Musée-Bibliothèque Pierre-André Benoît,2001,LANGUEDOC-ROUSSILLON,ALES,0,12772,12772,
Musée Municipal de la Vignasse,2001,LANGUEDOC-ROUSSILLON,BEAUCAIRE,896,2699,3595,
Musée Archéologique,2001,LANGUEDOC-ROUSSILLON,NIMES,10720,15470,26190,
Musée des Beaux-Arts,2001,LANGUEDOC-ROUSSILLON,NIMES,1978,1908,3886,
Musée de la Préhistoire des Matelles,2001,LANGUEDOC-ROUSSILLON,LES MATELLES,772,1182,1954,
Musée de la Bière et du Pays de Stenay,2001,LORRAINE,STENAY,14678,0,14678,
Musée des Mines de fer de Lorraine,2001,LORRAINE,NEUFCHEF,25176,840,26016,
Musée de la Mine - Carreau Wendel,2001,LORRAINE,PETITE-ROSSELLE,2703,1053,3756,
Musée de La Faïence et des Techniques Faïencières,2001,LORRAINE,SARREGUEMINES,12508,15710,28218,
La Tour aux Puces - Musée du Pays Thionvillois,2001,LORRAINE,THIONVILLE,497,757,1254,
Musée Départemental d'Archéologie Précolombienne et de Préhistoire de la Martinique,2001,MARTINIQUE,FORT-DE-FRANCE,10900,0,10900,
Musée du Textile et du Peigne en Corne,2001,MIDI-PYRENEES,LAVELANET,4732,328,5060,
Musée Municipal de Millau,2001,MIDI-PYRENEES,MILLAU,18508,3684,22192,
Musée des Beaux-Arts et des Arts Décoratifs,2001,MIDI-PYRENEES,MIRANDE,937,435,1372,
Musée Salies,2001,MIDI-PYRENEES,BAGNERES-DE-BIGORRE,2449,382,2831,
Musée Pyrénéen,2001,MIDI-PYRENEES,LOURDES,84895,0,84895,
Musée Gallo-Romain d'Uxellodunum,2001,MIDI-PYRENEES,MARTEL,250,40,290,
Musée d'Art Sacré,2001,MIDI-PYRENEES,ROCAMADOUR,7811,0,7811,
Musée de l'Automate,2001,MIDI-PYRENEES,SOUILLAC,29465,3112,32577,
Musée Eugénie et Maurice Guérin,2001,MIDI-PYRENEES,ANDILLAC,2281,2865,5146,
Musée Raymond Lafage,2001,MIDI-PYRENEES,LISLE-SUR-TARN,0,2138,2138,
"Forum Antique de Bavay, Musée Archéologique du Département du Nord",2001,NORD-PAS-DE-CALAIS,BAVAY,7837,3687,11524,
Musée Municipal d'Histoire Locale,2001,NORD-PAS-DE-CALAIS,MARCHIENNES,515,640,1155,
Musée des Beaux-Arts,2001,NORD-PAS-DE-CALAIS,ROUBAIX,99278,0,99278,
Musée du Verre,2001,NORD-PAS-DE-CALAIS,SARS-POTERIES,10451,0,10451,
Musée Municipal Bruno Danvin,2001,NORD-PAS-DE-CALAIS,SAINT-POL-SUR-TERNOISE,0,2338,2338,
Musée Jean-Charles Cazin,2001,NORD-PAS-DE-CALAIS,SAMER,0,600,600,
Musée du Débarquement,2001,BASSE-NORMANDIE,ARROMANCHES,324664,0,324664,
Musée d'Art et d'Histoire de Lisieux,2001,BASSE-NORMANDIE,LISIEUX,510,3752,4262,
Musée de Trouville - Villa Montebello,2001,BASSE-NORMANDIE,TROUVILLE-SUR-MER,2559,15792,18351,
Musée Régional du Cidre et du Calvados,2001,BASSE-NORMANDIE,VALOGNES,9083,0,9083,
Musée Départemental d'Art Sacré,2001,BASSE-NORMANDIE,SEES,886,0,886,
Château-Musée de Dieppe,2001,HAUTE-NORMANDIE,DIEPPE,42822,0,42822,
Musée des Terres-Neuvas et de la Pêche,2001,HAUTE-NORMANDIE,FECAMP,17045,22778,39823,
Musée de l'Hôtel Dubocage de Bléville,2001,HAUTE-NORMANDIE,LE HAVRE,3676,1911,5587,
Muséum d'Histoire Naturelle,2001,HAUTE-NORMANDIE,LE HAVRE,0,18642,18642,
Musée des Traditions et Arts Normands,2001,HAUTE-NORMANDIE,MARTAINVILLE-EPREVILLE,9462,8369,17831,
Musée Mathon-Durand,2001,HAUTE-NORMANDIE,NEUFCHATEL-EN-BRAY,751,2147,2898,
Musée Le Secq des Tournelles,2001,HAUTE-NORMANDIE,ROUEN,12606,0,12606,
Musée du Pays de Retz,2001,PAYS DE LA LOIRE,BOURGNEUF-EN-RETZ,5215,728,5943,
Musée du Vignoble Nantais,2001,PAYS DE LA LOIRE,LE PALLET,4015,613,4628,
Ecomusée de Saint-Nazaire,2001,PAYS DE LA LOIRE,SAINT-NAZAIRE,0,136229,136229,
Muséum d'Histoire Naturelle,2001,PAYS DE LA LOIRE,ANGERS,3590,7820,11410,
Galerie David d'Angers,2001,PAYS DE LA LOIRE,ANGERS,7568,9587,17155,
Musée Joseph Denais,2001,PAYS DE LA LOIRE,BEAUFORT-EN-VALLEE,1299,2130,3429,
Musée d'Art et d'Archéologie Hôtel Fouquet,2001,PAYS DE LA LOIRE,CHATEAU-GONTIER,194,443,637,
Musée de Tessé,2001,PAYS DE LA LOIRE,LE MANS,14393,9789,24182,
Musée ornithologique Charles-Payraudeau,2001,PAYS DE LA LOIRE,LA-CHAIZE-LE-VICOMTE,0,441,441,
Musée du Château,2001,PAYS DE LA LOIRE,NOIRMOUTIER-EN-L'ILE,44241,465,44706,
Musée - Centre de Documentation Alfred Desmasures,2001,PICARDIE,HIRSON,0,1075,1075,
Musée des Beaux-Arts Antoine Lecuyer,2001,PICARDIE,SAINT-QUENTIN,3943,8983,12926,
Musée Municipal de Soissons,2001,PICARDIE,SOISSONS,510,13749,14259,
Musée Alexandre Dumas,2001,PICARDIE,VILLERS COTTERETS,1969,0,1969,
Musée Antoine Vivenel,2001,PICARDIE,COMPIEGNE,2139,4776,6915,
Musée Boucher-de-Perthes,2001,PICARDIE,ABBEVILLE,0,18158,18158,
Musée de Picardie,2001,PICARDIE,AMIENS,23206,29609,52815,
Musée Protestant,2001,POITOU-CHARENTES,LA ROCHELLE,1295,331,1626,
Musée Archéologique,2001,POITOU-CHARENTES,SAINTES,2024,24847,26871,
Musée des Tumulus de Bougon,2001,POITOU-CHARENTES,BOUGON,35907,0,35907,
Musée Municipal de l'Hôtel de Sully,2001,POITOU-CHARENTES,CHATELLERAULT,1826,1353,3179,
"Musée de la Moto, de l'Automobile et du Vélo",2001,POITOU-CHARENTES,CHATELLERAULT,11967,16201,28168,
Musée Municipal de Civray,2001,POITOU-CHARENTES,CIVRAY,0,412,412,
Musée Sainte-Croix,2001,POITOU-CHARENTES,POITIERS,4180,12820,17000,
Musée du baptistère Saint-Jean,2001,POITOU-CHARENTES,POITIERS,22847,0,22847,
Musée-Château de Cagnes,2001,PROVENCE-ALPES-CÔTE D'AZUR,CAGNES-SUR-MER,22494,1067,23561,
Musée Renoir,2001,PROVENCE-ALPES-CÔTE D'AZUR,CAGNES-SUR-MER,38723,0,38723,
Musée des Beaux-Arts,2001,PROVENCE-ALPES-CÔTE D'AZUR,MENTON,0,14751,14751,
Musée Jean Cocteau Collection Séverin Wunderman,2001,PROVENCE-ALPES-CÔTE D'AZUR,MENTON,16211,0,16211,
Musée Départemental des Arts Asiatiques,2001,PROVENCE-ALPES-CÔTE D'AZUR,NICE,20585,18497,39082,
Musée du Vieux-Logis de Nice,2001,PROVENCE-ALPES-CÔTE D'AZUR,NICE,0,1216,1216,
Musée des Beaux-Arts Jules Chéret,2001,PROVENCE-ALPES-CÔTE D'AZUR,NICE,20404,11286,31690,
Musée Départemental des Merveilles,2001,PROVENCE-ALPES-CÔTE D'AZUR,TENDE,22088,0,22088,
Musée du Pavillon de Vendôme,2001,PROVENCE-ALPES-CÔTE D'AZUR,AIX-EN-PROVENCE,6797,2991,9788,
Musée- Atelier de Paul Cézanne,2001,PROVENCE-ALPES-CÔTE D'AZUR,AIX-EN-PROVENCE,80775,0,80775,
Musée des Docks Romains,2001,PROVENCE-ALPES-CÔTE D'AZUR,MARSEILLE,6483,0,6483,
Musée Municipal Paul Lafran,2001,PROVENCE-ALPES-CÔTE D'AZUR,SAINT-CHAMAS,0,2150,2150,
Musée Départemental du Cartonnage et de l'Imprimerie,2001,PROVENCE-ALPES-CÔTE D'AZUR,VALREAS,1413,962,2375,
Musée Archéologique,2001,RHONE-ALPES,IZERNORE,0,204,204,
Musée Départemental du Revermont,2001,RHONE-ALPES,VAL-REVERMONT,22234,0,22234,
Musée du Château des Adhémars,2001,RHONE-ALPES,MONTELIMAR,13521,0,13521,
Musée-château d'Annecy,2001,RHONE-ALPES,ANNECY,77568,73568,151136,
Musée Stendhal,2001,RHONE-ALPES,GRENOBLE,0,6896,6896,
Maison du Patrimoine de Hières-sur-Amby,2001,RHONE-ALPES,HIERES SUR AMBY,2846,0,2846,
Musée Folklorique du Vieux Saint-Etienne,2001,RHONE-ALPES,SAINT-ETIENNE,887,0,887,
Musée d'Art Moderne et Contemporain,2001,RHONE-ALPES,SAINT-ETIENNE,37968,20161,58129,
Musée Henri Malartre,2001,RHONE-ALPES,ROCHETAILLEE-SUR-SAONE,28623,26203,54826,
Musée Archéologique,2001,RHONE-ALPES,SAINT-ROMAIN-EN-GAL,35640,31014,66654,
Musée du docteur Faure,2001,RHONE-ALPES,AIX-LES-BAINS,9667,3606,13273,
Musée de la Chartreuse,2002,ALSACE,MOLSHEIM,3146,0,3146,
Musée du Fer,2002,ALSACE,REICHSHOFFEN,909,636,1545,
Musée d'Histoire Naturelle et d'Ethnographie de Colmar,2002,ALSACE,COLMAR,2985,4169,7154,
Musée du Florival,2002,ALSACE,GUEBWILLER,2471,1734,4205,
Musée du Vignoble et des Vins d'Alsace,2002,ALSACE,KIENTZHEIM,6661,0,6661,
Musée du Dolder,2002,ALSACE,RIQUEWIHR,6465,780,7245,
Musée National de la Préhistoire,2002,AQUITAINE,LES EYZIES-DE-TAYAC,46286,32661,78947,
Musée Militaire - Souvenir du Périgord,2002,AQUITAINE,PERIGUEUX,1973,0,1973,
Musée du Périgord,2002,AQUITAINE,PERIGUEUX,8337,19088,27425,
Musée des Beaux-Arts et d'Archéologie,2002,AQUITAINE,LIBOURNE,1408,6131,7539,
Musée de Borda,2002,AQUITAINE,DAX,6727,4025,10752,
Atelier-Musée  (Ecomusée de la Grande Landes),2002,AQUITAINE,LUXEY,8324,0,8324,
Musée Municipal du Lac,2002,AQUITAINE,SANGUINET,2864,88,2952,
Musée de Préhistoire Mésolithique Laurent Coulonges,2002,AQUITAINE,SAUVETERRE-LA-LEMANCE,631,315,946,
Musée Charles-Louis Philippe,2002,AUVERGNE,CERILLY,165,0,165,
Musée des Arts D'Afrique et D'Asie,2002,AUVERGNE,VICHY,2680,989,3669,
Ecomusée de Margeride-Haute-Auvergne,2002,AUVERGNE,RUYNES-EN-MARGERIDE,19132,0,19132,
Musée de la Haute Auvergne,2002,AUVERGNE,SAINT-FLOUR,7597,2782,10379,
"Musée de la Vie Bourguignonne, Perrin de Puycousin",2002,BOURGOGNE,DIJON,5709,22855,28564,
Musée des Arts et Traditions des Hautes-Côtes,2002,BOURGOGNE,GEVREY-CHAMBERTIN - Reulle Vergy,4300,0,4300,
Musée Buffon,2002,BOURGOGNE,MONTBARD,2529,849,3378,
Musée Municipal François Pompon,2002,BOURGOGNE,SAULIEU,3231,1095,4326,
Musée de la Loire,2002,BOURGOGNE,COSNE-SUR-LOIRE,892,3224,4116,
Musée de la Faïence et des Beaux-Arts,2002,BOURGOGNE,NEVERS,4684,3527,8211,
Musée Archéologique du Nivernais (Porte du Croux),2002,BOURGOGNE,NEVERS,70,819,889,
Musée du Grès de Puisaye,2002,BOURGOGNE,SAINT-AMAND-EN-PUISAYE,2445,660,3105,
Musée Nicéphore Niepce,2002,BOURGOGNE,CHALON-SUR-SAONE,6783,10082,16865,
"L'Atelier d'un Journal"" de Louhans - Musée Municipal",2002,BOURGOGNE,LOUHANS,2602,338,2940,
Musée de la Tour du Moulin,2002,BOURGOGNE,MARCIGNY,1728,456,2184,
Musée des Arts Naïfs et Populaires de Noyers sur Serein,2002,BOURGOGNE,NOYERS-SUR-SEREIN,2204,888,3092,
Musée Colette,2002,BOURGOGNE,SAINT-SAUVEUR-EN-PUISAYE,9194,2484,11678,
Musée du Château de Dinan,2002,BRETAGNE,DINAN,19919,12574,32493,
Musée d'Art et d'Histoire,2002,BRETAGNE,SAINT-BRIEUC,0,193504,193504,
Musée de Morlaix,2002,BRETAGNE,MORLAIX,10810,13556,24366,
Musée Bigouden,2002,BRETAGNE,PONT-L'ABBE,23667,0,23667,
Musée des Beaux-Arts,2002,BRETAGNE,QUIMPER,21803,17322,39125,
Ecomusée du Pays de Montfort,2002,BRETAGNE,MONTFORT-SUR-MEU,3924,1450,5374,
Musée du Château de Suscinio,2002,BRETAGNE,SARZEAU,66464,17464,83928,
Musée Municipal,2002,CENTRE,VIERZON,0,1200,1200,
Musée d'Art et d'Histoire de Dreux,2002,CENTRE,DREUX,5236,0,5236,
Musées de Châteauroux - Hôtel Bertrand,2002,CENTRE,CHATEAUROUX,0,10842,10842,
Musée des Beaux-Arts,2002,CENTRE,TOURS,21559,26816,48375,
Musée de la Corbillière,2002,CENTRE,MER,973,0,973,
Musée de Sologne,2002,CENTRE,ROMORANTIN-LANTHENAY,5769,5472,11241,
Musée d'Art et d'Archéologie,2002,CENTRE,CHATILLON-COLIGNY,1842,0,1842,
Musée du Gatinais,2002,CENTRE,MONTARGIS,223,322,545,
Musée Girodet,2002,CENTRE,MONTARGIS,906,1374,2280,
Musée des Beaux-Arts,2002,CENTRE,ORLEANS,13105,39961,53066,
Musée de l'Ardenne,2002,CHAMPAGNE-ARDENNES,CHARLEVILLE-MEZIERES,27700,0,27700,
Musée des Beaux-Arts (Musée Pic Saint-Loup),2002,CHAMPAGNE-ARDENNES,TROYES,5132,9581,14713,
Musée des Beaux-Arts et d'Archéologie,2002,CHAMPAGNE-ARDENNES,CHAUMONT,1631,4409,6040,
Musée de la Coutellerie,2002,CHAMPAGNE-ARDENNES,NOGENT,5750,1274,7024,
Musée de l'Argonne Viard-Morel,2002,CHAMPAGNE-ARDENNES,SAINTE-MENEHOULD,0,950,950,
Musée Comtois,2002,FRANCHE-COMTE,BESANCON,73068,0,73068,
Musée du Temps,2002,FRANCHE-COMTE,BESANCON,28031,0,28031,
Musée Beurnier-Rossel,2002,FRANCHE-COMTE,MONTBELIARD,3352,743,4095,
Musée de Pontarlier,2002,FRANCHE-COMTE,PONTARLIER,5235,4910,10145,
Musée Baron Martin,2002,FRANCHE-COMTE,GRAY,3626,4941,8567,
Musée Municipal d'Archéologie,2002,FRANCHE-COMTE,CHAMPAGNOLE,385,932,1317,
Viséum-Musée de la Lunette,2002,FRANCHE-COMTE,MOREZ HAUTS DE BIENNE,1298,0,1298,
Musée Municipal Saint-John Perse,2002,GUADELOUPE,POINTE-A-PITRE,5513,0,5513,
Musée-Jardin Paul Landowski,2002,ILE-DE-FRANCE,BOULOGNE-BILLANCOURT,1648,0,1648,
Musée Municipal d'Art et d'Histoire,2002,ILE-DE-FRANCE,COLOMBES,0,4402,4402,
Musée de l'Île-de-France,2002,ILE-DE-FRANCE,SCEAUX,8080,21741,29821,
Musée de la Musique,2002,ILE-DE-FRANCE,PARIS,126299,17512,143811,
Musée des Arts Asiatiques Guimet,2002,ILE-DE-FRANCE,PARIS,229970,109770,339740,
Mémorial du Maréchal Leclerc et de la Libération de Paris - Musée Jean Moulin,2002,ILE-DE-FRANCE,PARIS,4715,10913,15628,
Musée des Arts Décoratifs (Union Centrale des Arts Décoratifs),2002,ILE-DE-FRANCE,PARIS,49187,35279,84466,
Musée d'Art Moderne de la ville de Paris,2002,ILE-DE-FRANCE,PARIS,148431,228139,376570,
Musée d'Art et d'Histoire du Judaïsme,2002,ILE-DE-FRANCE,PARIS,61069,21202,82271,
Musée National des Techniques,2002,ILE-DE-FRANCE,PARIS,163150,0,163150,
Musée Départemental de l'Ecole de Barbizon,2002,ILE-DE-FRANCE,BARBIZON,20735,0,20735,
Musée Municipal des Capucins,2002,ILE-DE-FRANCE,COULOMMIERS,1433,1277,2710,
Musée Gatien Bonnet,2002,ILE-DE-FRANCE,LAGNY-SUR-MARNE,0,2040,2040,
Musée Henri Chapu,2002,ILE-DE-FRANCE,LE MEE-SUR-SEINE,0,1370,1370,
Musée Départemental de Préhistoire d'Île de France,2002,ILE-DE-FRANCE,NEMOURS,4193,22288,26481,
Musée des Pays de Seine-et-Marne,2002,ILE-DE-FRANCE,SAINT-CYR-SUR-MORIN,2417,5079,7496,
Musée de Nogent-Sur-Marne,2002,ILE-DE-FRANCE,NOGENT-SUR-MARNE,0,4764,4764,
Musée Emile Jean,2002,ILE-DE-FRANCE,VILLIERS-SUR-MARNE,0,300,300,
Musée de la Toile de Jouy,2002,ILE-DE-FRANCE,JOUY-EN-JOSAS,11175,0,11175,
Musée Rambolitrain,2002,ILE-DE-FRANCE,RAMBOUILLET,17885,0,17885,
Muséum Agricole et Industriel Stella Matutina,2002,LA REUNION,PITON-SAINT-LEU,56729,840,57569,
Musée d'Art et d'Histoire - Ensemble monumental de Narbonne,2002,LANGUEDOC-ROUSSILLON,NARBONNE,282520,0,282520,
Musée Départemental d'Art Sacré du Gard,2002,LANGUEDOC-ROUSSILLON,PONT-SAINT-ESPRIT,1848,6326,8174,
Musée de la Maison Romane,2002,LANGUEDOC-ROUSSILLON,SAINT-GILLES-DU-GARD,0,9867,9867,
Musée Pierre de Luxembourg,2002,LANGUEDOC-ROUSSILLON,VILLENEUVE-LES-AVIGNON,5560,1779,7339,
Musée de l'Etang de Thau,2002,LANGUEDOC-ROUSSILLON,BOUZIGUES,21559,447,22006,
Musée de la Cloche et de la Sonnaille,2002,LANGUEDOC-ROUSSILLON,HEREPIAN,7912,1352,9264,
Musée de Vulliod Saint-Germain,2002,LANGUEDOC-ROUSSILLON,PEZENAS,2535,2982,5517,
Musée du Cloître de Tulle André Mazeyrie,2002,LIMOUSIN,TULLE,3215,33598,36813,
Musée de l'Evêché,2002,LIMOUSIN,LIMOGES,0,63583,63583,
Musée des Mines de fer de Lorraine,2002,LORRAINE,NEUFCHEF,19700,0,19700,
Musée Militaire et Erckmann-Chatrian,2002,LORRAINE,PHALSBOURG,1699,365,2064,
La Tour aux Puces - Musée du Pays Thionvillois,2002,LORRAINE,THIONVILLE,2116,4735,6851,
Musée Louis Français,2002,LORRAINE,PLOMBIERES-LES-BAINS,441,0,441,
Musée Départemental de l'Ariège,2002,MIDI-PYRENEES,FOIX,94884,0,94884,
Musée de la Préhistoire,2002,MIDI-PYRENEES,LE MAS D'AZIL,15518,0,15518,
Musée Régional de Géologie Pierre Vetter,2002,MIDI-PYRENEES,DECAZEVILLE,0,1552,1552,
Musée Fenaille,2002,MIDI-PYRENEES,RODEZ,10278,11878,22156,
Musée des Beaux-Arts Denys Puech,2002,MIDI-PYRENEES,RODEZ,1079,6630,7709,
Musée de l'Armagnac,2002,MIDI-PYRENEES,CONDOM,6614,309,6923,
Musée Campanaire,2002,MIDI-PYRENEES,L'ISLE JOURDAIN,8344,1901,10245,
Musée du Pays de Luchon,2002,MIDI-PYRENEES,BAGNERES-DE-LUCHON,2437,632,3069,
Musée Municipal,2002,MIDI-PYRENEES,MARTRES-TOLOSANE,0,583,583,
Musée Départemental de Cuzals,2002,MIDI-PYRENEES,SAULIAC-SUR-CELE,20025,0,20025,
Musée du Pays Rabastinois,2002,MIDI-PYRENEES,RABASTENS,1301,766,2067,
Musée Théodore Calbet,2002,MIDI-PYRENEES,GRISOLLES,0,2043,2043,
Musée Municipal de Cambrai,2002,NORD-PAS-DE-CALAIS,CAMBRAI,11123,15942,27065,
Musée Municipal d'Escaudain,2002,NORD-PAS-DE-CALAIS,ESCAUDAIN,0,1036,1036,
Musée du Dessin et de l'Estampe Originale,2002,NORD-PAS-DE-CALAIS,GRAVELINES,10171,0,10171,
Musée Municipal d'Hazebrouck,2002,NORD-PAS-DE-CALAIS,HAZEBROUCK,760,6617,7377,
Musée Départemental Matisse,2002,NORD-PAS-DE-CALAIS,LE CATEAU-CAMBRESIS,9099,18955,28054,
Musée des Beaux-Arts,2002,NORD-PAS-DE-CALAIS,ARRAS,23842,18484,42326,
Musée des Beaux-Arts et de la Dentelle,2002,NORD-PAS-DE-CALAIS,CALAIS,5215,15929,21144,
Musée des Beaux-Arts,2002,BASSE-NORMANDIE,CAEN,80669,0,80669,
Musée d'Initiation à la Nature,2002,BASSE-NORMANDIE,CAEN,0,9000,9000,
Château de Saint-Germain de Livet,2002,BASSE-NORMANDIE,SAINT-GERMAIN DE LIVET,12113,10187,22300,
Musée Municipal,2002,HAUTE-NORMANDIE,BERNAY,6241,0,6241,
Musée de l'Ancien Evêché,2002,HAUTE-NORMANDIE,EVREUX,0,19153,19153,
Musée municipal de Vernon,2002,HAUTE-NORMANDIE,VERNON,1744,5503,7247,
Musée d'Elbeuf,2002,HAUTE-NORMANDIE,ELBEUF,0,6213,6213,
Musée des Terres-Neuvas et de la Pêche,2002,HAUTE-NORMANDIE,FECAMP,17913,24707,42620,
Ecomusée de la Basse-Seine,2002,HAUTE-NORMANDIE,NOTRE-DAME-DE-BLIQUETUIT,29953,0,29953,
Musée des Antiquités de la Seine-Maritime,2002,HAUTE-NORMANDIE,ROUEN,3037,23303,26340,
Musée-Maison Natale Pierre Corneille,2002,HAUTE-NORMANDIE,ROUEN,769,2058,2827,
Musée de la Céramique,2002,HAUTE-NORMANDIE,ROUEN,8100,9012,17112,
Musée des Beaux-Arts de Nantes,2002,PAYS DE LA LOIRE,NANTES,32891,81281,114172,
Château-Musée,2002,PAYS DE LA LOIRE,SAUMUR,74050,15774,89824,
Musée de l'Ardoise,2002,PAYS DE LA LOIRE,TRELAZE,8900,0,8900,
Musée Vert Véron-de-Forbonnais,2002,PAYS DE LA LOIRE,LE MANS,6221,5354,11575,
Musée Vendéen,2002,PAYS DE LA LOIRE,FONTENAY-LE-COMTE,2091,3348,5439,
Musée ornithologique Charles-Payraudeau,2002,PAYS DE LA LOIRE,LA-CHAIZE-LE-VICOMTE,0,592,592,
Musée du Château,2002,PAYS DE LA LOIRE,NOIRMOUTIER-EN-L'ILE,44668,805,45473,
Musée Milcendeau Jean-Yole,2002,PAYS DE LA LOIRE,SOULLANS,1901,2308,4209,
Musée Archéologique de la région de Breteuil,2002,PICARDIE,VENDEUIL-CAPLY,7104,0,7104,
Musée Départemental de l'Abbaye de Saint-Riquier,2002,PICARDIE,ABBEVILLE,0,29086,29086,
Atelier - Musée du Papier,2002,POITOU-CHARENTES,ANGOULEME,0,8362,8362,
Musée Municipal de Cognac,2002,POITOU-CHARENTES,COGNAC,3149,7950,11099,
Musée du Présidial,2002,POITOU-CHARENTES,SAINTES,1195,2739,3934,
Musée ethnographique et archéologique du Donjon,2002,POITOU-CHARENTES,NIORT,3621,17066,20687,
Musée Henri Barré,2002,POITOU-CHARENTES,THOUARS,279,760,1039,
"Musée de la Moto, de l'Automobile et du Vélo",2002,POITOU-CHARENTES,CHATELLERAULT,9336,12681,22017,
Musée Municipal de Civray,2002,POITOU-CHARENTES,CIVRAY,0,300,300,
Musée du baptistère Saint-Jean,2002,POITOU-CHARENTES,POITIERS,19423,0,19423,
Musée de Salagon,2002,PROVENCE-ALPES-CÔTE D'AZUR,MANE,27371,6613,33984,
Musée Archéologique,2002,PROVENCE-ALPES-CÔTE D'AZUR,RIEZ-LA-ROMAINE,0,608,608,
Musée du Vieux Sisteron,2002,PROVENCE-ALPES-CÔTE D'AZUR,SISTERON,0,603,603,
Musée de Préhistoire Régionale,2002,PROVENCE-ALPES-CÔTE D'AZUR,MENTON,0,11795,11795,
Musée Archéologique - Site de  Cimiez,2002,PROVENCE-ALPES-CÔTE D'AZUR,NICE,11984,20232,32216,
Musée d'Art Naïf Anatole Jakovsky,2002,PROVENCE-ALPES-CÔTE D'AZUR,NICE,4120,12394,16514,
Musée National Message Biblique Marc Chagall,2002,PROVENCE-ALPES-CÔTE D'AZUR,NICE,135880,65060,200940,
Musée Départemental des Merveilles,2002,PROVENCE-ALPES-CÔTE D'AZUR,TENDE,25429,0,25429,
Musée Picasso la guerre et la paix à Vallauris,2002,PROVENCE-ALPES-CÔTE D'AZUR,VALLAURIS,22847,8149,30996,
Musée Paul Arbaud,2002,PROVENCE-ALPES-CÔTE D'AZUR,AIX-EN-PROVENCE,1358,0,1358,
Musée Archéologique d'Istres René Beaucaire,2002,PROVENCE-ALPES-CÔTE D'AZUR,ISTRES,2566,4104,6670,
Musée Ciotaden,2002,PROVENCE-ALPES-CÔTE D'AZUR,LA CIOTAT,3423,5475,8898,
Fondation Louis Jou,2002,PROVENCE-ALPES-CÔTE D'AZUR,LES-BAUX-DE-PROVENCE,2982,0,2982,
Musée de la Faïence,2002,PROVENCE-ALPES-CÔTE D'AZUR,MARSEILLE,5138,12528,17666,
Musée d'Art Contemporain - Galeries Contemporaines,2002,PROVENCE-ALPES-CÔTE D'AZUR,MARSEILLE,5262,15152,20414,
Musée d'Archéologie Méditerranéenne,2002,PROVENCE-ALPES-CÔTE D'AZUR,MARSEILLE,29460,0,29460,
Musée Cantini,2002,PROVENCE-ALPES-CÔTE D'AZUR,MARSEILLE,28576,33692,62268,
Musée Suffren et du Vieux Saint-Cannat,2002,PROVENCE-ALPES-CÔTE D'AZUR,SAINT-CANNAT,0,8318,8318,
Musée de l'Empéri de Salon et de la Crau,2002,PROVENCE-ALPES-CÔTE D'AZUR,SALON-DE-PROVENCE,11332,5266,16598,
Musée Départemental des Hautes-Alpes,2002,PROVENCE-ALPES-CÔTE D'AZUR,GAP,3914,14593,18507,
Musée du Pays Brignolais,2002,PROVENCE-ALPES-CÔTE D'AZUR,BRIGNOLES,2274,2067,4341,
Musée d'Art et d'Archéologie,2002,PROVENCE-ALPES-CÔTE D'AZUR,TOULON,0,22743,22743,
Musée Comtadin-Duplessis,2002,PROVENCE-ALPES-CÔTE D'AZUR,CARPENTRAS,546,764,1310,
Musée Sobirats,2002,PROVENCE-ALPES-CÔTE D'AZUR,CARPENTRAS,754,382,1136,
Musée du Brou,2002,RHONE-ALPES,BOURG-EN-BRESSE,80303,0,80303,
Musée de la Société d'Histoire et d'Archéologie,2002,RHONE-ALPES,BRIORD,24,123,147,
Musée de la Bresse - Domaine des Planons,2002,RHONE-ALPES,SAINT-CYR-SUR-MENTHON,17038,0,17038,
Musée Départemental du Revermont,2002,RHONE-ALPES,VAL-REVERMONT,20481,0,20481,
Musée et Site Archéologiques,2002,RHONE-ALPES,SOYONS,11410,5590,17000,
Musée du Rhône,2002,RHONE-ALPES,TOURNON-SUR-RHÔNE,7822,3084,10906,
Château de Grignan,2002,RHONE-ALPES,GRIGNAN,90623,19492,110115,
Musée du site Préhistorique,2002,RHONE-ALPES,VASSIEUX-EN-VERCORS,18708,1376,20084,
Musée-château d'Annecy,2002,RHONE-ALPES,ANNECY,59313,55431,114744,
Musée d'Huez et de l'Oisans,2002,RHONE-ALPES,ALPE D'HUEZ,3809,405,4214,
Musée Gallo-Romain,2002,RHONE-ALPES,AOSTE,3215,1768,4983,
Musée - Parc Archéologique du Lac de Paladru,2002,RHONE-ALPES,CHARAVINES,9853,0,9853,
Musée Archéologique Grenoble Saint-Laurent,2002,RHONE-ALPES,GRENOBLE,4648,11863,16511,
Musée Matheysin,2002,RHONE-ALPES,LA MURE,2773,1766,4539,
Musée-Cloître Saint-André-Le-Bas,2002,RHONE-ALPES,VIENNE,4064,6363,10427,
Musée Lapidaire Saint-Pierre,2002,RHONE-ALPES,VIENNE,2193,4362,6555,
Musée de la Soierie,2002,RHONE-ALPES,CHARLIEU,8975,2407,11382,
Musée de la Diana,2002,RHONE-ALPES,MONTBRISON,13000,0,13000,
Musée d'Art et d'Industrie,2002,RHONE-ALPES,SAINT-ETIENNE,62332,0,62332,
Château de la Bastie d'Urfé,2002,RHONE-ALPES,SAINT-ETIENNE-LE-MOLARD,15456,0,15456,
Musée des Civilisations : Daniel Pouget,2002,RHONE-ALPES,SAINT-JUST-SAINT-RAMBERT,15906,0,15906,
Musée Rural,2002,RHONE-ALPES,USSON-EN-FOREZ,6198,1171,7369,
Musée Historique des Tissus,2002,RHONE-ALPES,LYON,69511,24332,93843,
Musée des Beaux-Arts,2002,RHONE-ALPES,CHAMBERY,11665,20495,32160,
Muséum d'histoire naturelle,2002,RHONE-ALPES,CHAMBERY,1040,2404,3444,
Musée de l'Académie de La Val d'Isère,2002,RHONE-ALPES,MOÛTIERS,223,1855,2078,
Musée Alsacien,2003,ALSACE,HAGUENAU,3056,0,3056,
Musée d'Art Moderne et Contemporain de Strasbourg,2003,ALSACE,STRASBOURG,48051,94926,142977,
Musée Alsacien,2003,ALSACE,STRASBOURG,26307,25357,51664,
Musée des Beaux-Arts,2003,ALSACE,STRASBOURG,52006,0,52006,
Musée J.F. Oberlin,2003,ALSACE,WALDERSBACH,5715,12163,17878,
Musée Gallo-Romain,2003,ALSACE,BIESHEIM,915,2602,3517,
Musée Fernand Desmoulin,2003,AQUITAINE,BRANTOME,11020,1489,12509,
Musée des Arts et Traditions Populaires du Périgord,2003,AQUITAINE,MUSSIDAN,970,646,1616,
Musée des Arts Décoratifs,2003,AQUITAINE,BORDEAUX,22052,5721,27773,
CAPC Musée d'Art Contemporain de Bordeaux,2003,AQUITAINE,BORDEAUX,11698,70683,82381,
Musée des Beaux-Arts,2003,AQUITAINE,BORDEAUX,56510,37369,93879,
Musée Municipal,2003,AQUITAINE,ARUDY,1053,296,1349,
Musée Edmond Rostand,2003,AQUITAINE,CAMBO-LES-BAINS,60069,1697,61766,
Musée Charles-Louis Philippe,2003,AUVERGNE,CERILLY,76,4,80,
Musée Rieckotter,2003,AUVERGNE,NERIS-LES-BAINS,490,784,1274,
Musée d'Archéologie Bargoin,2003,AUVERGNE,CLERMONT-FERRAND,1439,6163,7602,
Musée Municipal de la Coutellerie,2003,AUVERGNE,THIERS,36673,5059,41732,
Musée Municipal Marcel Sahut,2003,AUVERGNE,VOLVIC,690,2610,3300,
Musée du Vin de Bourgogne,2003,BOURGOGNE,BEAUNE,29005,4507,33512,
Musée Municipal François Pompon,2003,BOURGOGNE,SAULIEU,2836,942,3778,
Musée du Septennat,2003,BOURGOGNE,CHATEAU-CHINON,20573,2526,23099,
Musée de la Mine,2003,BOURGOGNE,BLANZY,11645,2643,14288,
Musée Saint-Nazaire,2003,BOURGOGNE,BOURBON-LANCY,0,973,973,
Musée du Prieuré de Charolles,2003,BOURGOGNE,CHAROLLES,2352,1055,3407,
Musée d'Art et d'Histoire,2003,BOURGOGNE,AUXERRE,12024,20121,32145,
Musée des Arts Naïfs et Populaires de Noyers sur Serein,2003,BOURGOGNE,NOYERS-SUR-SEREIN,1780,991,2771,
Musée Villeneuvien,2003,BOURGOGNE,VILLENEUVE-SUR-YONNE,0,2459,2459,
Musée d'Art et d'Histoire,2003,BRETAGNE,SAINT-BRIEUC,0,33941,33941,
Musée d'Histoire de la Ville de Saint-Malo,2003,BRETAGNE,SAINT-MALO,26220,6015,32235,
Musée du Château de Suscinio,2003,BRETAGNE,SARZEAU,94811,0,94811,
Musée des Meilleurs Ouvriers de France,2003,CENTRE,BOURGES,0,18124,18124,
Musée de l'Histoire du Perche,2003,CENTRE,NOGENT-LE-ROTROU,8330,5492,13822,
Musée de l'Hospice Saint-Roch,2003,CENTRE,ISSOUDUN,0,14917,14917,
Musée George Sand et de la Vallée Noire,2003,CENTRE,LA CHATRE,3924,1957,5881,
Musée Ornithologique (Ecomusée de la Brenne),2003,CENTRE,LE BLANC,4251,2630,6881,
Musée de Préhistoire du Grand Pressigny,2003,CENTRE,LE GRAND PRESSIGNY,10300,4700,15000,
Musée Lansyer,2003,CENTRE,LOCHES,3346,765,4111,
Musée Balzac,2003,CENTRE,SACHE,22032,3171,25203,
Musée des Beaux-Arts,2003,CENTRE,TOURS,20379,26314,46693,
Musée Archéologique,2003,CENTRE,THESEE,1811,0,1811,
Musée de la Marine de Loire,2003,CENTRE,CHATEAUNEUF-SUR-LOIRE,8820,3296,12116,
Musée Girodet,2003,CENTRE,MONTARGIS,826,1639,2465,
Musée de la Résistance,2003,CHAMPAGNE-ARDENNES,MUSSY-SUR-SEINE,200,270,470,
Musée des Beaux-Arts (Musée Pic Saint-Loup),2003,CHAMPAGNE-ARDENNES,TROYES,7073,10923,17996,
Ecomusée de la Montagne de Reims,2003,CHAMPAGNE-ARDENNES,POURCY,843,191,1034,
Musée Palais Fesch,2003,CORSE,AJACCIO,32781,16809,49590,
Muséum de Besançon,2003,FRANCHE-COMTE,BESANCON,248552,27617,276169,
Musée du Temps,2003,FRANCHE-COMTE,BESANCON,29206,0,29206,
Musée Beurnier-Rossel,2003,FRANCHE-COMTE,MONTBELIARD,2644,3845,6489,
Viséum-Musée de la Lunette,2003,FRANCHE-COMTE,MOREZ HAUTS DE BIENNE,9913,4696,14609,
Musée Frédéric Japy,2003,FRANCHE-COMTE,BEAUCOURT,3635,0,3635,
Musée Français de la Photographie,2003,ILE-DE-FRANCE,BIEVRES,1875,3225,5100,
Musée du Château,2003,ILE-DE-FRANCE,DOURDAN,14331,1936,16267,
Musée Municipal de Saint-Cloud,2003,ILE-DE-FRANCE,SAINT-CLOUD,0,6643,6643,
Musée National Gustave Moreau,2003,ILE-DE-FRANCE,PARIS,21697,13254,34951,
Musée des Thermes et de l'Hôtel de Cluny (arts et techniques du Moyen-Age et de la Renaissance),2003,ILE-DE-FRANCE,PARIS,118734,140030,258764,
Musée des Arts Décoratifs (Union Centrale des Arts Décoratifs),2003,ILE-DE-FRANCE,PARIS,138817,28413,167230,
Musée National des Techniques,2003,ILE-DE-FRANCE,PARIS,151323,0,151323,
Musée de la Poste,2003,ILE-DE-FRANCE,PARIS,22183,19687,41870,
Musée Départemental de l'Ecole de Barbizon,2003,ILE-DE-FRANCE,BARBIZON,25684,722,26406,
Musée d'Art et d'Histoire Militaire,2003,ILE-DE-FRANCE,FONTAINEBLEAU,2180,4454,6634,
Musée Henri Chapu,2003,ILE-DE-FRANCE,LE MEE-SUR-SEINE,0,785,785,
Musée des Pays de Seine-et-Marne,2003,ILE-DE-FRANCE,SAINT-CYR-SUR-MORIN,1891,5556,7447,
Ecomusée,2003,ILE-DE-FRANCE,SAVIGNY-LE-TEMPLE,0,6609,6609,
Musée d'Art et d'Histoire,2003,ILE-DE-FRANCE,SAINT-DENIS,5256,22177,27433,
Musée de Nogent-Sur-Marne,2003,ILE-DE-FRANCE,NOGENT-SUR-MARNE,0,8258,8258,
Musée Tavet Delacour,2003,ILE-DE-FRANCE,PONTOISE,6647,7156,13803,
Collections de la Fondation de Coubertin,2003,ILE-DE-FRANCE,SAINT-REMY-LES-CHEVREUSE,5051,1170,6221,
Musée d'Art et d'Histoire - Ensemble monumental de Narbonne,2003,LANGUEDOC-ROUSSILLON,NARBONNE,268310,0,268310,
Musée du Colombier,2003,LANGUEDOC-ROUSSILLON,ALES,0,2782,2782,
Musée Léon Alègre,2003,LANGUEDOC-ROUSSILLON,BAGNOLS-SUR-CEZE,465,554,1019,
Musée Cévenol,2003,LANGUEDOC-ROUSSILLON,LE VIGAN,3903,2154,6057,
Musée des Cultures Taurines (Annexe Musée du Vieux Nîmes),2003,LANGUEDOC-ROUSSILLON,NIMES,532,8896,9428,
Musée des Beaux-Arts,2003,LANGUEDOC-ROUSSILLON,NIMES,10642,5320,15962,
Musée des Vallées Cévenoles,2003,LANGUEDOC-ROUSSILLON,SAINT-JEAN DU GARD,12412,1643,14055,
Musée de l'Etang de Thau,2003,LANGUEDOC-ROUSSILLON,BOUZIGUES,17690,231,17921,
Musée de Vulliod Saint-Germain,2003,LANGUEDOC-ROUSSILLON,PEZENAS,2314,2719,5033,
Musée Labenche d'Art et d'Histoire,2003,LIMOUSIN,BRIVE-LA-GAILLARDE,2851,10476,13327,
Musée d'Art et d'Archéologie,2003,LIMOUSIN,GUERET,5429,5634,11063,
Musée Départemental d'Art Contemporain,2003,LIMOUSIN,ROCHECHOUART,8375,3035,11410,
Musée du Château de Montaigu,2003,LORRAINE,LANEUVEVILLE-DEVANT-NANCY,773,0,773,
Palais des ducs de Lorraine - Musée Historique Lorrain,2003,LORRAINE,NANCY,27238,41461,68699,
Musée des Beaux-Arts de Nancy,2003,LORRAINE,NANCY,54328,59079,113407,
Musée Jules Bastien-Lepage - Musée de la Fortification,2003,LORRAINE,MONTMEDY,17559,650,18209,
Musée de la Bière et du Pays de Stenay,2003,LORRAINE,STENAY,7791,3195,10986,
Musée des Mines de fer de Lorraine,2003,LORRAINE,NEUFCHEF,21159,722,21881,
Musée Louis Français,2003,LORRAINE,PLOMBIERES-LES-BAINS,104,396,500,
Musée d'Archéologie,2003,MIDI-PYRENEES,MONTSEGUR,21323,7284,28607,
Musée Joseph Vaylet,2003,MIDI-PYRENEES,ESPALION,3990,1893,5883,
Musée des Beaux-Arts Denys Puech,2003,MIDI-PYRENEES,RODEZ,1235,6776,8011,
Musée Municipal Urbain Cabrol,2003,MIDI-PYRENEES,VILLEFRANCHE-DE-ROUERGUE,0,1810,1810,
Musée Campanaire,2003,MIDI-PYRENEES,L'ISLE JOURDAIN,10298,1652,11950,
Musée des Beaux-Arts et des Arts Décoratifs,2003,MIDI-PYRENEES,MIRANDE,648,153,801,
Musée des Transports et des Communications,2003,MIDI-PYRENEES,TOULOUSE,0,500,500,
Musée des Augustins,2003,MIDI-PYRENEES,TOULOUSE,43462,72571,116033,
Musée Salies,2003,MIDI-PYRENEES,BAGNERES-DE-BIGORRE,2173,420,2593,
Musée Henri Martin,2003,MIDI-PYRENEES,CAHORS,2101,7455,9556,
Musée Goya,2003,MIDI-PYRENEES,CASTRES,19331,17895,37226,
Musée d'Art et d'Histoire Charles Portal,2003,MIDI-PYRENEES,CORDES-SUR-CIEL,390,501,891,
Muséum d'histoire naturelle Philadelphe Thomas,2003,MIDI-PYRENEES,GAILLAC,734,3557,4291,
Musée d'Histoire Naturelle Victor Brun,2003,MIDI-PYRENEES,MONTAUBAN,1612,3371,4983,
Musée d'Archéologie et d'Histoire Locale,2003,NORD-PAS-DE-CALAIS,DENAIN,0,1900,1900,
Musée Départemental Matisse,2003,NORD-PAS-DE-CALAIS,LE CATEAU-CAMBRESIS,59267,54324,113591,
Musée d'Histoire Locale de Marchiennes,2003,NORD-PAS-DE-CALAIS,MARCHIENNES,546,829,1375,
Musée des Beaux-Arts,2003,NORD-PAS-DE-CALAIS,ARRAS,36415,0,36415,
Musée Municipal,2003,NORD-PAS-DE-CALAIS,BERCK-SUR-MER,5822,2689,8511,
Musée de la Céramique,2003,NORD-PAS-DE-CALAIS,DESVRES,7928,3793,11721,
Musée des Beaux-Arts,2003,BASSE-NORMANDIE,CAEN,13001,38613,51614,
Mémorial de Caen,2003,BASSE-NORMANDIE,CAEN,377965,45035,423000,
Musée de la Meunerie - Moulin de Marcy,2003,BASSE-NORMANDIE,LE MOLAY-LITTRY,5511,2026,7537,
Musée et Sites archéologiques de Vieux-la-Romaine,2003,BASSE-NORMANDIE,VIEUX,11586,18914,30500,
Musée Municipal,2003,BASSE-NORMANDIE,VIRE NORMANDIE,523,1249,1772,
Musée de la Libération,2003,BASSE-NORMANDIE,CHERBOURG-EN-COTENTIN,5054,3815,8869,
Musée Christian Dior,2003,BASSE-NORMANDIE,GRANVILLE,6544,0,6544,
Musée Municipal - Musée du Jouet,2003,BASSE-NORMANDIE,LA FERTE-MACE,1080,0,1080,
Musée Municipal d'Archéologie,2003,BASSE-NORMANDIE,L'AIGLE,0,150,150,
Musée Municipal,2003,HAUTE-NORMANDIE,LOUVIERS,0,4681,4681,
Musée des Traditions et Arts Normands,2003,HAUTE-NORMANDIE,MARTAINVILLE-EPREVILLE,9346,10971,20317,
Musée des Sapeurs-Pompiers de France,2003,HAUTE-NORMANDIE,MONTVILLE,6903,4959,11862,
Musée-Maison Natale Pierre Corneille,2003,HAUTE-NORMANDIE,ROUEN,691,1618,2309,
Musée Le Secq des Tournelles,2003,HAUTE-NORMANDIE,ROUEN,6446,5546,11992,
Association de l'Horlogerie Aliermontaise,2003,HAUTE-NORMANDIE,SAINT-NICOLAS-D'ALIERMONT,516,155,671,
Musée Victor Hugo,2003,HAUTE-NORMANDIE,VILLEQUIER,6472,7064,13536,
Musée du Pays de Retz,2003,PAYS DE LA LOIRE,BOURGNEUF-EN-RETZ,4480,513,4993,
Musée du Pays de Guérande et de la Porte Saint Michel,2003,PAYS DE LA LOIRE,GUERANDE,20177,3208,23385,
Musée du Château des Ducs de Bretagne,2003,PAYS DE LA LOIRE,NANTES,50384,18036,68420,
Musée du Chaume/Kerhinet - Parc Naturel Régional de Brière,2003,PAYS DE LA LOIRE,SAINT-LYPHARD,5238,780,6018,
Musée d'Art et d'Histoire,2003,PAYS DE LA LOIRE,BAUGE,4883,1104,5987,
Musée du Vieux Château,2003,PAYS DE LA LOIRE,LAVAL,4054,8316,12370,
Musée des Traditions de l'Île,2003,PAYS DE LA LOIRE,LA GUERINIERE,5132,207,5339,
Musée Entomologique,2003,PICARDIE,SAINT-QUENTIN,3144,7397,10541,
Musée Antoine Vivenel,2003,PICARDIE,COMPIEGNE,1025,6532,7557,
Musée Gallé-Juillet,2003,PICARDIE,CREIL,1996,2074,4070,
Musée Archéologique de la région de Breteuil,2003,PICARDIE,VENDEUIL-CAPLY,2371,0,2371,
Musée Boucher-de-Perthes,2003,PICARDIE,ABBEVILLE,0,13542,13542,
Musée Départemental de l'Abbaye de Saint-Riquier,2003,PICARDIE,ABBEVILLE,0,19167,19167,
Musée Napoléonien et Africain,2003,POITOU-CHARENTES,ILE D'AIX,16283,28247,44530,
Musée National de la Marine,2003,POITOU-CHARENTES,ROCHEFORT,21678,9893,31571,
Musée Ernest Cognacq,2003,POITOU-CHARENTES,SAINT-MARTIN-DE-RE,7959,4322,12281,
Musée des Tumulus de Bougon,2003,POITOU-CHARENTES,BOUGON,25115,5685,30800,
Musée ethnographique et archéologique du Donjon,2003,POITOU-CHARENTES,NIORT,11731,0,11731,
Musée des Ruralies,2003,POITOU-CHARENTES,PRAHECQ,5860,1940,7800,
Musée des Traditions Populaires et d'Archéologie,2003,POITOU-CHARENTES,CHAUVIGNY,5801,3270,9071,
Musée Municipal de Civray,2003,POITOU-CHARENTES,CIVRAY,0,425,425,
Musée du Vieux Sisteron,2003,PROVENCE-ALPES-CÔTE D'AZUR,SISTERON,0,477,477,
Musée d'Histoire Locale,2003,PROVENCE-ALPES-CÔTE D'AZUR,BIOT,1002,1728,2730,
Musée-Château de Cagnes,2003,PROVENCE-ALPES-CÔTE D'AZUR,CAGNES-SUR-MER,13362,13903,27265,
Musée Renoir,2003,PROVENCE-ALPES-CÔTE D'AZUR,CAGNES-SUR-MER,22794,7745,30539,
Musée des Beaux-Arts Jules Chéret,2003,PROVENCE-ALPES-CÔTE D'AZUR,NICE,24418,24187,48605,
Musée Archéologique - Site de Terra Amata,2003,PROVENCE-ALPES-CÔTE D'AZUR,NICE,3615,11641,15256,
Musée Départemental des Merveilles,2003,PROVENCE-ALPES-CÔTE D'AZUR,TENDE,27138,0,27138,
Muséum d'Histoire Naturelle,2003,PROVENCE-ALPES-CÔTE D'AZUR,AIX-EN-PROVENCE,7976,18091,26067,
Musée Ciotaden,2003,PROVENCE-ALPES-CÔTE D'AZUR,LA CIOTAT,4440,3595,8035,
Fondation Louis Jou,2003,PROVENCE-ALPES-CÔTE D'AZUR,LES-BAUX-DE-PROVENCE,147,1519,1666,
Musée Cantini,2003,PROVENCE-ALPES-CÔTE D'AZUR,MARSEILLE,13602,20925,34527,
Musée Ziem,2003,PROVENCE-ALPES-CÔTE D'AZUR,MARTIGUES,0,6500,6500,
Musée Suffren et du Vieux Saint-Cannat,2003,PROVENCE-ALPES-CÔTE D'AZUR,SAINT-CANNAT,0,8683,8683,
Musée Baroncelli,2003,PROVENCE-ALPES-CÔTE D'AZUR,SAINTES-MARIES-DE-LA-MER,1005,0,1005,
Musée Départemental des Hautes-Alpes,2003,PROVENCE-ALPES-CÔTE D'AZUR,GAP,5471,11878,17349,
Musée des A.T.P. de Moyenne Provence,2003,PROVENCE-ALPES-CÔTE D'AZUR,DRAGUIGNAN,9181,2404,11585,
Musée Municipal Camille Pautet,2003,PROVENCE-ALPES-CÔTE D'AZUR,MAZAN,0,1287,1287,
Musée de la Société d'Histoire et d'Archéologie,2003,RHONE-ALPES,BRIORD,137,0,137,
Musée de la Résistance et de la Déportation de l'Ain,2003,RHONE-ALPES,NANTUA,7220,380,7600,
"Notre histoire, Musée de Rumilly",2003,RHONE-ALPES,RUMILLY,0,1452,1452,
Musée Dauphinois,2003,RHONE-ALPES,GRENOBLE,41123,0,41123,
Maison du Patrimoine de Hières-sur-Amby,2003,RHONE-ALPES,HIERES SUR AMBY,6358,1054,7412,
Musée Matheysin,2003,RHONE-ALPES,LA MURE,1824,2338,4162,
Musée de la Diana,2003,RHONE-ALPES,MONTBRISON,12800,900,13700,
Musée des Beaux-Arts et d'Archéologie J. Dechelette,2003,RHONE-ALPES,ROANNE,5320,11463,16783,
Musée de la Mine / Site Couriot,2003,RHONE-ALPES,SAINT-ETIENNE,29846,17866,47712,
Musée Historique des Tissus,2003,RHONE-ALPES,LYON,63663,18877,82540,
Musée des Hospices Civils de Lyon,2003,RHONE-ALPES,LYON,6370,1592,7962,
Muséum d'Histoire Naturelle,2003,RHONE-ALPES,LYON,56277,65538,121815,
Musée Henri Malartre,2003,RHONE-ALPES,ROCHETAILLEE-SUR-SAONE,41743,0,41743,
Musée Municipal d'Albertville-Conflans,2003,RHONE-ALPES,ALBERTVILLE,3458,1466,4924,
Musée Savoisien,2003,RHONE-ALPES,CHAMBERY,4390,12316,16706,
Muséum d'histoire naturelle,2003,RHONE-ALPES,CHAMBERY,674,2176,2850,
Musée Historique,2004,ALSACE,HAGUENAU,6820,0,6820,
Musée de la Chartreuse,2004,ALSACE,MOLSHEIM,3100,275,3375,
Musée des Beaux-Arts,2004,ALSACE,STRASBOURG,33680,37263,70943,
Cabinet des Estampes et des Dessins,2004,ALSACE,STRASBOURG,5922,12510,18432,
Musée Sundgauvien d'Altkirch,2004,ALSACE,ALTKIRCH,2409,7843,10252,
Musée d'Unterlinden,2004,ALSACE,COLMAR,178661,30339,209000,
Musée d'Histoire Naturelle et d'Ethnographie de Colmar,2004,ALSACE,COLMAR,3620,4547,8167,
Musée Historique et Militaire de Huningue,2004,ALSACE,HUNINGE,571,0,571,
Musée d'Histoire Local,2004,ALSACE,KAYSERSBERG,325,80,405,
Musée de l'Impression sur Etoffes,2004,ALSACE,MULHOUSE,13940,13979,27919,
Musée du Papier Peint,2004,ALSACE,RIXHEIM,6146,2148,8294,
Musée Fernand Desmoulin,2004,AQUITAINE,BRANTOME,12913,502,13415,
Musée du Périgord,2004,AQUITAINE,PERIGUEUX,25100,0,25100,
Centre National Jean Moulin,2004,AQUITAINE,BORDEAUX,0,22588,22588,
Musée de Borda,2004,AQUITAINE,DAX,2189,2881,5070,
Ecomusée de la Grande Lande,2004,AQUITAINE,SABRES,72942,8105,81047,
Musée Municipal du Lac,2004,AQUITAINE,SANGUINET,1597,220,1817,
Musée des Beaux-Arts,2004,AQUITAINE,AGEN,21650,0,21650,
Musée Municipal Albert Marzelles,2004,AQUITAINE,MARMANDE,0,8384,8384,
Musée Municipal,2004,AQUITAINE,ARUDY,1171,350,1521,
Musée Basque et de l'Histoire de Bayonne,2004,AQUITAINE,BAYONNE,20090,9924,30014,
Musée Municipal des Beaux-Arts,2004,AQUITAINE,PAU,12000,12088,24088,
Musée Bernadotte,2004,AQUITAINE,PAU,2102,2012,4114,
Musée Anne de Beaujeu,2004,AUVERGNE,MOULINS,8723,0,8723,
Musée de la Haute Auvergne,2004,AUVERGNE,SAINT-FLOUR,3833,1733,5566,
Musée Paléontologique,2004,AUVERGNE,MENAT,1054,0,1054,
Musée Alésia,2004,BOURGOGNE,ALISE-SAINTE-REINE,6116,9236,15352,
Musée Bonaparte,2004,BOURGOGNE,AUXONNE,0,3523,3523,
Musée E.J Marey,2004,BOURGOGNE,BEAUNE,4156,977,5133,
Musée du Pays Châtillonnais - Trésor de Vix,2004,BOURGOGNE,CHATILLON-SUR-SEINE,15423,3795,19218,
Musée des Beaux-Arts,2004,BOURGOGNE,DIJON,74649,136882,211531,
Musée des Arts et Traditions des Hautes-Côtes,2004,BOURGOGNE,GEVREY-CHAMBERTIN - Reulle Vergy,408,1532,1940,
Musée du Septennat,2004,BOURGOGNE,CHATEAU-CHINON,20598,2765,23363,
Musée Municipal,2004,BOURGOGNE,LA CHARITE-SUR-LOIRE,985,5335,6320,
Musée Départemental du Compagnonnage,2004,BOURGOGNE,ROMANECHE-THORINS,1999,921,2920,
Musée du Château de Dinan,2004,BRETAGNE,DINAN,25069,4886,29955,
Musée National de la Marine,2004,BRETAGNE,BREST,27677,30188,57865,
Musée de Morlaix,2004,BRETAGNE,MORLAIX,7184,15092,22276,
Ecomusée du Pays de Montfort,2004,BRETAGNE,MONTFORT-SUR-MEU,2775,1331,4106,
Musée des Beaux-Arts,2004,BRETAGNE,RENNES,34433,30065,64498,
Musée d'Histoire de la Ville de Saint-Malo,2004,BRETAGNE,SAINT-MALO,23292,6558,29850,
Musée Saint-Nicolas,2004,BRETAGNE,VITRE,2861,781,3642,
Ecomusée Industriel des Forges,2004,BRETAGNE,INZINZAC-LOCHRIST,4308,1225,5533,
Musée de la Compagnie des Indes,2004,BRETAGNE,PORT-LOUIS,45056,21083,66139,
Musée National de la Marine,2004,BRETAGNE,PORT-LOUIS,45056,21083,66139,
"La Cohue, Musée des Beaux-Arts de vannes",2004,BRETAGNE,VANNES,20000,0,20000,
Musée des Meilleurs Ouvriers de France,2004,CENTRE,BOURGES,0,22516,22516,
Musée du Château Charles VII,2004,CENTRE,MEHUN-SUR-YEVRE,9913,0,9913,
Musée Marcel Proust,2004,CENTRE,ILLIERS-COMBRAY,3795,443,4238,
Musée de l'Histoire du Perche,2004,CENTRE,NOGENT-LE-ROTROU,10377,9096,19473,
Musée Ornithologique (Ecomusée de la Brenne),2004,CENTRE,LE BLANC,3892,1388,5280,
Musée de Préhistoire du Grand Pressigny,2004,CENTRE,LE GRAND PRESSIGNY,13784,0,13784,
Musée Municipal,2004,CENTRE,SAINTE-MAURE-DE-TOURAINE,620,163,783,
Muséum d'Histoire Naturelle,2004,CENTRE,TOURS,7609,13147,20756,
Musée de la Corbillière,2004,CENTRE,MER,1116,0,1116,
Musée Archéologique,2004,CENTRE,THESEE,1783,0,1783,
Musée du Château-Fort,2004,CHAMPAGNE-ARDENNES,SEDAN,58835,0,58835,
Musée Napoléon Ier,2004,CHAMPAGNE-ARDENNES,BRIENNE-LE-CHATEAU,3449,957,4406,
Musée du Temps,2004,FRANCHE-COMTE,BESANCON,74273,0,74273,
Musée de Plein Air des Maisons Comtoises,2004,FRANCHE-COMTE,NANCRAY,50404,30756,81160,
Musée de la Tour des Echevins,2004,FRANCHE-COMTE,LUXEUIL-LES-BAINS,2646,0,2646,
Musée du Jouet,2004,FRANCHE-COMTE,MOIRANS-EN-MONTAGNE,34462,4415,38877,
Musée Territorial Alexandre Franconie,2004,GUYANE,CAYENNE,8255,0,8255,
Ecomusée Municipal d'Approuague-Kaw,2004,GUYANE,REGINA,300,0,300,
Musée Départemental Albert-Kahn,2004,ILE-DE-FRANCE,BOULOGNE-BILLANCOURT,86869,0,86869,
Musée des Années Trente,2004,ILE-DE-FRANCE,BOULOGNE-BILLANCOURT,17428,4817,22245,
Musée - Atelier Rodin,2004,ILE-DE-FRANCE,MEUDON,4136,2735,6871,
Musée National Gustave Moreau,2004,ILE-DE-FRANCE,PARIS,20761,12662,33423,
Musée Carnavalet-Histoire de Paris,2004,ILE-DE-FRANCE,PARIS,343372,51983,395355,
Musée Bourdelle,2004,ILE-DE-FRANCE,PARIS,7872,33117,40989,
Musée Zadkine,2004,ILE-DE-FRANCE,PARIS,10445,9528,19973,
"Musée Cognacq-Jay, Musée du XVIIIe siècle de la ville de Paris",2004,ILE-DE-FRANCE,PARIS,0,34938,34938,
Musée National d'Art Moderne (Centre National d'Art et de Culture Georges Pompidou),2004,ILE-DE-FRANCE,PARIS,2589825,0,2589825,
Musée du Château de Fontainebleau,2004,ILE-DE-FRANCE,FONTAINEBLEAU,219601,99395,318996,
Musée Gatien Bonnet,2004,ILE-DE-FRANCE,LAGNY-SUR-MARNE,0,1770,1770,
Musée de Nogent-Sur-Marne,2004,ILE-DE-FRANCE,NOGENT-SUR-MARNE,0,7386,7386,
Musée de la Renaissance - Château d'Ecouen,2004,ILE-DE-FRANCE,ECOUEN,17308,41922,59230,
Musée Archéologique du Val d'Oise,2004,ILE-DE-FRANCE,GUIRY-EN-VEXIN,12810,2337,15147,
Musée de la Batellerie et des Voies Navigables,2004,ILE-DE-FRANCE,CONFLANS-SAINTE-HONORINE,13536,0,13536,
Musée de la Ville,2004,ILE-DE-FRANCE,MONTIGNY LE BRETONNEUX,4884,5534,10418,
Musée Départemental Maurice Denis,2004,ILE-DE-FRANCE,SAINT-GERMAIN-EN-LAYE,24706,2249,26955,
Etablissement Public du Musée et du Domaine National de Versailles,2004,ILE-DE-FRANCE,VERSAILLES,3545565,784046,4329611,
Musée du Colombier,2004,LANGUEDOC-ROUSSILLON,ALES,0,4889,4889,
Musée des Beaux-Arts,2004,LANGUEDOC-ROUSSILLON,NIMES,15876,0,15876,
Musée Paul Raymond,2004,LANGUEDOC-ROUSSILLON,PONT-SAINT-ESPRIT,283,862,1145,
Musée de la Maison Romane,2004,LANGUEDOC-ROUSSILLON,SAINT-GILLES-DU-GARD,0,6512,6512,
Musée des Beaux-Arts de Béziers,2004,LANGUEDOC-ROUSSILLON,BEZIERS,12922,0,12922,
Musée du Vieux Montpellier,2004,LANGUEDOC-ROUSSILLON,MONTPELLIER,0,5834,5834,
Musée Languedocien,2004,LANGUEDOC-ROUSSILLON,MONTPELLIER,6024,0,6024,
Musée départemental d'Art Moderne,2004,LANGUEDOC-ROUSSILLON,CERET,65191,22812,88003,
Musée des Monnaies et Médailles Joseph Puig,2004,LANGUEDOC-ROUSSILLON,PERPIGNAN,138,1096,1234,
Musée Labenche d'Art et d'Histoire,2004,LIMOUSIN,BRIVE-LA-GAILLARDE,2706,12435,15141,
Les Sources d'Hercule,2004,LORRAINE,DENEUVRE,4304,682,4986,
Palais des ducs de Lorraine - Musée Historique Lorrain,2004,LORRAINE,NANCY,26069,44734,70803,
Musée d'Art Sacré de la Meuse,2004,LORRAINE,SAINT-MIHIEL,3137,1376,4513,
Musée d'Argonne,2004,LORRAINE,VARENNES-EN-ARGONNE,2004,0,2004,
Musée Départemental Georges de la Tour,2004,LORRAINE,VIC-SUR-SEILLE,10550,8167,18717,
Musée de l'Image,2004,LORRAINE,EPINAL,23149,10565,33714,
Musée Départemental de l'Ariège,2004,MIDI-PYRENEES,FOIX,79988,6563,86551,
Musée Municipal de Millau,2004,MIDI-PYRENEES,MILLAU,13817,11174,24991,
Musée du Charroi Rural et de l'Artisanat Traditionnel,2004,MIDI-PYRENEES,SALMIECH,0,1871,1871,
Musée Municipal Urbain Cabrol,2004,MIDI-PYRENEES,VILLEFRANCHE-DE-ROUERGUE,0,3775,3775,
Musée des Jacobins,2004,MIDI-PYRENEES,AUCH,12321,0,12321,
Musée Archéologique,2004,MIDI-PYRENEES,EAUZE,5421,993,6414,
Musée Campanaire,2004,MIDI-PYRENEES,L'ISLE JOURDAIN,10977,3047,14024,
Musée du Vieux Toulouse,2004,MIDI-PYRENEES,TOULOUSE,3569,851,4420,
Musée Paul Dupuy,2004,MIDI-PYRENEES,TOULOUSE,6242,7984,14226,
Musée Salies,2004,MIDI-PYRENEES,BAGNERES-DE-BIGORRE,1900,418,2318,
Musée du Vieux Figeac,2004,MIDI-PYRENEES,FIGEAC,625,624,1249,
Musée du protestantisme en Haut-Languedoc,2004,MIDI-PYRENEES,FERRIERES,1277,371,1648,
Musée Départemental du Textile,2004,MIDI-PYRENEES,LA-BASTIDE-ROUAIROUX,4213,3019,7232,
Musée Théodore Calbet,2004,MIDI-PYRENEES,GRISOLLES,0,2563,2563,
Musée des arts et traditions populaires,2004,MIDI-PYRENEES,MOISSAC,4215,1301,5516,
Musée Benoît de Puydt,2004,NORD-PAS-DE-CALAIS,BAILLEUL,2485,4773,7258,
Musée de l'Ostrevant,2004,NORD-PAS-DE-CALAIS,BOUCHAIN,384,1079,1463,
Musée Municipal d'Escaudain,2004,NORD-PAS-DE-CALAIS,ESCAUDAIN,0,1048,1048,
Musée des Beaux-Arts,2004,NORD-PAS-DE-CALAIS,ROUBAIX,131323,120567,251890,
Musée des Beaux-Arts et de la Dentelle,2004,NORD-PAS-DE-CALAIS,CALAIS,17167,9709,26876,
Musée de la Céramique,2004,NORD-PAS-DE-CALAIS,DESVRES,7346,5706,13052,
Musée de l'Hôtel Sandelin,2004,NORD-PAS-DE-CALAIS,SAINT-OMER,6104,5320,11424,
Mémorial de Caen,2004,BASSE-NORMANDIE,CAEN,509600,50400,560000,
Musée Municipal,2004,BASSE-NORMANDIE,ORBEC,0,3505,3505,
Château de Saint-Germain de Livet,2004,BASSE-NORMANDIE,SAINT-GERMAIN DE LIVET,13928,13981,27909,
Musée et Sites archéologiques de Vieux-la-Romaine,2004,BASSE-NORMANDIE,VIEUX,26159,0,26159,
Musée de l'Abbaye,2004,BASSE-NORMANDIE,CERISY-LA-FORET,6701,963,7664,
Musée Thomas Henry,2004,BASSE-NORMANDIE,CHERBOURG-EN-COTENTIN,0,21605,21605,
Musée de la Poeslerie,2004,BASSE-NORMANDIE,VILLEDIEU-LES-POELES-ROUFFIGNY,8275,546,8821,
Musée Municipal - Musée du Jouet,2004,BASSE-NORMANDIE,LA FERTE-MACE,1232,0,1232,
Musée Municipal d'Archéologie,2004,BASSE-NORMANDIE,L'AIGLE,0,154,154,
Musée Départemental d'Art Sacré,2004,BASSE-NORMANDIE,SEES,1299,0,1299,
Musée Municipal,2004,HAUTE-NORMANDIE,BERNAY,1176,5677,6853,
Musée de l'Ancien Evêché,2004,HAUTE-NORMANDIE,EVREUX,3238,6086,9324,
Musée Municipal Nicolas Poussin,2004,HAUTE-NORMANDIE,LES ANDELYS,985,854,1839,
Pavillon Flaubert,2004,HAUTE-NORMANDIE,CANTELEU,911,0,911,
Maison des Templiers,2004,HAUTE-NORMANDIE,CAUDEBEC-EN-CAUX,1034,0,1034,
Musée Louis-Philippe du Château d'Eu,2004,HAUTE-NORMANDIE,EU,9325,3014,12339,
Musée du Prieuré,2004,HAUTE-NORMANDIE,HARFLEUR,151,4349,4500,
Musée Départemental Pierre Corneille,2004,HAUTE-NORMANDIE,LE PETIT-COURONNE,1098,2348,3446,
Musée Mathon-Durand,2004,HAUTE-NORMANDIE,NEUFCHATEL-EN-BRAY,522,1542,2064,
Musée des Beaux-Arts,2004,HAUTE-NORMANDIE,ROUEN,36331,43716,80047,
Musée-Maison Natale Pierre Corneille,2004,HAUTE-NORMANDIE,ROUEN,781,1400,2181,
Musée de la Céramique,2004,HAUTE-NORMANDIE,ROUEN,5305,6686,11991,
Musées du Parc Naturel Régional de Brière,2004,PAYS DE LA LOIRE,SAINT-JOACHIM,3092,0,3092,
Muséum d'Histoire Naturelle,2004,PAYS DE LA LOIRE,ANGERS,3213,12187,15400,
Musée Jean Lurcat et de la Tapisserie Contemporaine,2004,PAYS DE LA LOIRE,ANGERS,14145,38848,52993,
Musée du Vieux Château,2004,PAYS DE LA LOIRE,LAVAL,6767,19364,26131,
Musée de l'Ardoise et de la Géologie,2004,PAYS DE LA LOIRE,RENAZE,1713,620,2333,
Musée de l'Abbaye de Sainte-Croix,2004,PAYS DE LA LOIRE,LES SABLES D'OLONNE,4272,11234,15506,
Musée Jean de la Fontaine,2004,PICARDIE,CHATEAU-THIERRY,6592,4044,10636,
Musée de la Résistance et de la Déportation,2004,PICARDIE,TERGNIER,6642,0,6642,
Musée de l'Archerie et de l'Art Sacré,2004,PICARDIE,CREPY-EN-VALOIS,3832,1672,5504,
Musée d'Art et d'Archéologie,2004,PICARDIE,SENLIS,1987,1805,3792,
Musée Départemental de l'Abbaye de Saint-Riquier,2004,PICARDIE,ABBEVILLE,0,18037,18037,
Musée de l'Hôtel de Berny,2004,PICARDIE,AMIENS,214,2740,2954,
Musée de la Maison de Pierre Loti,2004,POITOU-CHARENTES,ROCHEFORT,30677,2644,33321,
Musée Dupuy-Mestreau,2004,POITOU-CHARENTES,SAINTES,700,2233,2933,
Musée des Traditions Populaires et d'Archéologie,2004,POITOU-CHARENTES,CHAUVIGNY,8897,0,8897,
Collection d'Histoire Naturelle,2004,POITOU-CHARENTES,POITIERS,25267,68544,93811,
Musée d'Histoire Locale,2004,PROVENCE-ALPES-CÔTE D'AZUR,BIOT,801,1836,2637,
Musée Jean Cocteau Collection Séverin Wunderman,2004,PROVENCE-ALPES-CÔTE D'AZUR,MENTON,10977,3834,14811,
Musée Départemental des Arts Asiatiques,2004,PROVENCE-ALPES-CÔTE D'AZUR,NICE,15660,18956,34616,
Musée Matisse,2004,PROVENCE-ALPES-CÔTE D'AZUR,NICE,79251,47428,126679,
Muséum d'Histoire Naturelle,2004,PROVENCE-ALPES-CÔTE D'AZUR,AIX-EN-PROVENCE,8044,19856,27900,
Musée des Tapisseries,2004,PROVENCE-ALPES-CÔTE D'AZUR,AIX-EN-PROVENCE,16902,12998,29900,
Musée Archéologique d'Istres René Beaucaire,2004,PROVENCE-ALPES-CÔTE D'AZUR,ISTRES,622,2900,3522,
Musée des Docks Romains,2004,PROVENCE-ALPES-CÔTE D'AZUR,MARSEILLE,8183,0,8183,
Musée d'Art Contemporain - Galeries Contemporaines,2004,PROVENCE-ALPES-CÔTE D'AZUR,MARSEILLE,6864,17747,24611,
Musée d'Archéologie Méditerranéenne,2004,PROVENCE-ALPES-CÔTE D'AZUR,MARSEILLE,23222,0,23222,
Musée Cantini,2004,PROVENCE-ALPES-CÔTE D'AZUR,MARSEILLE,19138,28185,47323,
Muséum d'Histoire Naturelle,2004,PROVENCE-ALPES-CÔTE D'AZUR,MARSEILLE,17098,36599,53697,
Musée du Pays Brignolais,2004,PROVENCE-ALPES-CÔTE D'AZUR,BRIGNOLES,1170,917,2087,
Musée Jean Aicard,2004,PROVENCE-ALPES-CÔTE D'AZUR,LE POUVEREL LA GARDE,0,896,896,
Musée Archéologique,2004,PROVENCE-ALPES-CÔTE D'AZUR,SAINT-RAPHAËL,0,3800,3800,
Musée d'Art et d'Archéologie,2004,PROVENCE-ALPES-CÔTE D'AZUR,TOULON,0,15665,15665,
Musée National de la Marine de Toulon,2004,PROVENCE-ALPES-CÔTE D'AZUR,TOULON,14751,15212,29963,
Musée Marc Deydier,2004,PROVENCE-ALPES-CÔTE D'AZUR,CUCURON,0,3914,3914,
Musée Municipal Camille Pautet,2004,PROVENCE-ALPES-CÔTE D'AZUR,MAZAN,0,1570,1570,
Musée Municipal,2004,PROVENCE-ALPES-CÔTE D'AZUR,ORANGE,62792,0,62792,
Musée Archéologique Théo Desplans,2004,PROVENCE-ALPES-CÔTE D'AZUR,VAISON-LA-ROMAINE,70834,0,70834,
Musée de la Société d'Histoire et d'Archéologie,2004,RHONE-ALPES,BRIORD,179,0,179,
Musée Archéologique,2004,RHONE-ALPES,IZERNORE,0,100,100,
Musée Chintreuil,2004,RHONE-ALPES,PONT-DE-VAUX,4449,0,4449,
Musée Départemental du Revermont,2004,RHONE-ALPES,VAL-REVERMONT,21294,0,21294,
Musée et Site Archéologiques,2004,RHONE-ALPES,SOYONS,7184,2065,9249,
Musée de la Résistance de la Déportation de l'Isère,2004,RHONE-ALPES,GRENOBLE,0,27080,27080,
Musée Dauphinois,2004,RHONE-ALPES,GRENOBLE,0,107398,107398,
Musée Hébert,2004,RHONE-ALPES,LA TRONCHE,0,18981,18981,
Musée de la Grande Chartreuse,2004,RHONE-ALPES,SAINT-PIERRE-DE-CHARTREUSE,60805,0,60805,
Musée des Beaux-Arts et d'Archéologie,2004,RHONE-ALPES,VIENNE,1437,1734,3171,
Musée Alice Taverne,2004,RHONE-ALPES,AMBIERLE,5440,1689,7129,
Musée Hospitalier,2004,RHONE-ALPES,CHARLIEU,4191,1725,5916,
Musée d'Histoire du  20ème Siècle - Résistance et Déportation,2004,RHONE-ALPES,ESTIVAREILLES,3244,1153,4397,
Musée d'Art Moderne et Contemporain,2004,RHONE-ALPES,SAINT-ETIENNE,36286,24135,60421,
Musée des Civilisations : Daniel Pouget,2004,RHONE-ALPES,SAINT-JUST-SAINT-RAMBERT,5998,1677,7675,
Muséum d'Histoire Naturelle,2004,RHONE-ALPES,LYON,88298,0,88298,
Musée des Beaux-Arts,2004,RHONE-ALPES,LYON,150917,99515,250432,
Musée Archéologique,2004,RHONE-ALPES,SAINT-ROMAIN-EN-GAL,20780,53413,74193,
Musée Alsacien,2005,ALSACE,HAGUENAU,3430,0,3430,
Musée de la Chartreuse,2005,ALSACE,MOLSHEIM,3337,79,3416,
Musée de l'Image Populaire de Pfaffenhoffen,2005,ALSACE,PFAFFENHOFFEN,2680,766,3446,
Musée d'Art Moderne et Contemporain de Strasbourg,2005,ALSACE,STRASBOURG,38636,99092,137728,
Musée Archéologique,2005,ALSACE,STRASBOURG,18480,34447,52927,
Musée des Arts Décoratifs,2005,ALSACE,STRASBOURG,20011,35378,55389,
Musée Sundgauvien d'Altkirch,2005,ALSACE,ALTKIRCH,2630,11274,13904,
Musée Historique et Militaire de Huningue,2005,ALSACE,HUNINGE,512,0,512,
Musée Historique,2005,ALSACE,MULHOUSE,0,39467,39467,
Musée Vauban,2005,ALSACE,NEUF-BRISACH,3985,0,3985,
Musée du Papier Peint,2005,ALSACE,RIXHEIM,7588,2191,9779,
Musée de la Chalosse,2005,AQUITAINE,MONTFORT-EN-CHALOSSE,6898,2403,9301,
Musée Bonnat,2005,AQUITAINE,BAYONNE,13733,12971,26704,
Musée Basque et de l'Histoire de Bayonne,2005,AQUITAINE,BAYONNE,20953,9185,30138,
Musée Edmond Rostand,2005,AQUITAINE,CAMBO-LES-BAINS,54812,1775,56587,
Musée des Musiques Populaires - MuPop,2005,AUVERGNE,MONTLUCON,1486,8229,9715,
Musée Anne de Beaujeu,2005,AUVERGNE,MOULINS,10622,0,10622,
Musée Municipal de Souvigny,2005,AUVERGNE,SOUVIGNY,5509,1447,6956,
Musée d'Art et d'Archéologie,2005,AUVERGNE,AURILLAC,992,18646,19638,
Musée des Manufactures de Dentelles,2005,AUVERGNE,RETOURNAC,1954,2404,4358,
Muséum d'Histoire Naturelle Henri-Lecoq,2005,AUVERGNE,CLERMONT-FERRAND,3364,23116,26480,
Musée Alésia,2005,BOURGOGNE,ALISE-SAINTE-REINE,4178,659,4837,
Musée des Beaux-Arts,2005,BOURGOGNE,BEAUNE,1651,1083,2734,
Muséum - Jardin des Sciences,2005,BOURGOGNE,DIJON,6158,102561,108719,
Musée Noisot,2005,BOURGOGNE,FIXIN,367,454,821,
Musée des Beaux-Arts,2005,BOURGOGNE,MONTBARD,1315,0,1315,
Musée du Septennat,2005,BOURGOGNE,CHATEAU-CHINON,16481,3958,20439,
Musée du Costume,2005,BOURGOGNE,CHATEAU-CHINON,6954,1698,8652,
Musée Saint-Nazaire,2005,BOURGOGNE,BOURBON-LANCY,21,1658,1679,
Musée Denon,2005,BOURGOGNE,CHALON-SUR-SAONE,1531,9689,11220,
Musée du Prieuré de Charolles,2005,BOURGOGNE,CHAROLLES,1161,915,2076,
Musée des Ursulines,2005,BOURGOGNE,MACON,2459,7090,9549,
Musée Départemental de Préhistoire de Solutré,2005,BOURGOGNE,SOLUTRE-POUILLY,16301,7249,23550,
Musée Bourguignon -  Perrin de Puycousin,2005,BOURGOGNE,TOURNUS,1159,1438,2597,
Maison du Blé et du Pain,2005,BOURGOGNE,VERDUN-SUR-LE-DOUBS,4719,716,5435,
Musée d'Art et d'Histoire,2005,BOURGOGNE,AUXERRE,11287,19179,30466,
Musée de l'Avallonnais Jean Després,2005,BOURGOGNE,AVALLON,0,5519,5519,
Musée Muncipal,2005,BOURGOGNE,SENS,17784,10730,28514,
Musée d'Art et d'Histoire,2005,BRETAGNE,SAINT-BRIEUC,0,53040,53040,
Musée Bigouden,2005,BRETAGNE,PONT-L'ABBE,12974,3260,16234,
Musée des Beaux-Arts,2005,BRETAGNE,QUIMPER,35210,0,35210,
Musée de la Faucillonnaie,2005,BRETAGNE,MONTREUIL-SOUS-PEROUSE,2220,882,3102,
Musée Saint-Nicolas,2005,BRETAGNE,VITRE,3048,667,3715,
Ecomusée de Saint-Dégan,2005,BRETAGNE,BREC'H,9909,719,10628,
Musée du Berry,2005,CENTRE,BOURGES,0,13999,13999,
Musée d'Histoire Naturelle Gabriel Foucher,2005,CENTRE,BOURGES,9272,21091,30363,
Musée Saint-Vic,2005,CENTRE,SAINT-AMAND-MONTROND,878,2343,3221,
Musée d'Art et d'Histoire de Dreux,2005,CENTRE,DREUX,707,7056,7763,
Musée de la Chemiserie et de l'Elégance Masculine,2005,CENTRE,ARGENTON-SUR-CREUSE,4083,4699,8782,
Château Musée,2005,CENTRE,AZAY-LE-FERRON,10110,0,10110,
Musée de Préhistoire du Grand Pressigny,2005,CENTRE,LE GRAND PRESSIGNY,6567,5169,11736,
Musée Lansyer,2005,CENTRE,LOCHES,3656,0,3656,
Musée de l'Hôtel de Ville,2005,CENTRE,RICHELIEU,1079,0,1079,
Musée Municipal,2005,CENTRE,SAINTE-MAURE-DE-TOURAINE,71,54,125,
Musée des Vins de Touraine,2005,CENTRE,TOURS,1916,1470,3386,
Musée du Compagnonnage,2005,CENTRE,TOURS,36713,13401,50114,
Musée de l'Hôtel Goüin,2005,CENTRE,TOURS,3294,9696,12990,
Muséum d'Histoire Naturelle,2005,CENTRE,BLOIS,10583,0,10583,
Château-Musée de Gien,2005,CENTRE,GIEN,17822,1868,19690,
Musée des Sciences Naturelles,2005,CENTRE,ORLEANS,74276,0,74276,
Musée du Feutre,2005,CHAMPAGNE-ARDENNES,MOUZON,10985,1280,12265,
Musée du Château-Fort,2005,CHAMPAGNE-ARDENNES,SEDAN,68208,0,68208,
Musée des Beaux-Arts et d'Archéologie,2005,CHAMPAGNE-ARDENNES,CHAUMONT,4082,368,4450,
Musée de la Coutellerie,2005,CHAMPAGNE-ARDENNES,NOGENT,4185,839,5024,
Ecomusée de la Montagne de Reims,2005,CHAMPAGNE-ARDENNES,POURCY,164,1134,1298,
Musée Napoléonien,2005,CORSE,AJACCIO,4930,2399,7329,
Musée Beurnier-Rossel,2005,FRANCHE-COMTE,MONTBELIARD,5665,5722,11387,
Musée Départemental Albert-et-Félicie Demard - ATP,2005,FRANCHE-COMTE,CHAMPLITTE,17412,0,17412,
Musée Baron Martin,2005,FRANCHE-COMTE,GRAY,6565,5027,11592,
Musée Frédéric Japy,2005,FRANCHE-COMTE,BEAUCOURT,1973,1156,3129,
Forge-Musée,2005,FRANCHE-COMTE,ETUEFFONT,1458,242,1700,
Musée de l'Homme (Muséum National d'Histoire Naturelle),2005,ILE-DE-FRANCE,PARIS,122401,36561,158962,
Galerie de Minéralogie et de Géologie (Muséum d'Histoire Naturelle),2005,ILE-DE-FRANCE,PARIS,18505,6698,25203,
Maison de Victor Hugo,2005,ILE-DE-FRANCE,PARIS,5912,117311,123223,
Musée National Gustave Moreau,2005,ILE-DE-FRANCE,PARIS,20987,11956,32943,
Musée de l'Assistance Publique - Hôpitaux de Paris,2005,ILE-DE-FRANCE,PARIS,11825,10152,21977,
"Petit Palais, Musée des Beaux-Arts de la ville de Paris",2005,ILE-DE-FRANCE,PARIS,0,90213,90213,
Musée de la Musique,2005,ILE-DE-FRANCE,PARIS,98082,21374,119456,
Musée de la Poste,2005,ILE-DE-FRANCE,PARIS,55426,0,55426,
Musée Municipal des Capucins,2005,ILE-DE-FRANCE,COULOMMIERS,1491,1390,2881,
Musée Bossuet,2005,ILE-DE-FRANCE,MEAUX,8127,6750,14877,
Musée Départemental de Préhistoire d'Île de France,2005,ILE-DE-FRANCE,NEMOURS,3360,25457,28817,
Musée d'Art et d'Histoire,2005,ILE-DE-FRANCE,SAINT-DENIS,3599,25299,28898,
Ecomusée du Val de Bièvre,2005,ILE-DE-FRANCE,FRESNES,0,10342,10342,
Musée Camille Pissarro,2005,ILE-DE-FRANCE,PONTOISE,0,4409,4409,
Musée de l'Hôtel-Dieu,2005,ILE-DE-FRANCE,MANTES-LA-JOLIE,3851,1774,5625,
Musée Victor Aubert,2005,ILE-DE-FRANCE,MAULE,0,1100,1100,
Muséum d'Histoire Naturelle,2005,LA REUNION,SAINT-DENIS,12059,27546,39605,
Musée-Bibliothèque Pierre-André Benoît,2005,LANGUEDOC-ROUSSILLON,ALES,0,12849,12849,
Carré d'Art Musée d'Art Contemporain de Nîmes,2005,LANGUEDOC-ROUSSILLON,NIMES,43165,0,43165,
Musée des Vallées Cévenoles,2005,LANGUEDOC-ROUSSILLON,SAINT-JEAN DU GARD,12302,0,12302,
Musée des Beaux-Arts de Béziers,2005,LANGUEDOC-ROUSSILLON,BEZIERS,11560,0,11560,
Musée Archéologique Henri Prades,2005,LANGUEDOC-ROUSSILLON,LATTES,3546,2191,5737,
Musée du Vieux Montpellier,2005,LANGUEDOC-ROUSSILLON,MONTPELLIER,0,5591,5591,
Agropolis-Muséum,2005,LANGUEDOC-ROUSSILLON,MONTPELLIER,13380,0,13380,
Musée de Préhistoire Régionale et du Mégalithisme,2005,LANGUEDOC-ROUSSILLON,SAINT-PONS-DE-THOMIERES,1406,89,1495,
Muséum d'Histoire Naturelle,2005,LANGUEDOC-ROUSSILLON,PERPIGNAN,323,3166,3489,
Musée Hyacinthe Rigaud,2005,LANGUEDOC-ROUSSILLON,PERPIGNAN,3322,2690,6012,
Musée des Monnaies et Médailles Joseph Puig,2005,LANGUEDOC-ROUSSILLON,PERPIGNAN,190,949,1139,
Musée de Tautavel,2005,LANGUEDOC-ROUSSILLON,TAUTAVEL,77346,10093,87439,
Musée d'Art et d'Archéologie,2005,LIMOUSIN,GUERET,4968,5239,10207,
Musée de l'Evêché,2005,LIMOUSIN,LIMOGES,0,44991,44991,
Musée Jeanne d'Arc,2005,LORRAINE,VAUCOULEURS,916,598,1514,
Maison du Verre et du Cristal,2005,LORRAINE,MEISENTHAL,15609,1511,17120,
Moulin de la Blies - Musée des Techniques Faïencières,2005,LORRAINE,SARREGUEMINES,8950,4699,13649,
"Jardin d'Hiver, Musée de La Faïence",2005,LORRAINE,SARREGUEMINES,7498,4729,12227,
Musée de l'Image,2005,LORRAINE,EPINAL,21469,9882,31351,
Musée Charles de Bruyères,2005,LORRAINE,REMIREMONT,900,4074,4974,
Musée Municipal de Millau,2005,MIDI-PYRENEES,MILLAU,15704,11270,26974,
Musée des Beaux-Arts Denys Puech,2005,MIDI-PYRENEES,RODEZ,947,11670,12617,
Musée de l'Armagnac,2005,MIDI-PYRENEES,CONDOM,3916,76,3992,
Musée Municipal,2005,MIDI-PYRENEES,MARTRES-TOLOSANE,0,745,745,
Musée Saint-Raymond,2005,MIDI-PYRENEES,TOULOUSE,16221,36717,52938,
Musée de l'Automate,2005,MIDI-PYRENEES,SOUILLAC,27200,0,27200,
Musée Jean Jaurès,2005,MIDI-PYRENEES,CASTRES,1380,6535,7915,
Muséum d'histoire naturelle Philadelphe Thomas,2005,MIDI-PYRENEES,GAILLAC,596,2419,3015,
Musée Départemental du Textile,2005,MIDI-PYRENEES,LA-BASTIDE-ROUAIROUX,3222,3978,7200,
Musée des arts et traditions populaires,2005,MIDI-PYRENEES,MOISSAC,4704,1606,6310,
Musée Théophile Jouglet,2005,NORD-PAS-DE-CALAIS,ANZIN,0,2800,2800,
"Musée de la Mine, Centre Historique Minier",2005,NORD-PAS-DE-CALAIS,LEWARDE,134163,11831,145994,
Musée de l'Hospice Comtesse,2005,NORD-PAS-DE-CALAIS,LILLE,7199,48537,55736,
Palais des Beaux-Arts de Lille,2005,NORD-PAS-DE-CALAIS,LILLE,202535,30355,232890,
Musée d'Histoire et d'Archéologie,2005,NORD-PAS-DE-CALAIS,HARNES,0,1414,1414,
Musée de la Mine,2005,BASSE-NORMANDIE,LE MOLAY-LITTRY,6283,721,7004,
Musée et Sites archéologiques de Vieux-la-Romaine,2005,BASSE-NORMANDIE,VIEUX,9610,17709,27319,
Musée Municipal d'Avranches,2005,BASSE-NORMANDIE,AVRANCHES,3218,2186,5404,
Musée de la Guerre et de la Libération,2005,BASSE-NORMANDIE,CHERBOURG-EN-COTENTIN,4426,4453,8879,
Musée Richard Anacréon,2005,BASSE-NORMANDIE,GRANVILLE,5588,4624,10212,
Musée Municipal d'Archéologie,2005,BASSE-NORMANDIE,L'AIGLE,820,0,820,
Musée du Percheron,2005,BASSE-NORMANDIE,MORTAGNE-AU-PERCHE,0,825,825,
Musée Municipal,2005,HAUTE-NORMANDIE,BERNAY,1753,6652,8405,
Musée Alfred Canel,2005,HAUTE-NORMANDIE,PONT-AUDEMER,1165,1847,3012,
Musée Louis-Philippe du Château d'Eu,2005,HAUTE-NORMANDIE,EU,8405,3477,11882,
Muséum d'Histoire Naturelle,2005,HAUTE-NORMANDIE,LE HAVRE,0,23103,23103,
Musée Départemental Pierre Corneille,2005,HAUTE-NORMANDIE,LE PETIT-COURONNE,905,2363,3268,
Musée Industriel de la Corderie Vallois,2005,HAUTE-NORMANDIE,NOTRE-DAME-DE-BONDEVILLE,2192,6321,8513,
Musée-Maison Natale Pierre Corneille,2005,HAUTE-NORMANDIE,ROUEN,532,536,1068,
Musée Le Secq des Tournelles,2005,HAUTE-NORMANDIE,ROUEN,5982,7061,13043,
Musée Municipal des Ivoires,2005,HAUTE-NORMANDIE,YVETOT,817,255,1072,
Musée de la Reine Bérengère,2005,PAYS DE LA LOIRE,LE MANS,3674,3044,6718,
Centre Minier de Faymoreau,2005,PAYS DE LA LOIRE,FAYMOREAU,20633,6108,26741,
Musée Clemenceau et de Lattre-de-Tassigny,2005,PAYS DE LA LOIRE,MOUILLERON-EN-PAREDS,1840,1008,2848,
Familistère de Guise,2005,PICARDIE,GUISE,22951,0,22951,
Musée Jeanne d'Aboville,2005,PICARDIE,LA FERE,307,105,412,
Musée Entomologique,2005,PICARDIE,SAINT-QUENTIN,4350,3630,7980,
Musée Départemental de l'Abbaye de Saint-Riquier,2005,PICARDIE,ABBEVILLE,0,22516,22516,
Musée de Picardie,2005,PICARDIE,AMIENS,15287,35180,50467,
Musée-Historial de la Grande Guerre,2005,PICARDIE,PERONNE,73094,0,73094,
Musée Municipal de Cognac,2005,POITOU-CHARENTES,COGNAC,1564,5370,6934,
Musée du Nouveau Monde,2005,POITOU-CHARENTES,LA ROCHELLE,4345,5277,9622,
Musée des Beaux-Arts,2005,POITOU-CHARENTES,LA ROCHELLE,2580,5163,7743,
Musée Henri Barré,2005,POITOU-CHARENTES,THOUARS,1234,0,1234,
"Musée de la Moto, de l'Automobile et du Vélo",2005,POITOU-CHARENTES,CHATELLERAULT,4869,5963,10832,
Musée Municipal de Civray,2005,POITOU-CHARENTES,CIVRAY,0,509,509,
Musée départemental de préhistoire,2005,PROVENCE-ALPES-CÔTE D'AZUR,QUINSON,65787,10002,75789,
Musée d'Histoire Locale,2005,PROVENCE-ALPES-CÔTE D'AZUR,BIOT,2211,4547,6758,
Musée de la Mer,2005,PROVENCE-ALPES-CÔTE D'AZUR,CANNES,40429,28622,69051,
Villa-Musée Jean-Honoré Fragonard,2005,PROVENCE-ALPES-CÔTE D'AZUR,GRASSE,2774,1197,3971,
Musée des Beaux-Arts,2005,PROVENCE-ALPES-CÔTE D'AZUR,MENTON,0,11652,11652,
Musée Archéologique - Site de  Cimiez,2005,PROVENCE-ALPES-CÔTE D'AZUR,NICE,9201,20170,29371,
Musée d'Art Naïf Anatole Jakovsky,2005,PROVENCE-ALPES-CÔTE D'AZUR,NICE,3944,17621,21565,
Musée National Message Biblique Marc Chagall,2005,PROVENCE-ALPES-CÔTE D'AZUR,NICE,82535,58787,141322,
Musée des Beaux-Arts Jules Chéret,2005,PROVENCE-ALPES-CÔTE D'AZUR,NICE,20373,34808,55181,
Musée Matisse,2005,PROVENCE-ALPES-CÔTE D'AZUR,NICE,76068,48341,124409,
Musées de la Citadelle,2005,PROVENCE-ALPES-CÔTE D'AZUR,VILLEFRANCHE-SUR-MER,0,31736,31736,
Muséum d'Histoire Naturelle,2005,PROVENCE-ALPES-CÔTE D'AZUR,AIX-EN-PROVENCE,11650,20041,31691,
Fondation Louis Jou,2005,PROVENCE-ALPES-CÔTE D'AZUR,LES-BAUX-DE-PROVENCE,106,1250,1356,
Musée Frédéric Mistral,2005,PROVENCE-ALPES-CÔTE D'AZUR,MAILLANE,2408,1075,3483,
Musée des Beaux-Arts de Marseille,2005,PROVENCE-ALPES-CÔTE D'AZUR,MARSEILLE,4944,9041,13985,
Musée d'Art Contemporain - Galeries Contemporaines,2005,PROVENCE-ALPES-CÔTE D'AZUR,MARSEILLE,5909,14118,20027,
Musée Suffren et du Vieux Saint-Cannat,2005,PROVENCE-ALPES-CÔTE D'AZUR,SAINT-CANNAT,0,7659,7659,
Musée du Pays Brignolais,2005,PROVENCE-ALPES-CÔTE D'AZUR,BRIGNOLES,2077,1510,3587,
Musée Municipal,2005,PROVENCE-ALPES-CÔTE D'AZUR,DRAGUIGNAN,0,10235,10235,
Musée Archéologique Municipal,2005,PROVENCE-ALPES-CÔTE D'AZUR,FREJUS,0,6215,6215,
Musée Archéologique,2005,PROVENCE-ALPES-CÔTE D'AZUR,SAINT-RAPHAËL,0,7881,7881,
Musée du Vêtement Provençal (Jean Aicard),2005,PROVENCE-ALPES-CÔTE D'AZUR,SOLLIES-VILLE,0,4087,4087,
Musée d'Art et d'Archéologie,2005,PROVENCE-ALPES-CÔTE D'AZUR,TOULON,0,13195,13195,
Synagogue Musée Juif Comtadin,2005,PROVENCE-ALPES-CÔTE D'AZUR,CAVAILLON,3293,3390,6683,
Musée Marc Deydier,2005,PROVENCE-ALPES-CÔTE D'AZUR,CUCURON,0,2340,2340,
Musée-Bibliothèque François Pétrarque,2005,PROVENCE-ALPES-CÔTE D'AZUR,FONTAINE-DE-VAUCLUSE,2984,0,2984,
Musée Municipal Camille Pautet,2005,PROVENCE-ALPES-CÔTE D'AZUR,MAZAN,0,1539,1539,
Musée Archéologique Théo Desplans,2005,PROVENCE-ALPES-CÔTE D'AZUR,VAISON-LA-ROMAINE,65519,0,65519,
Musée Archéologique,2005,RHONE-ALPES,IZERNORE,0,386,386,
Musée du Bugey-Valmorey,2005,RHONE-ALPES,LOCHIEU,4211,298,4509,
Musée Départemental du Revermont,2005,RHONE-ALPES,VAL-REVERMONT,8080,11446,19526,
Musée de la Batellerie du Rhône,2005,RHONE-ALPES,SERRIERES,440,0,440,
Musée d'Huez et de l'Oisans,2005,RHONE-ALPES,ALPE D'HUEZ,2703,2191,4894,
Musée - Parc Archéologique du Lac de Paladru,2005,RHONE-ALPES,CHARAVINES,10871,0,10871,
Musée de Grenoble,2005,RHONE-ALPES,GRENOBLE,144401,0,144401,
Musée Dauphinois,2005,RHONE-ALPES,GRENOBLE,0,52344,52344,
Musée Hector Berlioz,2005,RHONE-ALPES,LA-COTE-SAINT-ANDRE,0,12415,12415,
Musée Lapidaire Saint-Pierre,2005,RHONE-ALPES,VIENNE,1762,3373,5135,
Atelier - Musée du Chapeau,2005,RHONE-ALPES,CHAZELLES-SUR-LYON,14432,2991,17423,
Musée d'Archéologie,2005,RHONE-ALPES,FEURS,849,3427,4276,
Musée d'Allard,2005,RHONE-ALPES,MONTBRISON,3901,4231,8132,
Musée Folklorique du Vieux Saint-Etienne,2005,RHONE-ALPES,SAINT-ETIENNE,1178,0,1178,
Musée Rural,2005,RHONE-ALPES,USSON-EN-FOREZ,6842,1337,8179,
Lugdunum - Musée et Théâtres Romains,2005,RHONE-ALPES,LYON,50989,54934,105923,
Muséum d'Histoire Naturelle,2005,RHONE-ALPES,LYON,41617,39229,80846,
Centre d'Histoire de la Résistance et de la Déportation,2005,RHONE-ALPES,LYON,17637,43024,60661,
Musée Henri Malartre,2005,RHONE-ALPES,ROCHETAILLEE-SUR-SAONE,43240,0,43240,
Musée Archéologique,2005,RHONE-ALPES,SAINT-ROMAIN-EN-GAL,21649,51832,73481,
Musée de l'Académie de La Val d'Isère,2005,RHONE-ALPES,MOÛTIERS,306,307,613,
Musée de la Poterie,2006,ALSACE,BETSCHDORF,2573,298,2871,
Musée Alsacien,2006,ALSACE,HAGUENAU,1591,2013,3604,
Musée Historique,2006,ALSACE,HAGUENAU,2155,3640,5795,
Musée Archéologique,2006,ALSACE,STRASBOURG,19061,31248,50309,
Musée Zoologique de Strasbourg,2006,ALSACE,STRASBOURG,11965,24583,36548,
Musée J.F. Oberlin,2006,ALSACE,WALDERSBACH,19063,2341,21404,
Musée d'Histoire Local,2006,ALSACE,KAYSERSBERG,248,149,397,
Musée du Vignoble et des Vins d'Alsace,2006,ALSACE,KAYSERSBERG VIGNOBLE,3480,22,3502,
Musée National de l'Automobile - Collection Schlumpf,2006,ALSACE,MULHOUSE,155287,31721,187008,
Musée Minéralogique de la Société Industrielle de Mulhouse,2006,ALSACE,MULHOUSE,0,130,130,
Maison du Sundgau - Musée Paysan,2006,ALSACE,OLTINGUE,1373,193,1566,
Musée du Dolder,2006,ALSACE,RIQUEWIHR,4134,486,4620,
Musée du Site Médiéval,2006,AQUITAINE,SAINT-AVIT-SENIEUR,1169,0,1169,
Musée d'Art et Traditions Populaires,2006,AQUITAINE,VILLEFRANCHE-DE-LONCHAT,0,930,930,
Musée d'Art et d'Histoire du Cap de Gascogne,2006,AQUITAINE,SAINT-SEVER,0,1500,1500,
Musée Municipal Albert Marzelles,2006,AQUITAINE,MARMANDE,0,5810,5810,
Musée Municipal (Moulin de Gajac),2006,AQUITAINE,VILLENEUVE-SUR-LOT,3160,4321,7481,
Musée Bonnat,2006,AQUITAINE,BAYONNE,14519,15180,29699,
Musée Bernadotte,2006,AQUITAINE,PAU,3595,0,3595,
Musée Municipal de Souvigny,2006,AUVERGNE,SOUVIGNY,5704,1187,6891,
Musée de la Haute Auvergne,2006,AUVERGNE,SAINT-FLOUR,4781,3791,8572,
Musée des Arts et Traditions Populaires de Haute Loire,2006,AUVERGNE,LAVAUDIEU,12129,465,12594,
Musée d'Archéologie Bargoin,2006,AUVERGNE,CLERMONT-FERRAND,3129,16843,19972,
Musée du Vin de Bourgogne,2006,BOURGOGNE,BEAUNE,20683,4104,24787,
"Musée de la Vie Bourguignonne, Perrin de Puycousin",2006,BOURGOGNE,DIJON,0,34844,34844,
Musée d'Art Sacré,2006,BOURGOGNE,DIJON,0,7092,7092,
Musée Municipal François Pompon,2006,BOURGOGNE,SAULIEU,2830,974,3804,
Musée d'Art et d'Histoire Romain Rolland,2006,BOURGOGNE,CLAMECY,1801,3984,5785,
Musée de la Loire,2006,BOURGOGNE,COSNE-SUR-LOIRE,708,2833,3541,
Musée Rolin,2006,BOURGOGNE,AUTUN,17270,4551,21821,
Musée Saint-Nazaire,2006,BOURGOGNE,BOURBON-LANCY,62,2872,2934,
Musée Denon,2006,BOURGOGNE,CHALON-SUR-SAONE,1127,11007,12134,
Musée Nicéphore Niepce,2006,BOURGOGNE,CHALON-SUR-SAONE,5258,13555,18813,
Musée des Ursulines,2006,BOURGOGNE,MACON,1730,6152,7882,
Musée Lamartine,2006,BOURGOGNE,MACON,1314,1367,2681,
Musée de la Tour du Moulin,2006,BOURGOGNE,MARCIGNY,1403,255,1658,
Musée du Terroir,2006,BOURGOGNE,ROMENAY,296,157,453,
Musée Leblanc-Duvernois,2006,BOURGOGNE,AUXERRE,893,1491,2384,
Musée de l'Avallonnais Jean Després,2006,BOURGOGNE,AVALLON,0,5658,5658,
Musée de la Pêche,2006,BRETAGNE,CONCARNEAU,33612,2343,35955,
Musée des Meilleurs Ouvriers de France,2006,CENTRE,BOURGES,0,19594,19594,
Muséum des Sciences Naturelles et de Préhistoire,2006,CENTRE,CHARTRES,1033,10636,11669,
Musée George Sand et de la Vallée Noire,2006,CENTRE,LA CHATRE,2879,1031,3910,
Musée de l'Hôtel Goüin,2006,CENTRE,TOURS,3178,7880,11058,
Musée de Minerve,2006,CENTRE,YZEURES-SUR-CREUSE,0,1020,1020,
Maison de la Magie,2006,CENTRE,BLOIS,54835,10720,65555,
Musée de Vendôme,2006,CENTRE,VENDOME,1463,7510,8973,
Musée Municipal Théâtre Forain et Archéologique,2006,CENTRE,ARTENAY,2055,3573,5628,
Musée des Beaux-Arts,2006,CENTRE,ORLEANS,6213,55517,61730,
Maison de l'Outil  et de la Pensée Ouvrière,2006,CHAMPAGNE-ARDENNES,TROYES,16321,6004,22325,
Musée des Beaux-Arts (Musée Pic Saint-Loup),2006,CHAMPAGNE-ARDENNES,TROYES,3204,7134,10338,
Musée d'Art Moderne,2006,CHAMPAGNE-ARDENNES,TROYES,13503,12270,25773,
Musée des Beaux-Arts et d'Archéologie,2006,CHAMPAGNE-ARDENNES,CHAUMONT,793,3751,4544,
Musée d'Art et d'Histoire,2006,CHAMPAGNE-ARDENNES,LANGRES,0,12623,12623,
Musée Municipal,2006,CHAMPAGNE-ARDENNES,CHALONS-EN-CHAMPAGNE,12428,0,12428,
Musée Garinet,2006,CHAMPAGNE-ARDENNES,CHALONS-EN-CHAMPAGNE,630,152,782,
Musée Hôtel le Vergeur,2006,CHAMPAGNE-ARDENNES,REIMS,8569,6548,15117,
Musée Saint-Rémi,2006,CHAMPAGNE-ARDENNES,REIMS,40654,0,40654,
Musée des Beaux-Arts de Saint-Denis,2006,CHAMPAGNE-ARDENNES,REIMS,9226,36593,45819,
Musée de l'Alta Rocca,2006,CORSE,LEVIE,4660,0,4660,
Ecomusée du Pays de la Cerise,2006,FRANCHE-COMTE,FOUGEROLLES,4934,0,4934,
Musée Départemental de la Montagne Albert Demard,2006,FRANCHE-COMTE,LE HAUT-DU-THEM,4385,3900,8285,
Musée du Jouet,2006,FRANCHE-COMTE,MOIRANS-EN-MONTAGNE,29120,1670,30790,
Musée des Salines,2006,FRANCHE-COMTE,SALINS-LES-BAINS,46042,5072,51114,
Musée de l'Artisanat Jurassien,2006,FRANCHE-COMTE,VOITEUR,0,8417,8417,
Musée Frédéric Japy,2006,FRANCHE-COMTE,BEAUCOURT,3142,0,3142,
Forge-Musée,2006,FRANCHE-COMTE,ETUEFFONT,1680,0,1680,
Musée Précolombien Edgar Clerc,2006,GUADELOUPE,LE MOULE,0,2691,2691,
Musée Municipal Saint-John Perse,2006,GUADELOUPE,POINTE-A-PITRE,2893,0,2893,
Musée Territorial Alexandre Franconie,2006,GUYANE,CAYENNE,5786,0,5786,
Musée Français de la Photographie,2006,ILE-DE-FRANCE,BIEVRES,2361,1964,4325,
Musée Municipal d'Art et d'Histoire,2006,ILE-DE-FRANCE,COLOMBES,0,4562,4562,
Musée - Atelier Rodin (Annexe du musée de Paris),2006,ILE-DE-FRANCE,MEUDON,2890,3056,5946,
Musée de l'Homme (Muséum National d'Histoire Naturelle),2006,ILE-DE-FRANCE,PARIS,113713,51704,165417,
Maison de Victor Hugo,2006,ILE-DE-FRANCE,PARIS,20814,106416,127230,
Musée des Arts d'Afrique et d'Océanie - Aquarium,2006,ILE-DE-FRANCE,PARIS,134029,83644,217673,
Musée National Picasso,2006,ILE-DE-FRANCE,PARIS,290281,210779,501060,
Mémorial du Maréchal Leclerc de Hauteclocque et de la Libération de Paris-musée Jean Moulin,2006,ILE-DE-FRANCE,PARIS,2316,11954,14270,
Musée National Auguste Rodin,2006,ILE-DE-FRANCE,PARIS,341671,273196,614867,
Musée National d'Art Moderne (Centre National d'Art et de Culture Georges Pompidou),2006,ILE-DE-FRANCE,PARIS,2711331,0,2711331,
Musée de la Poste,2006,ILE-DE-FRANCE,PARIS,15394,46091,61485,
Musée d'Art et d'Histoire Militaire,2006,ILE-DE-FRANCE,FONTAINEBLEAU,1112,3031,4143,
Musée Henri Chapu,2006,ILE-DE-FRANCE,LE MEE-SUR-SEINE,0,964,964,
Musée Municipal,2006,ILE-DE-FRANCE,MORET-SUR-LOING,0,6178,6178,
Musée départemental Stéphane Mallarmé,2006,ILE-DE-FRANCE,VULAINES-SUR-SEINE,2246,821,3067,
Musée de l'Air et de l'Espace,2006,ILE-DE-FRANCE,LE BOURGET,143107,43796,186903,
Musée Fragonard,2006,ILE-DE-FRANCE,MAISONS-ALFORT,4052,0,4052,
Musée de Nogent-Sur-Marne,2006,ILE-DE-FRANCE,NOGENT-SUR-MARNE,0,5856,5856,
Musée jean-Jacques Rousseau,2006,ILE-DE-FRANCE,MONTMORENCY,939,1146,2085,
Musée-Maison Maurice Ravel,2006,ILE-DE-FRANCE,MONTFORT-L'AMAURY,2780,0,2780,
Musée Départemental de la Réunion - Musée Léon Dierx,2006,LA REUNION,SAINT-DENIS,5738,4262,10000,
Musée des Beaux-Arts de Béziers,2006,LANGUEDOC-ROUSSILLON,BEZIERS,14987,0,14987,
Musée de l'Ephèbe,2006,LANGUEDOC-ROUSSILLON,LE CAP D'AGDE,9063,4068,13131,
Musée Fabre,2006,LANGUEDOC-ROUSSILLON,MONTPELLIER,39500,0,39500,
Musée Languedocien,2006,LANGUEDOC-ROUSSILLON,MONTPELLIER,2854,3282,6136,
Musée de Préhistoire Régionale et du Mégalithisme,2006,LANGUEDOC-ROUSSILLON,SAINT-PONS-DE-THOMIERES,976,81,1057,
Musée Paul Valéry,2006,LANGUEDOC-ROUSSILLON,SETE,6295,9389,15684,
Musée National Adrien Dubouché,2006,LIMOUSIN,LIMOGES,12105,8944,21049,
Les Sources d'Hercule,2006,LORRAINE,DENEUVRE,2897,718,3615,
Musée de la Mine - Carreau Wendel,2006,LORRAINE,PETITE-ROSSELLE,10842,0,10842,
"Jardin d'Hiver, Musée de La Faïence",2006,LORRAINE,SARREGUEMINES,5773,4951,10724,
Musée de l'Image,2006,LORRAINE,EPINAL,18143,8517,26660,
Musée Louis Français,2006,LORRAINE,PLOMBIERES-LES-BAINS,261,137,398,
Musée Départemental d'Archéologie Précolombienne et de Préhistoire de la Martinique,2006,MARTINIQUE,FORT-DE-FRANCE,5561,4002,9563,
Musée Régional d'Histoire et d'Ethnologie,2006,MARTINIQUE,FORT-DE-FRANCE - MARTINIQUE-,2586,1342,3928,
"Musée des Mœurs et Coutumes, Musée du Rouergue",2006,MIDI-PYRENEES,ESPALION,501,79,580,
Musée Joseph Vaylet,2006,MIDI-PYRENEES,ESPALION,2870,435,3305,
Musée des Arts et Métiers Traditionnels,2006,MIDI-PYRENEES,SALLES-LA-SOURCE,9772,1329,11101,
Musée du Charroi Rural et de l'Artisanat Traditionnel,2006,MIDI-PYRENEES,SALMIECH,0,2000,2000,
Musée d'Histoire Naturelle et de Préhistoire,2006,MIDI-PYRENEES,NIMES,0,45341,45341,
Musée Départemental d'Art Sacré du Gard,2006,MIDI-PYRENEES,PONT-SAINT-ESPRIT,956,9072,10028,
Musée Archéologique,2006,MIDI-PYRENEES,EAUZE,3644,2530,6174,
Musée des Beaux-Arts et des Arts Décoratifs,2006,MIDI-PYRENEES,MIRANDE,604,482,1086,
Musée Municipal d'Art et d'Histoire,2006,MIDI-PYRENEES,SAINT-GAUDENS,407,275,682,
"Les Abattoirs, Musée d'Art Moderne et Contemporain",2006,MIDI-PYRENEES,TOULOUSE,30781,82999,113780,
Musée Saint-Raymond,2006,MIDI-PYRENEES,TOULOUSE,39440,22034,61474,
"Musée Archéologique ""Armand-Viré""",2006,MIDI-PYRENEES,LUZECH,369,316,685,
Musée Gallo-Romain d'Uxellodunum,2006,MIDI-PYRENEES,MARTEL,288,208,496,
Musée Départemental de Cuzals,2006,MIDI-PYRENEES,SAULIAC-SUR-CELE,8609,2082,10691,
Musée Municipal,2006,MIDI-PYRENEES,VAYRAC,212,53,265,
Musée Goya,2006,MIDI-PYRENEES,CASTRES,10596,9686,20282,
Musée d'Histoire Naturelle Victor Brun,2006,MIDI-PYRENEES,MONTAUBAN,756,4393,5149,
Musée Ingres,2006,MIDI-PYRENEES,MONTAUBAN,18936,24157,43093,
Musée du Mont-de-Piété,2006,NORD-PAS-DE-CALAIS,BERGUES,1625,951,2576,
Musée de l'Ostrevant,2006,NORD-PAS-DE-CALAIS,BOUCHAIN,174,515,689,
Musée des Beaux-Arts,2006,NORD-PAS-DE-CALAIS,DUNKERQUE,13357,0,13357,
Ecomusée de la Région,2006,NORD-PAS-DE-CALAIS,FOURMIES,45831,0,45831,
Musée Départemental Matisse,2006,NORD-PAS-DE-CALAIS,LE CATEAU-CAMBRESIS,23219,44541,67760,
Musée d'Art Moderne de Lille Métropole,2006,NORD-PAS-DE-CALAIS,VILLENEUVE-D'ASCQ,4701,29926,34627,
Musée Municipal,2006,NORD-PAS-DE-CALAIS,LE TOUQUET-PARIS-PLAGE,2152,1227,3379,
Musée Jean-Charles Cazin,2006,NORD-PAS-DE-CALAIS,SAMER,0,573,573,
Musée du Débarquement,2006,BASSE-NORMANDIE,ARROMANCHES,305161,0,305161,
Musée de la Poste et des Techniques de communication,2006,BASSE-NORMANDIE,CAEN,3466,3156,6622,
Musée d'Initiation à la Nature,2006,BASSE-NORMANDIE,CAEN,0,5323,5323,
Musée de la Mine,2006,BASSE-NORMANDIE,LE MOLAY-LITTRY,4883,991,5874,
Musée de Trouville - Villa Montebello,2006,BASSE-NORMANDIE,TROUVILLE-SUR-MER,5415,5966,11381,
Musée Thomas Henry,2006,BASSE-NORMANDIE,CHERBOURG-EN-COTENTIN,0,18248,18248,
Musée Municipal,2006,BASSE-NORMANDIE,EQUEURDREVILLLE-HAINNEVILLE,0,5500,5500,
Musée Christian Dior,2006,BASSE-NORMANDIE,GRANVILLE,25293,0,25293,
Musée de l'Ancien Evêché,2006,HAUTE-NORMANDIE,EVREUX,9480,0,9480,
Musée Municipal,2006,HAUTE-NORMANDIE,LOUVIERS Cedex,36,7049,7085,
Musée Alphonse-Georges Poulain,2006,HAUTE-NORMANDIE,VERNON,2430,7992,10422,
Musée des Terres-Neuvas et de la Pêche,2006,HAUTE-NORMANDIE,FECAMP,15975,12860,28835,
Abbaye de Graville - Musée du Prieuré de Graville,2006,HAUTE-NORMANDIE,LE HAVRE,1167,4204,5371,
Musée des Antiquités de la Seine-Maritime,2006,HAUTE-NORMANDIE,ROUEN,1986,17526,19512,
Musée Le Secq des Tournelles,2006,HAUTE-NORMANDIE,ROUEN,5665,6081,11746,
MUNAE - Musée National de l'Education,2006,HAUTE-NORMANDIE,ROUEN,4558,6776,11334,
Association de l'Horlogerie Aliermontaise,2006,HAUTE-NORMANDIE,SAINT-NICOLAS-D'ALIERMONT,262,408,670,
Musée  Départemental Dobrée,2006,PAYS DE LA LOIRE,NANTES,6193,21166,27359,
Musée du Chaume/Kerhinet - Pard Naturel Régional de Brière,2006,PAYS DE LA LOIRE,SAINT-LYPHARD,3005,1443,4448,
Ecomusée de Saint-Nazaire,2006,PAYS DE LA LOIRE,SAINT-NAZAIRE,2139,70225,72364,
Galerie David d'Angers,2006,PAYS DE LA LOIRE,ANGERS,6861,16996,23857,
Musée d'Art et d'Histoire,2006,PAYS DE LA LOIRE,BAUGE,3503,1068,4571,
Musée des Tisserands Mayennais,2006,PAYS DE LA LOIRE,AMBRIERES-LES-VALLEES,798,91,889,
Musée du Vieux Château,2006,PAYS DE LA LOIRE,LAVAL,6601,17295,23896,
Musée Vert Véron-de-Forbonnais,2006,PAYS DE LA LOIRE,LE MANS,2296,10178,12474,
Ecomusée du Marais Breton Vendéen,2006,PAYS DE LA LOIRE,LA BARRE-DE-MONTS,20794,9736,30530,
Musée Municipal,2006,PAYS DE LA LOIRE,LA ROCHE-SUR-YON,0,11058,11058,
Musée ornithologique Charles-Payraudeau,2006,PAYS DE LA LOIRE,LA-CHAIZE-LE-VICOMTE,0,828,828,
Musée Jean de la Fontaine,2006,PICARDIE,CHATEAU-THIERRY,6402,3737,10139,
Familistère de Guise,2006,PICARDIE,GUISE,24395,1174,25569,
Musée Municipal de Soissons,2006,PICARDIE,SOISSONS,0,28547,28547,
Musée Alexandre Dumas,2006,PICARDIE,VILLERS COTTERETS,1425,0,1425,
Musée Pillon,2006,PICARDIE,CHAUMONT-EN-VEXIN,0,300,300,
Musée de l'Archerie et de l'Art Sacré,2006,PICARDIE,CREPY-EN-VALOIS,2846,4045,6891,
Musée Jean Calvin,2006,PICARDIE,NOYON,1943,1521,3464,
Musée Alfred Danicourt,2006,PICARDIE,PERONNE,0,1181,1181,
Cité International de la Bande Dessinée et de l'Image - Musée de la Bande Dessinée,2006,POITOU-CHARENTES,ANGOULEME,27151,2775,29926,
Musée de la Maison de Pierre Loti,2006,POITOU-CHARENTES,ROCHEFORT,26784,2902,29686,
Musée National de la Marine,2006,POITOU-CHARENTES,ROCHEFORT,15711,10321,26032,
Musée d'Art et d'Histoire Georges Turpin,2006,POITOU-CHARENTES,PARTHENAY,782,5601,6383,
Musée Municipal de Civray,2006,POITOU-CHARENTES,CIVRAY,0,425,425,
Musée du baptistère Saint-Jean,2006,POITOU-CHARENTES,POITIERS,15897,1220,17117,
Collection d'Histoire Naturelle,2006,POITOU-CHARENTES,POITIERS,26491,32636,59127,
Musée de la Faïence,2006,PROVENCE-ALPES-CÔTE D'AZUR,MOUSTIERS-SAINTE-MARIE,7300,3119,10419,
Musée départemental de préhistoire,2006,PROVENCE-ALPES-CÔTE D'AZUR,QUINSON,66226,3815,70041,
Musée du Vieux Sisteron,2006,PROVENCE-ALPES-CÔTE D'AZUR,SISTERON,0,555,555,
Musée archéologique,2006,PROVENCE-ALPES-CÔTE D'AZUR,VACHERES,887,347,1234,
Musée de la Castre,2006,PROVENCE-ALPES-CÔTE D'AZUR,CANNES,14831,11406,26237,
Musée National Message Biblique Marc Chagall,2006,PROVENCE-ALPES-CÔTE D'AZUR,NICE,98073,33900,131973,
Musée du Palais Lascaris,2006,PROVENCE-ALPES-CÔTE D'AZUR,NICE,0,53835,53835,
Muséum d'Histoire Naturelle,2006,PROVENCE-ALPES-CÔTE D'AZUR,AIX-EN-PROVENCE,8971,19958,28929,
Muséon Arlaten,2006,PROVENCE-ALPES-CÔTE D'AZUR,ARLES,14996,34743,49739,
Musée d'Histoire et d'Archéologie des Baux-de-Provence,2006,PROVENCE-ALPES-CÔTE D'AZUR,LES BAUX DE PROVENCE,222072,23343,245415,
Fondation Louis Jou,2006,PROVENCE-ALPES-CÔTE D'AZUR,LES-BAUX-DE-PROVENCE,357,507,864,
Musée Frédéric Mistral,2006,PROVENCE-ALPES-CÔTE D'AZUR,MAILLANE,2600,800,3400,
Musée du Vieux Marseille,2006,PROVENCE-ALPES-CÔTE D'AZUR,MARSEILLE,3113,6632,9745,
Musée Archéologique Municipal,2006,PROVENCE-ALPES-CÔTE D'AZUR,FREJUS,4146,4572,8718,
Musée de l'Annonciade,2006,PROVENCE-ALPES-CÔTE D'AZUR,SAINT-TROPEZ,35802,6839,42641,
Musée d'Apt,2006,PROVENCE-ALPES-CÔTE D'AZUR,APT,1881,4958,6839,
Synagogue Musée Juif Comtadin,2006,PROVENCE-ALPES-CÔTE D'AZUR,CAVAILLON,3310,3021,6331,
Musée Municipal,2006,PROVENCE-ALPES-CÔTE D'AZUR,ORANGE,48004,0,48004,
Musée du Bugey-Valmorey,2006,RHONE-ALPES,LOCHIEU,4041,3185,7226,
Musée et Site Archéologiques,2006,RHONE-ALPES,SOYONS,8063,1471,9534,
Musée International de la Chaussure,2006,RHONE-ALPES,ROMANS,20014,17500,37514,
Musée des Vallées de Thônes,2006,RHONE-ALPES,THONES,1438,708,2146,
Musée Gallo-Romain,2006,RHONE-ALPES,AOSTE,5475,2297,7772,
Musée de Grenoble,2006,RHONE-ALPES,GRENOBLE,58052,109263,167315,
Maison du Patrimoine de Hières-sur-Amby,2006,RHONE-ALPES,HIERES SUR AMBY,7640,362,8002,
Conservatoire - Musée des Industries Hydroélectriques,2006,RHONE-ALPES,VAUJANY,0,11108,11108,
Musée Départemental de la Révolution Française,2006,RHONE-ALPES,VIZILLE,0,52284,52284,
Musée Alice Taverne,2006,RHONE-ALPES,AMBIERLE,4642,1119,5761,
Musée d'Archéologie,2006,RHONE-ALPES,FEURS,1607,3521,5128,
Musée d'Art Moderne et Contemporain,2006,RHONE-ALPES,SAINT-ETIENNE,54808,0,54808,
Musée Barthélemy-Thimonnier,2006,RHONE-ALPES,AMPLEPUIS,2193,2517,4710,
Musée des Hospices Civils de Lyon,2006,RHONE-ALPES,LYON,6404,2339,8743,
Musée des Sapeurs-Pompiers de Lyon,2006,RHONE-ALPES,LYON,0,5386,5386,
Musée Archéologique,2006,RHONE-ALPES,SAINT-ROMAIN-EN-GAL,14677,46488,61165,
Musée Municipal d'Albertville-Conflans,2006,RHONE-ALPES,ALBERTVILLE,2231,1818,4049,
Musée de Bouxwiller et du pays de hanau,2007,ALSACE,BOUXWILLER,1449,392,1841,
Musée du Château des Rohan,2007,ALSACE,SAVERNE,4833,3118,7951,
Musée de la Bataille du 6 Août 1870,2007,ALSACE,WOERTH,2555,729,3284,
Musée de la Porte de Thann,2007,ALSACE,CERNAY,160,840,1000,
Musée Bartholdi,2007,ALSACE,COLMAR,7647,4443,12090,
Musée Historique,2007,ALSACE,MULHOUSE,0,38441,38441,
Musée EDF Electropolis,2007,ALSACE,MULHOUSE,29464,7137,36601,
Ecomusée d'Alsace,2007,ALSACE,UNGERSHEIM,160000,10000,170000,
Musée des Arts et Traditions Populaires du Périgord,2007,AQUITAINE,MUSSIDAN,961,825,1786,
Musée du Site Médiéval,2007,AQUITAINE,SAINT-AVIT-SENIEUR,1244,0,1244,
Musée des Beaux-Arts,2007,AQUITAINE,BORDEAUX,27180,58243,85423,
Musée Historique de l'Hydravion,2007,AQUITAINE,BISCARROSSE,18235,1695,19930,
Musée de la Chalosse,2007,AQUITAINE,MONTFORT-EN-CHALOSSE,8953,1826,10779,
Musée du Château Henri IV,2007,AQUITAINE,NERAC,16709,4156,20865,
Musée Municipal (Moulin de Gajac),2007,AQUITAINE,VILLENEUVE-SUR-LOT,3216,2569,5785,
Musée National du Château,2007,AQUITAINE,PAU,65545,38236,103781,
Musée Bernadotte,2007,AQUITAINE,PAU,1628,1943,3571,
Musée Charles-Louis Philippe,2007,AUVERGNE,CERILLY,238,9,247,
Ecomusée de Margeride-Haute-Auvergne,2007,AUVERGNE,RUYNES-EN-MARGERIDE,8017,1011,9028,
Musée de la Haute Auvergne,2007,AUVERGNE,SAINT-FLOUR,2879,1046,3925,
Musée des Arts et Traditions Populaires de Haute Loire,2007,AUVERGNE,LAVAUDIEU,14376,453,14829,
Musée Municipal de la Coutellerie,2007,AUVERGNE,THIERS,26752,5588,32340,
Musée Bonaparte,2007,BOURGOGNE,AUXONNE,0,4094,4094,
Musée des Beaux-Arts,2007,BOURGOGNE,BEAUNE,6660,2480,9140,
"Musée de la Vie Bourguignonne, Perrin de Puycousin",2007,BOURGOGNE,DIJON,0,32877,32877,
Musée Municipal,2007,BOURGOGNE,NUITS-SAINT-GEORGES,1236,676,1912,
Musée du Costume,2007,BOURGOGNE,CHATEAU-CHINON,6527,1367,7894,
Musée du Grès de Puisaye,2007,BOURGOGNE,SAINT-AMAND-EN-PUISAYE,2524,318,2842,
Musée de l'Homme et de l'Industrie - Ecomusée de la Communauté Le Creusot-Monceau-Les-Mines,2007,BOURGOGNE,LE CREUSOT,13655,4202,17857,
Musée de la Tour du Moulin,2007,BOURGOGNE,MARCIGNY,1014,167,1181,
Musée Muncipal,2007,BOURGOGNE,SENS,5906,27399,33305,
Le Port-Musée,2007,BRETAGNE,DOUARNENEZ,38359,13289,51648,
Musée de Morlaix,2007,BRETAGNE,MORLAIX,9598,9605,19203,
Musée de l'Ecole Rurale en Bretagne,2007,BRETAGNE,TREGARVAN,10366,1390,11756,
Ecomusée du Pays de Rennes,2007,BRETAGNE,RENNES,12236,29401,41637,
Musée du Château de Vitré,2007,BRETAGNE,VITRE,11699,5970,17669,
Musée de la Résistance Bretonne,2007,BRETAGNE,SAINT-MARCEL - MALESTROIT,26347,3115,29462,
"La Cohue, Musée des Beaux-Arts de vannes",2007,BRETAGNE,VANNES,16024,28723,44747,
Musée des Meilleurs Ouvriers de France,2007,CENTRE,BOURGES,0,20247,20247,
Musée de l'Hospice Saint-Roch,2007,CENTRE,ISSOUDUN,242,13669,13911,
Musée du Vieux Chinon,2007,CENTRE,CHINON,1015,1491,2506,
"""Maison Musée"" René Descartes",2007,CENTRE,DESCARTES,1735,1693,3428,
Musée Lansyer,2007,CENTRE,LOCHES,2730,1612,4342,
Musée de l'Hôtel de Ville,2007,CENTRE,RICHELIEU,933,205,1138,
Musée François Rabelais,2007,CENTRE,SEUILLY,8062,4089,12151,
Musée du Compagnonnage,2007,CENTRE,TOURS,34927,17221,52148,
Maison de la Magie,2007,CENTRE,BLOIS,58891,12013,70904,
Musée de Sologne,2007,CENTRE,ROMORANTIN-LANTHENAY,6161,2558,8719,
Château-Musée de Gien,2007,CENTRE,GIEN,15988,8071,24059,
Musée Gaston Couté,2007,CENTRE,MEUNG-SUR-LOIRE,0,2467,2467,
Musée du Gatinais,2007,CENTRE,MONTARGIS,240,165,405,
Musée Historique et Archéologique,2007,CENTRE,ORLEANS,678,3057,3735,
Musée du Feutre,2007,CHAMPAGNE-ARDENNES,MOUZON,5307,1700,7007,
Musée Paul Dubois-Alfred Boucher,2007,CHAMPAGNE-ARDENNES,NOGENT-SUR-SEINE,1544,111,1655,
Musée des Beaux-Arts (Musée Pic Saint-Loup),2007,CHAMPAGNE-ARDENNES,TROYES,12940,0,12940,
Musée Hôtel le Vergeur,2007,CHAMPAGNE-ARDENNES,REIMS,8763,6539,15302,
Musée Saint-Rémi,2007,CHAMPAGNE-ARDENNES,REIMS,42362,0,42362,
Musée des Beaux-Arts de Saint-Denis,2007,CHAMPAGNE-ARDENNES,REIMS,13136,33468,46604,
Musée de la Maison Bonaparte,2007,CORSE,AJACCIO,45742,15205,60947,
Musée d'archéologie d'Aleria - Jérôme Carcopino,2007,CORSE,ALERIA,21039,18225,39264,
Musée de la Corse,2007,CORSE,CORTE,52203,10599,62802,
Musée Départemental Pascal Paoli,2007,CORSE,MOROSAGLIA,2500,2850,5350,
Musée de la résistance et de la Déportation,2007,FRANCHE-COMTE,BESANCON,62073,0,62073,
Musée du Temps,2007,FRANCHE-COMTE,BESANCON,4694,30327,35021,
Musée de Plein Air des Maisons Comtoises,2007,FRANCHE-COMTE,NANCRAY,36928,0,36928,
Ecomusée du Pays de la Cerise,2007,FRANCHE-COMTE,FOUGEROLLES,1533,52,1585,
Musée de la Tour des Echevins,2007,FRANCHE-COMTE,LUXEUIL-LES-BAINS,1102,4700,5802,
Musée Municipal Saint-John Perse,2007,GUADELOUPE,POINTE-A-PITRE,3322,0,3322,
Musée Intercommunal d'Etampes,2007,ILE-DE-FRANCE,ETAMPES,972,7527,8499,
Musée Départemental Albert-Kahn,2007,ILE-DE-FRANCE,BOULOGNE-BILLANCOURT,52045,30127,82172,
Musée Français de la Carte à Jouer,2007,ILE-DE-FRANCE,ISSY-LES-MOULINEAUX,3296,12764,16060,
Musée des Automates,2007,ILE-DE-FRANCE,NEUILLY-SUR-SEINE,2563,2750,5313,
Musée d'Histoire Locale - Mémoire de la Ville,2007,ILE-DE-FRANCE,RUEIL-MALMAISON,0,2694,2694,
Musée de l'Armée,2007,ILE-DE-FRANCE,PARIS,891167,251204,1142371,
Musée du Moyen Age-Thermes et Hôtel de Cluny,2007,ILE-DE-FRANCE,PARIS,165405,128570,293975,
Musée de l'Assistance Publique - Hôpitaux de Paris,2007,ILE-DE-FRANCE,PARIS,10032,6139,16171,
Musée Carnavalet-Histoire de Paris,2007,ILE-DE-FRANCE,PARIS,305154,562963,868117,
Mémorial du Maréchal Leclerc de Hauteclocque et de la Libération de Paris-musée Jean Moulin,2007,ILE-DE-FRANCE,PARIS,3824,10594,14418,
Musée Nissim de Camondo (UCAD),2007,ILE-DE-FRANCE,PARIS,24688,13433,38121,
Musée du Louvre,2007,ILE-DE-FRANCE,PARIS,5521236,2703407,8224643,
Musée de la Chasse et de la Nature,2007,ILE-DE-FRANCE,PARIS,28108,16173,44281,
Musée d'Art et d'Histoire du Judaïsme,2007,ILE-DE-FRANCE,PARIS,95423,42509,137932,
"Musée Cernuschi, Musée des Arts de l'Asie de la ville de Paris",2007,ILE-DE-FRANCE,PARIS,15573,35341,50914,
Musée National d'Art Moderne (Centre National d'Art et de Culture Georges Pompidou),2007,ILE-DE-FRANCE,PARIS,2696857,0,2696857,
Musée des Monnaies et des Médailles,2007,ILE-DE-FRANCE,PARIS,9527,3618,13145,
Musée de la Poste,2007,ILE-DE-FRANCE,PARIS,17222,50026,67248,
Musée Henri Chapu,2007,ILE-DE-FRANCE,LE MEE-SUR-SEINE,0,1410,1410,
Musée Bossuet,2007,ILE-DE-FRANCE,MEAUX,3257,4119,7376,
Ecomusée,2007,ILE-DE-FRANCE,SAVIGNY-LE-TEMPLE,0,7618,7618,
Musée départemental Stéphane Mallarmé,2007,ILE-DE-FRANCE,VULAINES-SUR-SEINE,3318,1855,5173,
Musée du Vieil Argenteuil,2007,ILE-DE-FRANCE,ARGENTEUIL,4191,0,4191,
Musée Promenade Marly/Louveciennes,2007,ILE-DE-FRANCE,LOUVECIENNES,4759,1870,6629,
Musée-Maison Maurice Ravel,2007,ILE-DE-FRANCE,MONTFORT-L'AMAURY,2117,0,2117,
Musée de la Ville,2007,ILE-DE-FRANCE,MONTIGNY LE BRETONNEUX,4668,9316,13984,
Musée d'Archéologie Nationale (des origines à l'an mille) - Château de st-Germain-en-Laye,2007,ILE-DE-FRANCE,SAINT-GERMAIN-EN-LAYE,16516,81730,98246,
Musée Départemental de la Réunion - Musée Léon Dierx,2007,LA REUNION,SAINT-DENIS,3632,13735,17367,
Musée d'Art et d'Histoire - Ensemble monumental de Narbonne,2007,LANGUEDOC-ROUSSILLON,NARBONNE,44436,302207,346643,
Musée-Bibliothèque Pierre-André Benoît,2007,LANGUEDOC-ROUSSILLON,ALES,0,18820,18820,
Musée Léon Alègre,2007,LANGUEDOC-ROUSSILLON,BAGNOLS-SUR-CEZE,23,1639,1662,
Musée Cévenol,2007,LANGUEDOC-ROUSSILLON,LE VIGAN,2142,2091,4233,
Musée des Cultures Taurines (Annexe Musée du Vieux Nîmes),2007,LANGUEDOC-ROUSSILLON,NIMES,671,15416,16087,
Carré d'Art Musée d'Art Contemporain de Nîmes,2007,LANGUEDOC-ROUSSILLON,NIMES,13145,23877,37022,
Musée de l'Ephèbe,2007,LANGUEDOC-ROUSSILLON,LE CAP D'AGDE,10570,3893,14463,
Musée Fleury,2007,LANGUEDOC-ROUSSILLON,LODEVE,37845,12334,50179,
Musée Archéologique,2007,LANGUEDOC-ROUSSILLON,MINERVE,5248,0,5248,
Musée de Vulliod Saint-Germain,2007,LANGUEDOC-ROUSSILLON,PEZENAS,1782,0,1782,
Musée de Préhistoire Régionale et du Mégalithisme,2007,LANGUEDOC-ROUSSILLON,SAINT-PONS-DE-THOMIERES,889,165,1054,
Musée Paul Valéry,2007,LANGUEDOC-ROUSSILLON,SETE,2457,6882,9339,
Musée de Tautavel,2007,LANGUEDOC-ROUSSILLON,TAUTAVEL,70338,9874,80212,
Musée Labenche d'Art et d'Histoire,2007,LIMOUSIN,BRIVE-LA-GAILLARDE,2792,13369,16161,
Musée du Président Jacques Chirac,2007,LIMOUSIN,SARRAN,45422,4593,50015,
Musée de l'Evêché,2007,LIMOUSIN,LIMOGES,0,43360,43360,
Musée des Beaux-Arts de Nancy,2007,LORRAINE,NANCY,43370,65774,109144,
Musée Départemental de l'Ariège,2007,MIDI-PYRENEES,FOIX,82145,5746,87891,
Musée de la Préhistoire,2007,MIDI-PYRENEES,LE MAS D'AZIL,11508,0,11508,
Musée d'Archéologie,2007,MIDI-PYRENEES,MONTSEGUR,26522,0,26522,
Musée du Charroi Rural et de l'Artisanat Traditionnel,2007,MIDI-PYRENEES,SALMIECH,0,1530,1530,
Musée des jacobins,2007,MIDI-PYRENEES,AUCH,5048,5902,10950,
Musée Joseph Abeilhé,2007,MIDI-PYRENEES,MARCIAC,93,60,153,
Musée du Pays de Luchon,2007,MIDI-PYRENEES,BAGNERES-DE-LUCHON,2322,150,2472,
Musée Paul Dupuy,2007,MIDI-PYRENEES,TOULOUSE,12304,8064,20368,
Musée de Préhistoire Amédée Lémozi,2007,MIDI-PYRENEES,CABRERETS,72500,0,72500,
Musée Gallo-Romain d'Uxellodunum,2007,MIDI-PYRENEES,MARTEL,541,300,841,
Musée Toulouse Lautrec,2007,MIDI-PYRENEES,ALBI,118038,27460,145498,
Musée de Préhistoire,2007,MIDI-PYRENEES,SAINT-ANTONIN-NOBLE-VAL,945,0,945,
"Forum Antique de Bavay, Musée Archéologique du Département du Nord",2007,NORD-PAS-DE-CALAIS,BAVAY,5165,15688,20853,
Musée du Mont-de-Piété,2007,NORD-PAS-DE-CALAIS,BERGUES,850,711,1561,
Musée de la Chartreuse,2007,NORD-PAS-DE-CALAIS,DOUAI,12953,30175,43128,
"Musée de la Mine, Centre Historique Minier",2007,NORD-PAS-DE-CALAIS,LEWARDE,126826,14987,141813,
Musée d'Histoire Naturelle et de Géologie,2007,NORD-PAS-DE-CALAIS,LILLE,61860,0,61860,
Musée d'Histoire Locale de Marchiennes,2007,NORD-PAS-DE-CALAIS,MARCHIENNES,352,182,534,
Musée Municipal,2007,NORD-PAS-DE-CALAIS,SAINT-AMAND-LES-EAUX,1463,2894,4357,
Musée du Verre,2007,NORD-PAS-DE-CALAIS,SARS-POTERIES,4563,4732,9295,
Musée d'Art et d'Industrie,2007,NORD-PAS-DE-CALAIS,TOURCOING,0,15228,15228,
Musée Régional d'Ethnologie,2007,NORD-PAS-DE-CALAIS,BETHUNE,0,750,750,
Musée des Beaux-Arts et de la Dentelle,2007,NORD-PAS-DE-CALAIS,CALAIS,0,17011,17011,
Musée Quentovic,2007,NORD-PAS-DE-CALAIS,ETAPLES-SUR-MER,2124,2195,4319,
Musée d'Histoire et d'Archéologie,2007,NORD-PAS-DE-CALAIS,HARNES,0,738,738,
Musée de l'Hôtel Sandelin,2007,NORD-PAS-DE-CALAIS,SAINT-OMER,6059,5565,11624,
Musée Municipal Bruno Danvin,2007,NORD-PAS-DE-CALAIS,SAINT-POL-SUR-TERNOISE,0,2572,2572,
Musée du Débarquement,2007,BASSE-NORMANDIE,ARROMANCHES,304201,10127,314328,
Musée de la Poste et des Techniques de communication,2007,BASSE-NORMANDIE,CAEN,3578,3167,6745,
Musée de Normandie,2007,BASSE-NORMANDIE,CAEN,9200,107388,116588,
Musée d'Art et d'Histoire de Lisieux,2007,BASSE-NORMANDIE,LISIEUX,867,2206,3073,
Château de Saint-Germain de Livet,2007,BASSE-NORMANDIE,SAINT-GERMAIN DE LIVET,11189,14557,25746,
Musée des Techniques Fromagères,2007,BASSE-NORMANDIE,SAINT-PIERRE-SUR-DIVES,135,52,187,
Musée de l'Abbaye,2007,BASSE-NORMANDIE,CERISY-LA-FORET,5487,883,6370,
Musée Quesnel-Morinière,2007,BASSE-NORMANDIE,COUTANCES,444,5931,6375,
Musée des Beaux-Arts,2007,BASSE-NORMANDIE,SAINT-LO,1034,3009,4043,
Musée Barbey d'Aurevilly,2007,BASSE-NORMANDIE,SAINT-SAUVEUR-LE-VICOMTE,676,175,851,
Musée de l'Ancien Evêché,2007,HAUTE-NORMANDIE,EVREUX,3589,7326,10915,
Musée des Terres-Neuvas et de la Pêche,2007,HAUTE-NORMANDIE,FECAMP,14556,18925,33481,
Musée du Prieuré,2007,HAUTE-NORMANDIE,HARFLEUR,191,3399,3590,
Muséum d'Histoire Naturelle,2007,HAUTE-NORMANDIE,LE HAVRE,0,13787,13787,
"Juliobona, Musée Gallo-Romain de Lillebonne",2007,HAUTE-NORMANDIE,LILLEBONNE,501,1866,2367,
Musée Industriel de la Corderie Vallois,2007,HAUTE-NORMANDIE,NOTRE-DAME-DE-BONDEVILLE,2506,6989,9495,
Musée de la Céramique,2007,HAUTE-NORMANDIE,ROUEN,4802,4400,9202,
Musée du Chaume/Kerhinet - Pard Naturel Régional de Brière,2007,PAYS DE LA LOIRE,SAINT-LYPHARD,0,35772,35772,
Ecomusée de Saint-Nazaire,2007,PAYS DE LA LOIRE,SAINT-NAZAIRE,2477,89093,91570,
Musée Jean Lurcat et de la Tapisserie Contemporaine,2007,PAYS DE LA LOIRE,ANGERS,13505,33077,46582,
Musée de la Vigne et du Vin d'Anjou,2007,PAYS DE LA LOIRE,SAINT LAMBERT-DU-LATTAY - VAL-DU-LAYON,4976,1380,6356,
Musée du Vieux Château,2007,PAYS DE LA LOIRE,LAVAL,11102,17033,28135,
Musée Vert Véron-de-Forbonnais,2007,PAYS DE LA LOIRE,LE MANS,7363,9708,17071,
Centre Minier de Faymoreau,2007,PAYS DE LA LOIRE,FAYMOREAU,23465,6662,30127,
Musée Vendéen,2007,PAYS DE LA LOIRE,FONTENAY-LE-COMTE,2043,3395,5438,
Ecomusée du Marais Breton Vendéen,2007,PAYS DE LA LOIRE,LA BARRE-DE-MONTS,19581,9424,29005,
Historial de la Vendée,2007,PAYS DE LA LOIRE,LES LUCS-SUR-BOULOGNE,44536,24634,69170,
Musée de la Construction Navale Artisanale,2007,PAYS DE LA LOIRE,NOIRMOUTIER EN L'ILE,9793,444,10237,
Musée La Bourrine du Bois-Juquaud,2007,PAYS DE LA LOIRE,SAINT-HILAIRE-DE-RIEZ,12600,11208,23808,
Musée Milcendeau Jean-Yole,2007,PAYS DE LA LOIRE,SOULLANS,1486,2558,4044,
Musée municipal de Chauny,2007,PICARDIE,CHAUNY,0,2800,2800,
Musée Entomologique,2007,PICARDIE,SAINT-QUENTIN,3454,6065,9519,
Musée du Château de Compiègne,2007,PICARDIE,COMPIEGNE,35448,46420,81868,
Musée de l'Archerie et de l'Art Sacré,2007,PICARDIE,CREPY-EN-VALOIS,5963,0,5963,
Muséum d'Histoire Naturelle,2007,POITOU-CHARENTES,LA ROCHELLE,4348,6201,10549,
Hôtel Hèbre de Saint-Clément - Musée d'Art et d'Histoire,2007,POITOU-CHARENTES,ROCHEFORT,5023,20626,25649,
Musée de l'Echevinage,2007,POITOU-CHARENTES,SAINTES,6655,9310,15965,
Musée Municipal des Cordeliers,2007,POITOU-CHARENTES,SAINT-JEAN-D'ANGELY,1106,2645,3751,
Musée de l'Ile d'Oléron,2007,POITOU-CHARENTES,ST-PIERRE D'OLERON,10234,2785,13019,
"Musée de la Moto, de l'Automobile et du Vélo",2007,POITOU-CHARENTES,CHATELLERAULT,4745,6997,11742,
Collection d'Histoire Naturelle,2007,POITOU-CHARENTES,POITIERS,18627,40500,59127,
Musée de la vallée,2007,PROVENCE-ALPES-CÔTE D'AZUR,BARCELONNETTE,12129,2079,14208,
Musée Gassendi,2007,PROVENCE-ALPES-CÔTE D'AZUR,DIGNE-LES-BAINS,1998,6143,8141,
Musée de Salagon,2007,PROVENCE-ALPES-CÔTE D'AZUR,MANE,25385,5689,31074,
Musée départemental de préhistoire,2007,PROVENCE-ALPES-CÔTE D'AZUR,QUINSON,59101,7905,67006,
Musée de la Mer,2007,PROVENCE-ALPES-CÔTE D'AZUR,CANNES,50334,36301,86635,
Musée des Beaux-Arts,2007,PROVENCE-ALPES-CÔTE D'AZUR,MENTON,0,18379,18379,
Musée de Préhistoire Régionale,2007,PROVENCE-ALPES-CÔTE D'AZUR,MENTON,0,7676,7676,
Musée Archéologique - Site de  Cimiez,2007,PROVENCE-ALPES-CÔTE D'AZUR,NICE,8857,18929,27786,
Musée d'Art Naïf Anatole Jakovsky,2007,PROVENCE-ALPES-CÔTE D'AZUR,NICE,3538,18690,22228,
Musée National Message Biblique Marc Chagall,2007,PROVENCE-ALPES-CÔTE D'AZUR,NICE,121555,46706,168261,
Musée des Beaux-Arts Jules Chéret,2007,PROVENCE-ALPES-CÔTE D'AZUR,NICE,15841,27865,43706,
Musée des Tapisseries,2007,PROVENCE-ALPES-CÔTE D'AZUR,AIX-EN-PROVENCE,6647,17476,24123,
Musée Granet,2007,PROVENCE-ALPES-CÔTE D'AZUR,AIX-EN-PROVENCE,30957,40310,71267,
Musée Municipal Méditerranéen de Cassis A.T.P.,2007,PROVENCE-ALPES-CÔTE D'AZUR,CASSIS,101,4300,4401,
Musée des Docks Romains,2007,PROVENCE-ALPES-CÔTE D'AZUR,MARSEILLE,2500,2000,4500,
"Musée d'Arts Africains, Océaniens, Amérindiens",2007,PROVENCE-ALPES-CÔTE D'AZUR,MARSEILLE,6171,9395,15566,
Musée Ziem,2007,PROVENCE-ALPES-CÔTE D'AZUR,MARTIGUES,0,10269,10269,
Musée de l'Annonciade,2007,PROVENCE-ALPES-CÔTE D'AZUR,SAINT-TROPEZ,58569,11529,70098,
Musée d'Apt,2007,PROVENCE-ALPES-CÔTE D'AZUR,APT,5581,3433,9014,
Muséum d'Histoire Naturelle Esprit Requien,2007,PROVENCE-ALPES-CÔTE D'AZUR,AVIGNON,0,17270,17270,
Musée Calvet (et musée Lapidaire),2007,PROVENCE-ALPES-CÔTE D'AZUR,AVIGNON,21367,13506,34873,
Musée Municipal,2007,PROVENCE-ALPES-CÔTE D'AZUR,ORANGE,53399,0,53399,
Musée Archéologique,2007,RHONE-ALPES,IZERNORE,246,106,352,
Château de Grignan,2007,RHONE-ALPES,GRIGNAN,50469,56845,107314,
Musée International de la Chaussure,2007,RHONE-ALPES,ROMANS,19649,17708,37357,
Musée-château d'Annecy,2007,RHONE-ALPES,ANNECY,46300,40811,87111,
Musée d'Huez et de l'Oisans,2007,RHONE-ALPES,ALPE D'HUEZ,3328,510,3838,
Muséum d'Histoire Naturelle de Grenoble,2007,RHONE-ALPES,GRENOBLE,14377,84071,98448,
Musée Dauphinois,2007,RHONE-ALPES,GRENOBLE,0,43109,43109,
Maison du Patrimoine de Hières-sur-Amby,2007,RHONE-ALPES,HIERES SUR AMBY,7794,421,8215,
Musée Lapidaire Saint-Pierre,2007,RHONE-ALPES,VIENNE,2255,4295,6550,
Musée des Beaux-Arts et d'Archéologie,2007,RHONE-ALPES,VIENNE,1186,1887,3073,
Musée Alice Taverne,2007,RHONE-ALPES,AMBIERLE,3583,666,4249,
Musée d'Histoire du  20ème Siècle - Résistance et Déportation,2007,RHONE-ALPES,ESTIVAREILLES,2724,532,3256,
Musée de la Diana,2007,RHONE-ALPES,MONTBRISON,3749,0,3749,
Muséum d'Histoire Naturelle,2007,RHONE-ALPES,LYON,12464,24886,37350,
Musée des Beaux-Arts,2007,RHONE-ALPES,CHAMBERY,1328,12144,13472,
Musée de la Chartreuse,2008,ALSACE,MOLSHEIM,3897,158,4055,
Musée de l'Œuvre Notre-Dame,2008,ALSACE,STRASBOURG,25107,33853,58960,
Musée Alsacien,2008,ALSACE,STRASBOURG,10971,10604,21575,
Musée du Vignoble et des Vins d'Alsace,2008,ALSACE,KAYSERSBERG VIGNOBLE,4703,0,4703,
Cité du Train,2008,ALSACE,MULHOUSE,57949,29169,87118,
Musée des Amis de Thann,2008,ALSACE,THANN,886,4921,5807,
Musée des Arts et Traditions Populaires du Périgord,2008,AQUITAINE,MUSSIDAN,1127,1368,2495,
Musée d'Art et d'Archéologie du Périgord (MAAP),2008,AQUITAINE,PERIGUEUX,4178,20283,24461,
Musée d'Art et Traditions Populaires,2008,AQUITAINE,VILLEFRANCHE-DE-LONCHAT,0,1530,1530,
Musée de la Voiture à Cheval,2008,AQUITAINE,BOURG-SUR-GIRONDE,2665,1251,3916,
Musée des Beaux-Arts et d'Archéologie,2008,AQUITAINE,LIBOURNE,0,5849,5849,
Musée Municipal Albert Marzelles,2008,AQUITAINE,MARMANDE,0,6676,6676,
Musée Municipal (Moulin de Gajac),2008,AQUITAINE,VILLENEUVE-SUR-LOT,4589,5755,10344,
Musée Edmond Rostand,2008,AQUITAINE,CAMBO-LES-BAINS,60762,2163,62925,
Musée National du Château,2008,AQUITAINE,PAU,43184,79599,122783,
Musée Municipal des Beaux-Arts,2008,AQUITAINE,PAU,9745,13179,22924,
Musée Rural de la Sologne Bourbonnaise,2008,AUVERGNE,BEAULON,100,200,300,
Musée des Musiques Populaires - MuPop,2008,AUVERGNE,MONTLUCON,1124,6054,7178,
Musée d'Archéologie Bargoin,2008,AUVERGNE,CLERMONT-FERRAND,4118,11950,16068,
Muséum d'Histoire Naturelle Henri-Lecoq,2008,AUVERGNE,CLERMONT-FERRAND,2837,24916,27753,
Musée Régional d'Auvergne,2008,AUVERGNE,RIOM,962,2570,3532,
"Musée de la Vie Bourguignonne, Perrin de Puycousin",2008,BOURGOGNE,DIJON,0,37105,37105,
Musée de la Mine,2008,BOURGOGNE,LA MACHINE,5608,1260,6868,
Musée du Prieuré de Charolles,2008,BOURGOGNE,CHAROLLES,1335,1487,2822,
Musée Lamartine,2008,BOURGOGNE,MACON,1010,3926,4936,
Musée Eucharistique du Hiéron,2008,BOURGOGNE,PARAY-LE-MONIAL,4453,3164,7617,
Musée Leblanc-Duvernois,2008,BOURGOGNE,AUXERRE,904,1386,2290,
Musée Zervos - Maison Romain Rolland,2008,BOURGOGNE,VEZELAY,10159,2841,13000,
Ecomusée des Monts d'Arrée - Moulins de Kerouat,2008,BRETAGNE,COMMANA,10590,3886,14476,
Musée de la Pêche,2008,BRETAGNE,CONCARNEAU,30304,3540,33844,
Musée de la Faucillonnaie,2008,BRETAGNE,MONTREUIL-SOUS-PEROUSE,802,490,1292,
Musée National de la Marine,2008,BRETAGNE,PORT-LOUIS,39046,18932,57978,
Musée de la Résistance Bretonne,2008,BRETAGNE,SAINT-MARCEL - MALESTROIT,23572,2699,26271,
Musée du Château de Suscinio,2008,BRETAGNE,SARZEAU,75300,16303,91603,
Muséum des Sciences Naturelles et de Préhistoire,2008,CENTRE,CHARTRES,0,15776,15776,
Musée Archéologique d'Argentomagus,2008,CENTRE,SAINT-MARCEL,9300,7940,17240,
Musée du Savignéen,2008,CENTRE,SAVIGNE-SUR-LATHAN,1593,215,1808,
Musée du Compagnonnage,2008,CENTRE,TOURS,34295,13369,47664,
Musée des Beaux-Arts,2008,CENTRE,TOURS,22799,41149,63948,
Muséum d'Histoire Naturelle,2008,CENTRE,BLOIS,3990,9065,13055,
Musée Archéologique,2008,CENTRE,THESEE,966,205,1171,
Musée de Vendôme,2008,CENTRE,VENDOME,1532,7332,8864,
Musée Gaston Couté,2008,CENTRE,MEUNG-SUR-LOIRE,0,3174,3174,
Musée de la Maison de la Dernière Cartouche,2008,CHAMPAGNE-ARDENNES,BAZEILLES,1504,1388,2892,
Musée Arthur Rimbaud,2008,CHAMPAGNE-ARDENNES,CHARLEVILLE-MEZIERES,10022,8557,18579,
Musée de la Résistance,2008,CHAMPAGNE-ARDENNES,MUSSY-SUR-SEINE,175,501,676,
Musée Vauluisant - Musée de la Bonneterie,2008,CHAMPAGNE-ARDENNES,TROYES,3607,6717,10324,
Musée des Beaux-Arts et d'Archéologie,2008,CHAMPAGNE-ARDENNES,CHAUMONT,758,4294,5052,
Musée Napoléonien,2008,CORSE,AJACCIO,8042,4665,12707,
Musée de la Maison Bonaparte,2008,CORSE,AJACCIO,47653,11891,59544,
Musée de Plein Air des Maisons Comtoises,2008,FRANCHE-COMTE,NANCRAY,29130,6766,35896,
Musée-Maison Natale Gustave Courbet,2008,FRANCHE-COMTE,ORNANS,1548,2338,3886,
Musée Départemental de la Montagne Albert Demard,2008,FRANCHE-COMTE,LE HAUT-DU-THEM,4170,3549,7719,
Musée du Jouet,2008,FRANCHE-COMTE,MOIRANS-EN-MONTAGNE,19373,1019,20392,
Musée de l'Abbaye/Donations Guy Bardone - René Genis,2008,FRANCHE-COMTE,SAINT-CLAUDE,1645,3173,4818,
Musée Territorial Alexandre Franconie,2008,GUYANE,CAYENNE,2613,6231,8844,
Musée Municipal Robert Dubois-Corneau,2008,ILE-DE-FRANCE,BRUNOY,464,3697,4161,
Musée des Années Trente,2008,ILE-DE-FRANCE,BOULOGNE-BILLANCOURT,12605,15737,28342,
Musée Roybet Fould,2008,ILE-DE-FRANCE,COURBEVOIE,0,11027,11027,
Musée d'Art et d'Histoire,2008,ILE-DE-FRANCE,MEUDON,0,10372,10372,
Musée - Atelier Rodin (Annexe du musée de Paris),2008,ILE-DE-FRANCE,MEUDON,3256,4077,7333,
Musée de l'Île-de-France,2008,ILE-DE-FRANCE,SCEAUX,0,87700,87700,
Maison de Victor Hugo,2008,ILE-DE-FRANCE,PARIS,13599,120690,134289,
"Petit Palais, Musée des Beaux-Arts de la ville de Paris",2008,ILE-DE-FRANCE,PARIS,127006,453272,580278,
Maison de Balzac,2008,ILE-DE-FRANCE,PARIS,759,20698,21457,
Etablissement public du musée d'Orsay,2008,ILE-DE-FRANCE,PARIS,1897635,1127529,3025164,
Musée d'Art Moderne de la ville de Paris,2008,ILE-DE-FRANCE,PARIS,261350,570738,832088,
Musée de la Chasse et de la Nature,2008,ILE-DE-FRANCE,PARIS,22695,18114,40809,
Musée Nissim de Camondo (UCAD),2008,ILE-DE-FRANCE,PARIS,32326,9995,42321,
Musée d'Art et d'Histoire du Judaïsme,2008,ILE-DE-FRANCE,PARIS,67160,32949,100109,
Musée National d'Art Moderne (Centre National d'Art et de Culture Georges Pompidou),2008,ILE-DE-FRANCE,PARIS,2850490,0,2850490,
Musée de la Poste,2008,ILE-DE-FRANCE,PARIS,18033,42286,60319,
Musée Municipal,2008,ILE-DE-FRANCE,MORET-SUR-LOING,0,5154,5154,
Musée départemental Stéphane Mallarmé,2008,ILE-DE-FRANCE,VULAINES-SUR-SEINE,3948,2259,6207,
Musée d'Art et d'Histoire Louis Senlecq,2008,ILE-DE-FRANCE,L'ISLE-ADAM,776,6927,7703,
Musée Intercommunal d'Histoire et d'Archéologie de Louvres,2008,ILE-DE-FRANCE,ROISSY-EN-FRANCE,40,1610,1650,
Musée de la Toile de Jouy,2008,ILE-DE-FRANCE,JOUY-EN-JOSAS,8827,2034,10861,
Musée-Maison Maurice Ravel,2008,ILE-DE-FRANCE,MONTFORT-L'AMAURY,3750,0,3750,
Muséum Agricole et Industriel Stella Matutina,2008,LA REUNION,PITON-SAINT-LEU,33888,5752,39640,
Musée Départemental de la Réunion - Musée Léon Dierx,2008,LA REUNION,SAINT-DENIS,2633,13863,16496,
Musée Historique de Villèle,2008,LA REUNION,SAINT-GILLES-LES-HAUTS,11383,12196,23579,
Musée des Arts Décoratifs de l’Océan indien (MADOI),2008,LA REUNION,SAINT-LOUIS,0,3417,3417,
Musée Petiet,2008,LANGUEDOC-ROUSSILLON,LIMOUX,1251,1510,2761,
Musée Municipal de la Vignasse,2008,LANGUEDOC-ROUSSILLON,BEAUCAIRE,529,1916,2445,
Musée Archéologique,2008,LANGUEDOC-ROUSSILLON,NIMES,0,79206,79206,
Musée des Beaux-Arts,2008,LANGUEDOC-ROUSSILLON,NIMES,2239,15430,17669,
Musée Pierre de Luxembourg,2008,LANGUEDOC-ROUSSILLON,VILLENEUVE-LES-AVIGNON,4228,2553,6781,
Musée Agathois,2008,LANGUEDOC-ROUSSILLON,AGDE,3001,2128,5129,
Musée de l'Etang de Thau,2008,LANGUEDOC-ROUSSILLON,BOUZIGUES,17016,0,17016,
Musée de Préhistoire Régionale et du Mégalithisme,2008,LANGUEDOC-ROUSSILLON,SAINT-PONS-DE-THOMIERES,2423,1870,4293,
Musée de la Mémoire et des Industries Tullistes,2008,LIMOUSIN,TULLE,0,3432,3432,
Musée d'Art et d'Histoire de Toul,2008,LORRAINE,TOUL,2448,3317,5765,
Musée Jules Bastien-Lepage - Musée de la Fortification,2008,LORRAINE,MONTMEDY,13607,1711,15318,
Musée Départemental Raymond Poincaré,2008,LORRAINE,SAMPIGNY,573,141,714,
Musée Départemental du Sel,2008,LORRAINE,MARSAL,4973,5566,10539,
Musée Militaire et Erckmann-Chatrian,2008,LORRAINE,PHALSBOURG,792,129,921,
Musée du Pays de Sarrebourg,2008,LORRAINE,SARREBOURG,4369,5716,10085,
"Jardin d'Hiver, Musée de La Faïence",2008,LORRAINE,SARREGUEMINES,6421,4070,10491,
La Tour aux Puces - Musée du Pays Thionvillois,2008,LORRAINE,THIONVILLE,2950,7553,10503,
Musée Louis Français,2008,LORRAINE,PLOMBIERES-LES-BAINS,451,394,845,
Musée Départemental d'Archéologie Précolombienne et de Préhistoire de la Martinique,2008,MARTINIQUE,FORT-DE-FRANCE,4771,2448,7219,
Musée des Beaux-Arts Denys Puech,2008,MIDI-PYRENEES,RODEZ,1457,11878,13335,
Musée des Beaux-Arts et des Arts Décoratifs,2008,MIDI-PYRENEES,MIRANDE,602,382,984,
Musée Municipal d'Art et d'Histoire,2008,MIDI-PYRENEES,SAINT-GAUDENS,496,1303,1799,
Musée du Vieux Toulouse,2008,MIDI-PYRENEES,TOULOUSE,2982,253,3235,
Muséum d'Histoire Naturelle,2008,MIDI-PYRENEES,BAGNERES-DE-BIGORRE,2151,52,2203,
Musée Salies,2008,MIDI-PYRENEES,BAGNERES-DE-BIGORRE,4033,110,4143,
Musée Pyrénéen,2008,MIDI-PYRENEES,LOURDES,84375,3772,88147,
Musée-château Gaston Phébus,2008,MIDI-PYRENEES,MAUVEZIN,23641,3000,26641,
Musée Henri Martin,2008,MIDI-PYRENEES,CAHORS,3729,9150,12879,
Musée Murat,2008,MIDI-PYRENEES,CŒUR DE CAUSSE,646,21,667,
Musée du Vieux Figeac,2008,MIDI-PYRENEES,FIGEAC,676,468,1144,
Musée Gallo-Romain d'Uxellodunum,2008,MIDI-PYRENEES,MARTEL,341,357,698,
Musée Jean Jaurès,2008,MIDI-PYRENEES,CASTRES,1437,10160,11597,
Musée du Pays Vaurais,2008,MIDI-PYRENEES,LAVAUR,1350,680,2030,
Musée Raymond Lafage,2008,MIDI-PYRENEES,LISLE-SUR-TARN,1976,3082,5058,
Musée d'Histoire Naturelle Victor Brun,2008,MIDI-PYRENEES,MONTAUBAN,1730,6709,8439,
Musée de Préhistoire,2008,MIDI-PYRENEES,SAINT-ANTONIN-NOBLE-VAL,577,325,902,
Musée Théophile Jouglet,2008,NORD-PAS-DE-CALAIS,ANZIN,0,1575,1575,
Musée de l'Ostrevant,2008,NORD-PAS-DE-CALAIS,BOUCHAIN,307,417,724,
Musée d'Archéologie et d'Histoire Locale,2008,NORD-PAS-DE-CALAIS,DENAIN,0,3400,3400,
Musée de la Chartreuse,2008,NORD-PAS-DE-CALAIS,DOUAI,14392,42021,56413,
Lieu d'Art et Action Contemporaine de Dunkerque - LAAC,2008,NORD-PAS-DE-CALAIS,DUNKERQUE,24837,0,24837,
Musée Portuaire,2008,NORD-PAS-DE-CALAIS,DUNKERQUE,29636,22473,52109,
Musée du Dessin et de l'Estampe Originale,2008,NORD-PAS-DE-CALAIS,GRAVELINES,1460,8121,9581,
Musée Municipal d'Hazebrouck,2008,NORD-PAS-DE-CALAIS,HAZEBROUCK,600,3835,4435,
Musée du Verre,2008,NORD-PAS-DE-CALAIS,SARS-POTERIES,4001,4543,8544,
Musée des Beaux-Arts,2008,NORD-PAS-DE-CALAIS,ARRAS,8612,21026,29638,
Musée Municipal,2008,NORD-PAS-DE-CALAIS,LE TOUQUET-PARIS-PLAGE,7897,4138,12035,
Musée du Château,2008,BASSE-NORMANDIE,PONTECOULANT,7254,0,7254,
Musée du Vieux Château,2008,BASSE-NORMANDIE,BRICQUEBEC-EN-COTENTIN,479,309,788,
Musée de la Guerre et de la Libération,2008,BASSE-NORMANDIE,CHERBOURG-EN-COTENTIN,4693,9298,13991,
Muséum Emmanuel Liais,2008,BASSE-NORMANDIE,CHERBOURG-EN-COTENTIN,0,22524,22524,
"Musée du Bocage Normand, ferme du bois Jugan",2008,BASSE-NORMANDIE,SAINT-LO,3206,2721,5927,
Musée du Granit,2008,BASSE-NORMANDIE,SAINT-MICHEL-DE-MONTJOIE,1929,400,2329,
Musée Municipal d'Archéologie,2008,BASSE-NORMANDIE,L'AIGLE,725,423,1148,
Musée Alphonse-Georges Poulain,2008,HAUTE-NORMANDIE,VERNON,1727,8025,9752,
Pavillon Flaubert,2008,HAUTE-NORMANDIE,CANTELEU,0,533,533,
Abbaye de Graville - Musée du Prieuré de Graville,2008,HAUTE-NORMANDIE,LE HAVRE,3700,4989,8689,
Ecomusée de la Basse-Seine,2008,HAUTE-NORMANDIE,NOTRE-DAME-DE-BLIQUETUIT,19367,4500,23867,
Association de l'Horlogerie Aliermontaise,2008,HAUTE-NORMANDIE,SAINT-NICOLAS-D'ALIERMONT,4004,1226,5230,
Musée du Pays de Retz,2008,PAYS DE LA LOIRE,BOURGNEUF-EN-RETZ,6334,835,7169,
Musée du Pays de Guérande et de la Porte Saint Michel,2008,PAYS DE LA LOIRE,GUERANDE,17139,6352,23491,
Musée  Départemental Dobrée,2008,PAYS DE LA LOIRE,NANTES,5566,36442,42008,
Musée Jean Lurcat et de la Tapisserie Contemporaine,2008,PAYS DE LA LOIRE,ANGERS,13370,32487,45857,
Musée du Textile,2008,PAYS DE LA LOIRE,CHOLET,5503,9047,14550,
Château-Musée,2008,PAYS DE LA LOIRE,SAUMUR,34032,11039,45071,
Musée de Tessé,2008,PAYS DE LA LOIRE,LE MANS,18239,12375,30614,
Musée de la Reine Bérengère,2008,PAYS DE LA LOIRE,LE MANS,3101,4467,7568,
Musée Vendéen,2008,PAYS DE LA LOIRE,FONTENAY-LE-COMTE,2106,4826,6932,
Musée des Traditions de l'Île,2008,PAYS DE LA LOIRE,LA GUERINIERE,4675,236,4911,
Musée ornithologique Charles-Payraudeau,2008,PAYS DE LA LOIRE,LA-CHAIZE-LE-VICOMTE,0,682,682,
Historial de la Vendée,2008,PAYS DE LA LOIRE,LES LUCS-SUR-BOULOGNE,32880,20618,53498,
Musée de l'Abbaye de Sainte-Croix,2008,PAYS DE LA LOIRE,LES SABLES D'OLONNE,12601,16434,29035,
Musée Jean de la Fontaine,2008,PICARDIE,CHATEAU-THIERRY,7354,3552,10906,
Musée - Centre de Documentation Alfred Desmasures,2008,PICARDIE,HIRSON,0,902,902,
Musée Antoine Vivenel,2008,PICARDIE,COMPIEGNE,0,17372,17372,
Musée Gallé-Juillet,2008,PICARDIE,CREIL,1665,4300,5965,
Musée de l'Archerie et de l'Art Sacré,2008,PICARDIE,CREPY-EN-VALOIS,2803,2736,5539,
Musée de Picardie,2008,PICARDIE,AMIENS,9553,35938,45491,
Musée des Beaux-Arts,2008,POITOU-CHARENTES,ANGOULEME,0,50111,50111,
Musée du Nouveau Monde,2008,POITOU-CHARENTES,LA ROCHELLE,4479,8270,12749,
Musée des Beaux-Arts,2008,POITOU-CHARENTES,LA ROCHELLE,1855,6334,8189,
Musée National de la Marine,2008,POITOU-CHARENTES,ROCHEFORT,11927,9404,21331,
Musée départemental de préhistoire,2008,PROVENCE-ALPES-CÔTE D'AZUR,QUINSON,54354,8121,62475,
Musée Picasso,2008,PROVENCE-ALPES-CÔTE D'AZUR,ANTIBES,71669,27854,99523,
Musée d'Histoire et d'Archéologie,2008,PROVENCE-ALPES-CÔTE D'AZUR,ANTIBES,4116,6429,10545,
Musée Fernand Léger,2008,PROVENCE-ALPES-CÔTE D'AZUR,BIOT,18796,13261,32057,
Musée Archéologique - Site de  Cimiez,2008,PROVENCE-ALPES-CÔTE D'AZUR,NICE,4201,28434,32635,
Musée des Beaux-Arts Jules Chéret,2008,PROVENCE-ALPES-CÔTE D'AZUR,NICE,7801,44902,52703,
Musée du Palais Lascaris,2008,PROVENCE-ALPES-CÔTE D'AZUR,NICE,0,78804,78804,
Musée d'Art Moderne et d'Art Contemporain,2008,PROVENCE-ALPES-CÔTE D'AZUR,NICE,21330,136340,157670,
Musée Départemental des Merveilles,2008,PROVENCE-ALPES-CÔTE D'AZUR,TENDE,0,34323,34323,
Musées de la Citadelle,2008,PROVENCE-ALPES-CÔTE D'AZUR,VILLEFRANCHE-SUR-MER,0,37507,37507,
Musée Granet,2008,PROVENCE-ALPES-CÔTE D'AZUR,AIX-EN-PROVENCE,60629,38316,98945,
Muséon Arlaten,2008,PROVENCE-ALPES-CÔTE D'AZUR,ARLES,21359,41077,62436,
Musée d'Archéologie Méditerranéenne,2008,PROVENCE-ALPES-CÔTE D'AZUR,MARSEILLE,8973,11284,20257,
Musée Cantini,2008,PROVENCE-ALPES-CÔTE D'AZUR,MARSEILLE,9846,17008,26854,
Muséum d'Histoire Naturelle,2008,PROVENCE-ALPES-CÔTE D'AZUR,MARSEILLE,6240,25989,32229,
Musée Grobet-Labadié,2008,PROVENCE-ALPES-CÔTE D'AZUR,MARSEILLE,2430,5400,7830,
Musée Ziem,2008,PROVENCE-ALPES-CÔTE D'AZUR,MARTIGUES,0,13103,13103,
Musée Suffren et du Vieux Saint-Cannat,2008,PROVENCE-ALPES-CÔTE D'AZUR,SAINT-CANNAT,0,5038,5038,
Musée des Arts et d’Histoire,2008,PROVENCE-ALPES-CÔTE D'AZUR,BORMES-LES-MIMOSAS,0,7884,7884,
Musée Archéologique Gallo-Romaine du Var,2008,PROVENCE-ALPES-CÔTE D'AZUR,FREJUS,4388,6726,11114,
Musée Archéologique,2008,PROVENCE-ALPES-CÔTE D'AZUR,SAINT-RAPHAËL,0,17844,17844,
Musée Calvet (et musée Lapidaire),2008,PROVENCE-ALPES-CÔTE D'AZUR,AVIGNON,19516,13309,32825,
Synagogue Musée Juif Comtadin,2008,PROVENCE-ALPES-CÔTE D'AZUR,CAVAILLON,3891,5802,9693,
Musée-Bibliothèque François Pétrarque,2008,PROVENCE-ALPES-CÔTE D'AZUR,FONTAINE-DE-VAUCLUSE,2879,1532,4411,
Musée Municipal,2008,PROVENCE-ALPES-CÔTE D'AZUR,SAULT,0,1557,1557,
Musée Archéologique Théo Desplans,2008,PROVENCE-ALPES-CÔTE D'AZUR,VAISON-LA-ROMAINE,70916,4455,75371,
Musée du Brou,2008,RHONE-ALPES,BOURG-EN-BRESSE,43761,16725,60486,
Musée Archéologique,2008,RHONE-ALPES,IZERNORE,329,86,415,
Musée de la Résistance et de la Déportation de l'Ain,2008,RHONE-ALPES,NANTUA,6190,3584,9774,
Musée Chintreuil,2008,RHONE-ALPES,PONT-DE-VAUX,6343,258,6601,
Musée Vivarois César Filhol,2008,RHONE-ALPES,ANNONAY,826,3064,3890,
Musée du Rhône,2008,RHONE-ALPES,TOURNON-SUR-RHÔNE,5590,3742,9332,
Château de Grignan,2008,RHONE-ALPES,GRIGNAN,72998,42930,115928,
Musée du Château des Adhémars,2008,RHONE-ALPES,MONTELIMAR,14224,0,14224,
Musée d'Art Sacré,2008,RHONE-ALPES,MOURS SAINT-EUSEBE,2623,0,2623,
Musée des Beaux-Arts,2008,RHONE-ALPES,VALENCE,2299,8641,10940,
Musée du site Préhistorique,2008,RHONE-ALPES,VASSIEUX-EN-VERCORS,3001,642,3643,
Musée de Bourgoin-Jallieu,2008,RHONE-ALPES,BOURGOIN-JALLIEU,2081,6600,8681,
Musée Alice Taverne,2008,RHONE-ALPES,AMBIERLE,4853,846,5699,
Musées Gadagne,2008,RHONE-ALPES,LYON,24107,0,24107,
Musée d'Art Contemporain de Lyon,2008,RHONE-ALPES,LYON,110435,116007,226442,
Musée de la Folie Marco,2009,ALSACE,BARR,1893,1929,3822,
Musée de la Chartreuse,2009,ALSACE,MOLSHEIM,3736,1440,5176,
Musée de l'Image Populaire de Pfaffenhoffen,2009,ALSACE,PFAFFENHOFFEN,1433,994,2427,
Musée Historique,2009,ALSACE,STRASBOURG,11961,25600,37561,
Musée Alsacien,2009,ALSACE,STRASBOURG,24232,32856,57088,
Cabinet des Estampes et des Dessins,2009,ALSACE,STRASBOURG,0,121,121,
Musée d'Unterlinden,2009,ALSACE,COLMAR,164286,28244,192530,
Musée Théodore Deck et des Pays du Florival,2009,ALSACE,GUEBWILLER,2358,3386,5744,
Musée des Beaux-Arts,2009,ALSACE,MULHOUSE,0,17949,17949,
Musée Historique,2009,ALSACE,MULHOUSE,0,35793,35793,
Musée National de l'Automobile - Collection Schlumpf,2009,ALSACE,MULHOUSE,162502,49841,212343,
Musée Vauban,2009,ALSACE,NEUF-BRISACH,3018,207,3225,
Ecomusée d'Alsace,2009,ALSACE,UNGERSHEIM,151620,15100,166720,
Musée du Tabac,2009,AQUITAINE,BERGERAC,3060,1567,4627,
Musée d'Art et d'Archéologie du Périgord (MAAP),2009,AQUITAINE,PERIGUEUX,4942,18818,23760,
Musée du Site Médiéval,2009,AQUITAINE,SAINT-AVIT-SENIEUR,882,0,882,
Musée des Arts Décoratifs,2009,AQUITAINE,BORDEAUX,2127,32969,35096,
CAPC Musée d'Art Contemporain de Bordeaux,2009,AQUITAINE,BORDEAUX,27127,88649,115776,
Centre National Jean Moulin,2009,AQUITAINE,BORDEAUX,0,23887,23887,
Musée de la Faïence et des arts de la table,2009,AQUITAINE,SAMADET,2589,3610,6199,
Musée de Préhistoire Mésolithique Laurent Coulonges,2009,AQUITAINE,SAUVETERRE-LA-LEMANCE,1780,451,2231,
Musée Municipal,2009,AQUITAINE,ARUDY,1148,826,1974,
Musée Bonnat,2009,AQUITAINE,BAYONNE,10476,11963,22439,
Musée Municipal de Guéthary,2009,AQUITAINE,GUETHARY,632,1176,1808,
Musée Municipal des Beaux-Arts,2009,AQUITAINE,PAU,9833,13390,23223,
Musée de la Haute Auvergne,2009,AUVERGNE,SAINT-FLOUR,2321,2092,4413,
Musée de Paléontologie,2009,AUVERGNE,CHILHAC,1299,0,1299,
Musée Crozatier,2009,AUVERGNE,LE PUY-EN-VELAY,0,18348,18348,
Musée Départemental de la Céramique Gallo-Romaine,2009,AUVERGNE,LEZOUX,9775,4565,14340,
Musée Paléontologique,2009,AUVERGNE,MENAT,565,213,778,
Musée d'Art Sacré,2009,BOURGOGNE,DIJON,0,6593,6593,
Musée Magnin,2009,BOURGOGNE,DIJON,5143,9694,14837,
Musée du Costume,2009,BOURGOGNE,CHATEAU-CHINON,4865,987,5852,
Musée du Grès de Puisaye,2009,BOURGOGNE,SAINT-AMAND-EN-PUISAYE,2607,0,2607,
Ecomusée de la Communauté Le Creusot-Monceau-Les-Mines,2009,BOURGOGNE,LE CREUSOT,11874,2784,14658,
Musée Lamartine,2009,BOURGOGNE,MACON,1341,3017,4358,
Musée Départemental du Compagnonnage,2009,BOURGOGNE,ROMANECHE-THORINS,2187,1662,3849,
Maison du Blé et du Pain,2009,BOURGOGNE,VERDUN-SUR-LE-DOUBS,2834,1007,3841,
Muséum - Maison de l'Eau,2009,BOURGOGNE,AUXERRE,0,13405,13405,
Musée d'Art et d'Histoire,2009,BOURGOGNE,AUXERRE,8802,20860,29662,
Musée des Beaux-Arts de Brest,2009,BRETAGNE,BREST,3148,16999,20147,
Musée National de la Marine,2009,BRETAGNE,BREST,30406,41838,72244,
Ecomusée des Monts d'Arrée - Moulins de Kerouat,2009,BRETAGNE,COMMANA,10360,2259,12619,
Le Port-Musée,2009,BRETAGNE,DOUARNENEZ,34784,9873,44657,
Musée de la Faucillonnaie,2009,BRETAGNE,MONTREUIL-SOUS-PEROUSE,964,410,1374,
Musée des Beaux-Arts,2009,BRETAGNE,RENNES,11730,23416,35146,
Musée de Bretagne,2009,BRETAGNE,RENNES,55056,13887,68943,
Musée d'Histoire de la Ville de Saint-Malo,2009,BRETAGNE,SAINT-MALO,18970,7600,26570,
Musée des Rochers-Sévigné,2009,BRETAGNE,VITRE,5640,2384,8024,
Musée du Château de Vitré,2009,BRETAGNE,VITRE,13735,7628,21363,
Musée de Préhistoire J. Miln- Z. Le-Rouzic,2009,BRETAGNE,CARNAC,24526,5510,30036,
Ecomusée de l'Île de Groix,2009,BRETAGNE,ILE DE GROIX,6231,940,7171,
Musée de la Résistance Bretonne,2009,BRETAGNE,SAINT-MARCEL - MALESTROIT,22378,3911,26289,
Musée d'Histoire et d'Archéologie de Vannes,2009,BRETAGNE,VANNES,2368,2903,5271,
Musée des Meilleurs Ouvriers de France,2009,CENTRE,BOURGES,0,23818,23818,
Musée du Château Charles VII,2009,CENTRE,MEHUN-SUR-YEVRE,7161,2200,9361,
Musée d'Art et d'Histoire de Dreux,2009,CENTRE,DREUX,1370,6502,7872,
Musée de l'Hospice Saint-Roch,2009,CENTRE,ISSOUDUN,120,20597,20717,
Musée George Sand et de la Vallée Noire,2009,CENTRE,LA CHATRE,2572,1614,4186,
Musée du Vieux Chinon,2009,CENTRE,CHINON,1030,830,1860,
Musée François Rabelais,2009,CENTRE,SEUILLY,8239,3858,12097,
Musée des Vins de Touraine,2009,CENTRE,TOURS,1220,900,2120,
Musée Archéologique,2009,CENTRE,THESEE,648,254,902,
Musée des Sciences Naturelles,2009,CENTRE,ORLEANS,7304,52792,60096,
Musée des Beaux-Arts et d'Archéologie,2009,CHAMPAGNE-ARDENNES,CHAUMONT,660,1757,2417,
Musée de la Coutellerie,2009,CHAMPAGNE-ARDENNES,NOGENT,4649,2535,7184,
Musée Hôtel le Vergeur,2009,CHAMPAGNE-ARDENNES,REIMS,8936,5556,14492,
Musée des Beaux-Arts de Saint-Denis,2009,CHAMPAGNE-ARDENNES,REIMS,23281,38157,61438,
Musée de la Maison Bonaparte,2009,CORSE,AJACCIO,45803,17094,62897,
Musée d'archéologie d'Aleria - Jérôme Carcopino,2009,CORSE,ALERIA,30231,21326,51557,
Musée du Temps,2009,FRANCHE-COMTE,BESANCON,7183,28821,36004,
Musée Beurnier-Rossel,2009,FRANCHE-COMTE,MONTBELIARD,985,2693,3678,
Musée de Plein Air des Maisons Comtoises,2009,FRANCHE-COMTE,NANCRAY,30750,8201,38951,
Musée de la Vigne et du Vin,2009,FRANCHE-COMTE,ARBOIS,2973,728,3701,
Musée de l'Abbaye/Donations Guy Bardone - René Genis,2009,FRANCHE-COMTE,SAINT-CLAUDE,6905,6950,13855,
Musée d'Art et d'Histoire,2009,FRANCHE-COMTE,BELFORT,4257,16226,20483,
Donation Maurice Jardot,2009,FRANCHE-COMTE,BELFORT,1148,3215,4363,
Musée Précolombien Edgar Clerc,2009,GUADELOUPE,LE MOULE,0,6035,6035,
Musée Départemental Victor Schoelcher,2009,GUADELOUPE,POINTE-A-PITRE,3130,1192,4322,
Ecomusée Municipal d'Approuague-Kaw,2009,GUYANE,REGINA,2180,3593,5773,
Musée Municipal Robert Dubois-Corneau,2009,ILE-DE-FRANCE,BRUNOY,165,4214,4379,
Musée Intercommunal d'Etampes,2009,ILE-DE-FRANCE,ETAMPES,1624,9722,11346,
Musée Départemental Albert-Kahn,2009,ILE-DE-FRANCE,BOULOGNE-BILLANCOURT,79538,37136,116674,
Musée des Années Trente,2009,ILE-DE-FRANCE,BOULOGNE-BILLANCOURT,59890,14768,74658,
Musée des Automates,2009,ILE-DE-FRANCE,NEUILLY-SUR-SEINE,0,1450,1450,
Musée d'Histoire Locale - Mémoire de la Ville ( et musée Franco Suisse),2009,ILE-DE-FRANCE,RUEIL-MALMAISON,0,3657,3657,
Musée national de céramique de Sèvres,2009,ILE-DE-FRANCE,SEVRES,21502,13846,35348,
Galerie de Minéralogie et de Géologie (Muséum d'Histoire Naturelle),2009,ILE-DE-FRANCE,PARIS,41292,11873,53165,
Musée National de la Marine,2009,ILE-DE-FRANCE,PARIS,95052,76403,171455,
Musée National Gustave Moreau,2009,ILE-DE-FRANCE,PARIS,16607,16036,32643,
Musée National Jean-Jacques Henner,2009,ILE-DE-FRANCE,PARIS,3322,2281,5603,
Musée Galliera - Musée de la Mode de la ville de Paris,2009,ILE-DE-FRANCE,PARIS,78730,25819,104549,
Etablissement public du musée d'Orsay,2009,ILE-DE-FRANCE,PARIS,1694390,1327622,3022012,
Musée d'Art Moderne de la ville de Paris,2009,ILE-DE-FRANCE,PARIS,251667,457053,708720,
Etablissement public de la Porte Dorée - Cité Nationale de l’Histoire de l’Immigration,2009,ILE-DE-FRANCE,PARIS,20293,83760,104053,
Musée Nissim de Camondo (UCAD),2009,ILE-DE-FRANCE,PARIS,34713,11230,45943,
Musée National d'Art Moderne (Centre National d'Art et de Culture Georges Pompidou),2009,ILE-DE-FRANCE,PARIS,3656759,0,3656759,
Musée Départemental de l'Ecole de Barbizon - Auberge Ganne,2009,ILE-DE-FRANCE,BARBIZON,13598,5184,18782,
Musée Municipal des Capucins,2009,ILE-DE-FRANCE,COULOMMIERS,2007,1246,3253,
Musée du Château de Fontainebleau,2009,ILE-DE-FRANCE,FONTAINEBLEAU,200846,145538,346384,
Musée Bossuet,2009,ILE-DE-FRANCE,MEAUX,3649,1486,5135,
Musée d'Art et d'Histoire de Melun,2009,ILE-DE-FRANCE,MELUN,1300,4000,5300,
Musée Départemental de Préhistoire d'Île de France,2009,ILE-DE-FRANCE,NEMOURS,3238,20983,24221,
Musée départemental Stéphane Mallarmé,2009,ILE-DE-FRANCE,VULAINES-SUR-SEINE,3821,2140,5961,
Ecomusée du Val de Bièvre,2009,ILE-DE-FRANCE,FRESNES,0,11470,11470,
Musée du Vieil Argenteuil,2009,ILE-DE-FRANCE,ARGENTEUIL,865,819,1684,
Musée Archéologique du Val d'Oise,2009,ILE-DE-FRANCE,GUIRY-EN-VEXIN,9813,2130,11943,
Musée jean-Jacques Rousseau,2009,ILE-DE-FRANCE,MONTMORENCY,1387,1688,3075,
Musée Tavet Delacour,2009,ILE-DE-FRANCE,PONTOISE,1891,4466,6357,
Musée National de Port Royal des Champs,2009,ILE-DE-FRANCE,MAGNY-LES-HAMEAUX,8250,12331,20581,
Musée de l'Hôtel-Dieu,2009,ILE-DE-FRANCE,MANTES-LA-JOLIE,3248,4561,7809,
Musée-Bibliothèque Pierre-André Benoît,2009,LANGUEDOC-ROUSSILLON,ALES,0,21229,21229,
Musée Départemental d'Art Sacré du Gard,2009,LANGUEDOC-ROUSSILLON,PONT-SAINT-ESPRIT,291,9708,9999,
Musée des Beaux-Arts de Béziers,2009,LANGUEDOC-ROUSSILLON,BEZIERS,3342,11165,14507,
Musée Municipal,2009,LANGUEDOC-ROUSSILLON,FRONTIGNAN-LA-PEYRADE,0,5775,5775,
Ecomusée du Mont Lozère,2009,LANGUEDOC-ROUSSILLON,LE PONT DE MONTVERT,2760,2194,4954,
Musée Labenche d'Art et d'Histoire,2009,LIMOUSIN,BRIVE-LA-GAILLARDE,3036,12267,15303,
Musée d'Art et d'Archéologie,2009,LIMOUSIN,GUERET,4657,5159,9816,
Musée Départemental d'Art Contemporain,2009,LIMOUSIN,ROCHECHOUART,6723,5960,12683,
Musée de la Céramique et de l'Ivoire,2009,LORRAINE,COMMERCY,1334,738,2072,
Moulin de la Blies - Musée des Techniques Faïencières,2009,LORRAINE,SARREGUEMINES,8408,16069,24477,
"Jardin d'Hiver, Musée de La Faïence",2009,LORRAINE,SARREGUEMINES,5252,4436,9688,
Musée de la Lutherie et de l'Archèterie Française,2009,LORRAINE,MIRECOURT,6048,3695,9743,
Ecomusée de la Martinique,2009,MARTINIQUE,RIVIERE-PILOTE,5368,2000,7368,
Musée d'Archéologie,2009,MIDI-PYRENEES,MONTSEGUR,0,20238,20238,
Musée Régional de Géologie Pierre Vetter,2009,MIDI-PYRENEES,DECAZEVILLE,1770,2445,4215,
"Musée des Mœurs et Coutumes, Musée du Rouergue",2009,MIDI-PYRENEES,ESPALION,1058,124,1182,
Musée Joseph Vaylet,2009,MIDI-PYRENEES,ESPALION,2164,941,3105,
Musée des Jacobins,2009,MIDI-PYRENEES,AUCH,3550,6864,10414,
Musée du Vieux Toulouse,2009,MIDI-PYRENEES,TOULOUSE,3784,1585,5369,
Musée des Augustins,2009,MIDI-PYRENEES,TOULOUSE,41878,68785,110663,
Musée du Pays Vaurais,2009,MIDI-PYRENEES,LAVAUR,927,1783,2710,
Musée du Pays Rabastinois,2009,MIDI-PYRENEES,RABASTENS,1009,3598,4607,
Musée d'Histoire Naturelle Victor Brun,2009,MIDI-PYRENEES,MONTAUBAN,1105,5350,6455,
Musée Municipal d'Hazebrouck,2009,NORD-PAS-DE-CALAIS,HAZEBROUCK,773,3612,4385,
Musée de l'Hospice Comtesse,2009,NORD-PAS-DE-CALAIS,LILLE,49722,5496,55218,
Palais des Beaux-Arts de Lille,2009,NORD-PAS-DE-CALAIS,LILLE,108600,121148,229748,
Musée d'Histoire Locale de Marchiennes,2009,NORD-PAS-DE-CALAIS,MARCHIENNES,395,331,726,
Musée Municipal,2009,NORD-PAS-DE-CALAIS,SAINT-AMAND-LES-EAUX,82,5181,5263,
Château musée,2009,NORD-PAS-DE-CALAIS,BOULOGNE-SUR-MER,21699,15508,37207,
Musée de Normandie,2009,BASSE-NORMANDIE,CAEN,8670,103782,112452,
Musée d'Ethnographie et d'Arts Populaires et Musée de la Marine,2009,BASSE-NORMANDIE,HONFLEUR,17598,0,17598,
Musée Municipal d'Avranches,2009,BASSE-NORMANDIE,AVRANCHES,990,1591,2581,
Musée Richard Anacréon,2009,BASSE-NORMANDIE,GRANVILLE,5627,6025,11652,
Musée Régional du Cidre et du Calvados,2009,BASSE-NORMANDIE,VALOGNES,6190,1265,7455,
Musée des Beaux-Arts et de la Dentelle,2009,BASSE-NORMANDIE,ALENCON,8305,9057,17362,
Musée Municipal d'Archéologie,2009,BASSE-NORMANDIE,L'AIGLE,54,1541,1595,
Musée Alfred Canel,2009,HAUTE-NORMANDIE,PONT-AUDEMER,1379,4233,5612,
Musée Louis-Philippe du Château d'Eu,2009,HAUTE-NORMANDIE,EU,9860,4959,14819,
Musée des Terres-Neuvas et de la Pêche,2009,HAUTE-NORMANDIE,FECAMP,11410,24929,36339,
Musée Mathon-Durand,2009,HAUTE-NORMANDIE,NEUFCHATEL-EN-BRAY,485,2033,2518,
Musée de la Céramique,2009,HAUTE-NORMANDIE,ROUEN,3486,5382,8868,
Muséum d'Histoire Naturelle,2009,HAUTE-NORMANDIE,ROUEN,17682,14243,31925,
Musée du Pays de Retz,2009,PAYS DE LA LOIRE,BOURGNEUF-EN-RETZ,5135,798,5933,
Musée du Vignoble Nantais,2009,PAYS DE LA LOIRE,LE PALLET,4382,2490,6872,
Musée du Chaume/Kerhinet - PNR Brière,2009,PAYS DE LA LOIRE,SAINT-LYPHARD,4831,47569,52400,
Muséum des Sciences Naturelles,2009,PAYS DE LA LOIRE,ANGERS,3228,12797,16025,
Musée d'Art et d'Histoire,2009,PAYS DE LA LOIRE,BAUGE,1008,1026,2034,
Musée Jules-Desbois,2009,PAYS DE LA LOIRE,PARCAY-LES-PINS,3843,2300,6143,
Musée des Tisserands Mayennais,2009,PAYS DE LA LOIRE,AMBRIERES-LES-VALLEES,625,44,669,
Musée Vert Véron-de-Forbonnais,2009,PAYS DE LA LOIRE,LE MANS,19438,0,19438,
Musée de Tessé,2009,PAYS DE LA LOIRE,LE MANS,15586,12233,27819,
Musée Espace Faïence de Malicorne,2009,PAYS DE LA LOIRE,MALICORNE-SUR-SARTHE,12186,3194,15380,
Musée La Bourrine du Bois-Juquaud,2009,PAYS DE LA LOIRE,SAINT-HILAIRE-DE-RIEZ,10680,7887,18567,
Musée Municipal de Soissons,2009,PICARDIE,SOISSONS,0,28494,28494,
Musée de la Résistance et de la Déportation,2009,PICARDIE,TERGNIER,5647,10479,16126,
Musée de la Nacre et de la Tabletterie,2009,PICARDIE,MERU,14685,5209,19894,
Musée du Noyonnais,2009,PICARDIE,NOYON,1859,1610,3469,
Musée Lombart,2009,PICARDIE,DOULLENS,510,4062,4572,
Musée-Historial de la Grande Guerre,2009,PICARDIE,PERONNE,69736,3815,73551,
Musée Napoléonien et Africain,2009,POITOU-CHARENTES,ILE D'AIX,13156,11515,24671,
Musée Protestant,2009,POITOU-CHARENTES,LA ROCHELLE,1236,490,1726,
Musée National de la Marine,2009,POITOU-CHARENTES,ROCHEFORT,16474,24534,41008,
Musée de Bressuire,2009,POITOU-CHARENTES,BRESSUIRE,0,5112,5112,
Musée ethnographique et archéologique du Donjon,2009,POITOU-CHARENTES,NIORT,3067,3962,7029,
"Musée de la Moto, de l'Automobile et du Vélo",2009,POITOU-CHARENTES,CHATELLERAULT,4311,9231,13542,
Musée Municipal de Civray,2009,POITOU-CHARENTES,CIVRAY,0,605,605,
Musée de la Faïence,2009,PROVENCE-ALPES-CÔTE D'AZUR,MOUSTIERS-SAINTE-MARIE,6746,4625,11371,
Musée d'Histoire Locale,2009,PROVENCE-ALPES-CÔTE D'AZUR,BIOT,2500,2190,4690,
Musée-Château de Cagnes,2009,PROVENCE-ALPES-CÔTE D'AZUR,CAGNES-SUR-MER,15723,21239,36962,
Musée d'Art et d'Histoire de Provence,2009,PROVENCE-ALPES-CÔTE D'AZUR,GRASSE,1142,13233,14375,
Musée International de la Parfumerie,2009,PROVENCE-ALPES-CÔTE D'AZUR,GRASSE,44110,46024,90134,
Musée Archéologique - Site de Terra Amata,2009,PROVENCE-ALPES-CÔTE D'AZUR,NICE,0,14823,14823,
Musée Picasso la guerre et la paix à Vallauris,2009,PROVENCE-ALPES-CÔTE D'AZUR,VALLAURIS,18564,12577,31141,
Muséon Arlaten,2009,PROVENCE-ALPES-CÔTE D'AZUR,ARLES,14631,17472,32103,
Musée Camarguais,2009,PROVENCE-ALPES-CÔTE D'AZUR,ARLES,11637,11065,22702,
Musée Départemental de l'Arles Antique,2009,PROVENCE-ALPES-CÔTE D'AZUR,ARLES,85323,97751,183074,
Musée Municipal Méditerranéen de Cassis A.T.P.,2009,PROVENCE-ALPES-CÔTE D'AZUR,CASSIS,34,4519,4553,
Musée Ciotaden,2009,PROVENCE-ALPES-CÔTE D'AZUR,LA CIOTAT,3311,2455,5766,
Musée Folklorique du Vieux Lambesc,2009,PROVENCE-ALPES-CÔTE D'AZUR,LAMBESC,0,1680,1680,
Fondation Louis Jou,2009,PROVENCE-ALPES-CÔTE D'AZUR,LES-BAUX-DE-PROVENCE,294,595,889,
Cabinet des Monnaies et Médailles de Marseille,2009,PROVENCE-ALPES-CÔTE D'AZUR,MARSEILLE,0,1094,1094,
"Musée d'Arts Africains, Océaniens, Amérindiens",2009,PROVENCE-ALPES-CÔTE D'AZUR,MARSEILLE,3232,8424,11656,
Musée Grobet-Labadié,2009,PROVENCE-ALPES-CÔTE D'AZUR,MARSEILLE,2027,6116,8143,
Musée Suffren et du Vieux Saint-Cannat,2009,PROVENCE-ALPES-CÔTE D'AZUR,SAINT-CANNAT,0,5200,5200,
Musée des A.T.P. de Moyenne Provence,2009,PROVENCE-ALPES-CÔTE D'AZUR,DRAGUIGNAN,4148,5570,9718,
Musée Municipal,2009,PROVENCE-ALPES-CÔTE D'AZUR,HYERES,0,44440,44440,
Musée de l'Annonciade,2009,PROVENCE-ALPES-CÔTE D'AZUR,SAINT-TROPEZ,30844,6166,37010,
Musée d'Art et d'Archéologie,2009,PROVENCE-ALPES-CÔTE D'AZUR,TOULON,0,15338,15338,
Muséum d'Histoire Naturelle Esprit Requien,2009,PROVENCE-ALPES-CÔTE D'AZUR,AVIGNON,0,18141,18141,
Musée du Vieux Pérouges,2009,RHONE-ALPES,PEROUGES,12525,475,13000,
Musée Chintreuil,2009,RHONE-ALPES,PONT-DE-VAUX,4031,965,4996,
Musée de la Bresse - Domaine des Planons,2009,RHONE-ALPES,SAINT-CYR-SUR-MENTHON,15827,9965,25792,
Château de Grignan,2009,RHONE-ALPES,GRIGNAN,90864,58859,149723,
Musée d'Art Sacré,2009,RHONE-ALPES,MOURS SAINT-EUSEBE,1244,0,1244,
Musée des Vallées de Thônes,2009,RHONE-ALPES,THONES,1034,809,1843,
Musée d'Huez et de l'Oisans,2009,RHONE-ALPES,ALPE D'HUEZ,1550,140,1690,
Musée de Bourgoin-Jallieu,2009,RHONE-ALPES,BOURGOIN-JALLIEU,1148,7413,8561,
Muséum d'Histoire Naturelle de Grenoble,2009,RHONE-ALPES,GRENOBLE,14204,77275,91479,
Conservatoire - Musée des Industries Hydroélectriques,2009,RHONE-ALPES,VAUJANY,0,9737,9737,
Atelier - Musée du Chapeau,2009,RHONE-ALPES,CHAZELLES-SUR-LYON,10610,4184,14794,
Musée de la Mine / Site Couriot,2009,RHONE-ALPES,SAINT-ETIENNE,33038,25613,58651,
Musée d'Art Moderne et Contemporain,2009,RHONE-ALPES,SAINT-ETIENNE,27874,19910,47784,
Musée Rural,2009,RHONE-ALPES,USSON-EN-FOREZ,5993,1131,7124,
Musée Barthélemy-Thimonnier,2009,RHONE-ALPES,AMPLEPUIS,1742,4511,6253,
Musée Archéologique,2009,RHONE-ALPES,SAINT-ROMAIN-EN-GAL,20601,48864,69465,
Ecomusée du Haut Beaujolais,2009,RHONE-ALPES,THIZY-LES-BOURGS,160,373,533,
Musée du docteur Faure,2009,RHONE-ALPES,AIX-LES-BAINS,5368,4117,9485,
Musée des Charmettes,2009,RHONE-ALPES,CHAMBERY,0,13617,13617,
Musée de l'Académie de La Val d'Isère,2009,RHONE-ALPES,MOÛTIERS,262,362,624,
Musée de Bouxwiller et du pays de hanau,2010,ALSACE,BOUXWILLER,656,79,735,
Musée Alsacien,2010,ALSACE,HAGUENAU,1392,1128,2520,
Musée Historique,2010,ALSACE,HAGUENAU,1742,4123,5865,
Musée de la Chartreuse,2010,ALSACE,MOLSHEIM,3026,492,3518,
Musée d'Art Moderne et Contemporain de Strasbourg,2010,ALSACE,STRASBOURG,32223,99471,131694,
Musée Archéologique,2010,ALSACE,STRASBOURG,6761,31257,38018,
Musée Zoologique de Strasbourg,2010,ALSACE,STRASBOURG,5253,32502,37755,
Musée de l'Œuvre Notre-Dame,2010,ALSACE,STRASBOURG,10493,25531,36024,
Musée Alsacien,2010,ALSACE,STRASBOURG,24133,34452,58585,
Musée de la Bataille du 6 Août 1870,2010,ALSACE,WOERTH,3068,475,3543,
Musée de la Porte de Thann,2010,ALSACE,CERNAY,344,287,631,
Musée de l'Impression sur Etoffes,2010,ALSACE,MULHOUSE,16119,13142,29261,
Musée Vauban,2010,ALSACE,NEUF-BRISACH,6819,0,6819,
Musée du Tabac,2010,AQUITAINE,BERGERAC,2143,1751,3894,
Centre National Jean Moulin,2010,AQUITAINE,BORDEAUX,0,23851,23851,
Ecomusée de la Grande Lande,2010,AQUITAINE,SABRES,68584,10394,78978,
Musée de la Faïence et des arts de la table,2010,AQUITAINE,SAMADET,2039,2187,4226,
Musée de Préhistoire Mésolithique Laurent Coulonges,2010,AQUITAINE,SAUVETERRE-LA-LEMANCE,1347,408,1755,
Muséum d'Histoire Naturelle,2010,AQUITAINE,BAYONNE,0,7701,7701,
Musée Rural de la Sologne Bourbonnaise,2010,AUVERGNE,BEAULON,0,125,125,
Musée des Sciences,2010,AUVERGNE,AURILLAC,3688,7556,11244,
Musée de Paléontologie,2010,AUVERGNE,CHILHAC,1553,0,1553,
Musée Crozatier,2010,AUVERGNE,LE PUY-EN-VELAY,78645,18746,97391,
Musée d'Archéologie Bargoin,2010,AUVERGNE,CLERMONT-FERRAND,3649,16718,20367,
Musée des Beaux-Arts,2010,BOURGOGNE,BEAUNE,3980,1404,5384,
Musée François Rude,2010,BOURGOGNE,DIJON,0,33247,33247,
Musée Noisot,2010,BOURGOGNE,FIXIN,330,175,505,
Musée Municipal,2010,BOURGOGNE,LA CHARITE-SUR-LOIRE,1240,600,1840,
Museum d'Histoire Naturelle Jacques de La Comble,2010,BOURGOGNE,AUTUN,2195,2374,4569,
Musée du Prieuré de Charolles,2010,BOURGOGNE,CHAROLLES,1293,1573,2866,
Musée Eucharistique du Hiéron,2010,BOURGOGNE,PARAY-LE-MONIAL,4004,2541,6545,
Musée des Arts Naïfs et Populaires de Noyers sur Serein,2010,BOURGOGNE,NOYERS-SUR-SEREIN,2168,1332,3500,
Musée de Bretagne,2010,BRETAGNE,RENNES,34630,12606,47236,
Ecomusée Industriel des Forges,2010,BRETAGNE,INZINZAC-LOCHRIST,2730,2270,5000,
Musée National de la Marine,2010,BRETAGNE,PORT-LOUIS,35827,25472,61299,
Musée de la Résistance Bretonne,2010,BRETAGNE,SAINT-MARCEL - MALESTROIT,21173,3620,24793,
Musée d'Histoire et d'Archéologie de Vannes,2010,BRETAGNE,VANNES,2673,3154,5827,
"La Cohue, Musée des Beaux-Arts de vannes",2010,BRETAGNE,VANNES,9154,9513,18667,
Musée du Château Charles VII,2010,CENTRE,MEHUN-SUR-YEVRE,8390,0,8390,
Musée des Beaux-Arts,2010,CENTRE,CHARTRES,4367,6858,11225,
Musée de la Chemiserie et de l'Elégance Masculine,2010,CENTRE,ARGENTON-SUR-CREUSE,3721,3584,7305,
Château Musée,2010,CENTRE,AZAY-LE-FERRON,10978,2917,13895,
Musée de l'Hôtel de Ville,2010,CENTRE,RICHELIEU,454,113,567,
Ecomusée du Véron,2010,CENTRE,SAVIGNY-EN-VERON,10367,0,10367,
Muséum d'Histoire Naturelle,2010,CENTRE,TOURS,9900,15484,25384,
Musée des Vins de Touraine,2010,CENTRE,TOURS,850,1667,2517,
Musée Arthur Rimbaud,2010,CHAMPAGNE-ARDENNES,CHARLEVILLE-MEZIERES,10253,9107,19360,
Musée du Château-Fort,2010,CHAMPAGNE-ARDENNES,SEDAN,53474,1311,54785,
Musée de la Résistance,2010,CHAMPAGNE-ARDENNES,MUSSY-SUR-SEINE,109,40,149,
Musée des Beaux-Arts (Musée Pic Saint-Loup),2010,CHAMPAGNE-ARDENNES,TROYES,7036,4968,12004,
Musée de la Corse,2010,CORSE,CORTE,61560,10363,71923,
Musée des Beaux-Arts et d'Archéologie,2010,FRANCHE-COMTE,BESANCON,4694,44277,48971,
Musée de Plein Air des Maisons Comtoises,2010,FRANCHE-COMTE,NANCRAY,30248,12044,42292,
Ecomusée du Pays de la Cerise,2010,FRANCHE-COMTE,FOUGEROLLES,7073,680,7753,
Musée Sarret de Grozon,2010,FRANCHE-COMTE,ARBOIS,0,1564,1564,
Viséum-Musée de la Lunette,2010,FRANCHE-COMTE,MOREZ HAUTS DE BIENNE,11424,5053,16477,
Musée Départemental Victor Schoelcher,2010,GUADELOUPE,POINTE-A-PITRE,3692,1088,4780,
Musée Municipal Robert Dubois-Corneau,2010,ILE-DE-FRANCE,BRUNOY,0,2528,2528,
Fondation Arp,2010,ILE-DE-FRANCE,CLAMART,1620,333,1953,
Musée Roybet Fould,2010,ILE-DE-FRANCE,COURBEVOIE,0,9685,9685,
Musée Français de la Carte à Jouer,2010,ILE-DE-FRANCE,ISSY-LES-MOULINEAUX,3690,11404,15094,
Musée d'Histoire Locale - Mémoire de la Ville (et musée Franco-Suisse),2010,ILE-DE-FRANCE,RUEIL-MALMAISON,0,2347,2347,
Galerie d'Anatomie Comparée et de Paléontologie (Muséum d'Histoire Naturelle),2010,ILE-DE-FRANCE,PARIS,111097,172732,283829,
Musée National de la Marine,2010,ILE-DE-FRANCE,PARIS,102202,67802,170004,
Musée du Moyen Age-Thermes et Hôtel de Cluny,2010,ILE-DE-FRANCE,PARIS,155911,150234,306145,
Musée de l'Assistance Publique - Hôpitaux de Paris,2010,ILE-DE-FRANCE,PARIS,10661,7373,18034,
Musée National de la Légion d'Honneur et des Ordres de Chevalerie,2010,ILE-DE-FRANCE,PARIS,0,42000,42000,
Musée des Monuments Français,2010,ILE-DE-FRANCE,PARIS,173629,150736,324365,
Musée des Arts Décoratifs (Union Centrale des Arts Décoratifs),2010,ILE-DE-FRANCE,PARIS,233898,258756,492654,
Musée National du Sport,2010,ILE-DE-FRANCE,PARIS,5890,5058,10948,
Musée du Quai Branly,2010,ILE-DE-FRANCE,PARIS,635650,690504,1326154,
Maison Natale de Louis Braille,2010,ILE-DE-FRANCE,COUPVRAY,3288,1123,4411,
Musée de Provins et du Provinois,2010,ILE-DE-FRANCE,PROVINS,15581,3116,18697,
Musée de Nogent-Sur-Marne,2010,ILE-DE-FRANCE,NOGENT-SUR-MARNE,0,6300,6300,
Musée de la Batellerie et des Voies Navigables,2010,ILE-DE-FRANCE,CONFLANS-SAINTE-HONORINE,9888,1641,11529,
Musée Promenade Marly/Louveciennes,2010,ILE-DE-FRANCE,LOUVECIENNES,5951,2844,8795,
Musée-Maison Maurice Ravel,2010,ILE-DE-FRANCE,MONTFORT-L'AMAURY,1397,143,1540,
Musée d'Archéologie Nationale (des origines à l'an mille) - Château de st-Germain-en-Laye,2010,ILE-DE-FRANCE,SAINT-GERMAIN-EN-LAYE,17805,77789,95594,
Musée Historique de Villèle,2010,LA REUNION,SAINT-GILLES-LES-HAUTS,14792,18228,33020,
Musée Léon Alègre,2010,LANGUEDOC-ROUSSILLON,BAGNOLS-SUR-CEZE,283,1248,1531,
Musée de l'Ephèbe,2010,LANGUEDOC-ROUSSILLON,LE CAP D'AGDE,9457,4962,14419,
Musée de la Préhistoire des Matelles,2010,LANGUEDOC-ROUSSILLON,LES MATELLES,1564,1917,3481,
Musée du Vieux Montpellier,2010,LANGUEDOC-ROUSSILLON,MONTPELLIER,506,2261,2767,
Musée de Vulliod Saint-Germain,2010,LANGUEDOC-ROUSSILLON,PEZENAS,1980,2991,4971,
Musée Hyacinthe Rigaud,2010,LANGUEDOC-ROUSSILLON,PERPIGNAN,2587,5549,8136,
Musée de Tautavel,2010,LANGUEDOC-ROUSSILLON,TAUTAVEL,63438,13182,76620,
Musée d'Art et d'Archéologie,2010,LIMOUSIN,GUERET,4847,6170,11017,
Musée de l'Evêché,2010,LIMOUSIN,LIMOGES,0,7216,7216,
Palais des ducs de Lorraine - Musée Historique Lorrain,2010,LORRAINE,NANCY,17432,29736,47168,
Musée d'Art et d'Histoire de Toul,2010,LORRAINE,TOUL,0,4751,4751,
Musée Départemental du Sel,2010,LORRAINE,MARSAL,4275,6654,10929,
Moulin de la Blies - Musée des Techniques Faïencières,2010,LORRAINE,SARREGUEMINES,22568,0,22568,
"Jardin d'Hiver, Musée de La Faïence",2010,LORRAINE,SARREGUEMINES,4353,4595,8948,
La Tour aux Puces - Musée du Pays Thionvillois,2010,LORRAINE,THIONVILLE,6278,3564,9842,
Musée Départemental d'Archéologie Précolombienne et de Préhistoire de la Martinique,2010,MARTINIQUE,FORT-DE-FRANCE,549,10,559,
Musée de la Préhistoire,2010,MIDI-PYRENEES,LE MAS D'AZIL,9548,541,10089,
Musée d'Archéologie,2010,MIDI-PYRENEES,MONTSEGUR,0,24927,24927,
Musée Municipal de Millau,2010,MIDI-PYRENEES,MILLAU,5432,12880,18312,
Musée du Pays de Luchon,2010,MIDI-PYRENEES,BAGNERES-DE-LUCHON,2455,1911,4366,
Musée Archéologique Départemental,2010,MIDI-PYRENEES,SAINT-BERTRAND-DE-COMMINGES,0,36504,36504,
"Les Abattoirs, Musée d'Art Moderne et Contemporain",2010,MIDI-PYRENEES,TOULOUSE,40787,85101,125888,
Musée Saint-Raymond,2010,MIDI-PYRENEES,TOULOUSE,21587,54716,76303,
Musée Salies,2010,MIDI-PYRENEES,BAGNERES-DE-BIGORRE,3434,508,3942,
Musée Murat,2010,MIDI-PYRENEES,CŒUR DE CAUSSE,865,1,866,
Musée Départemental de Cuzals,2010,MIDI-PYRENEES,SAULIAC-SUR-CELE,6922,3468,10390,
Musée Goya,2010,MIDI-PYRENEES,CASTRES,12073,11150,23223,
Musée Charles Portal - Histoire et Patrimoine,2010,MIDI-PYRENEES,CORDES-SUR-CIEL,309,232,541,
Musée du Pays Vaurais,2010,MIDI-PYRENEES,LAVAUR,495,7227,7722,
Musée du Pays Rabastinois,2010,MIDI-PYRENEES,RABASTENS,851,4382,5233,
Musée des arts et traditions populaires,2010,MIDI-PYRENEES,MOISSAC,13039,0,13039,
Musée Benoît de Puydt,2010,NORD-PAS-DE-CALAIS,BAILLEUL,1080,4898,5978,
Musée d'Archéologie et d'Histoire Locale,2010,NORD-PAS-DE-CALAIS,DENAIN,0,2600,2600,
Musée de la Chartreuse,2010,NORD-PAS-DE-CALAIS,DOUAI,5164,42525,47689,
Musée Municipal d'Escaudain,2010,NORD-PAS-DE-CALAIS,ESCAUDAIN,0,368,368,
Musée Départemental Matisse,2010,NORD-PAS-DE-CALAIS,LE CATEAU-CAMBRESIS,21698,49886,71584,
Musée d'Histoire Naturelle et de Géologie,2010,NORD-PAS-DE-CALAIS,LILLE,57299,0,57299,
Musée des Beaux-Arts,2010,NORD-PAS-DE-CALAIS,ROUBAIX,117721,111109,228830,
Musée Communautaire Opale-Sud,2010,NORD-PAS-DE-CALAIS,BERCK-SUR-MER,2663,5694,8357,
Musée Régional d'Ethnologie,2010,NORD-PAS-DE-CALAIS,BETHUNE,0,2776,2776,
Château musée,2010,NORD-PAS-DE-CALAIS,BOULOGNE-SUR-MER,16802,15482,32284,
Musée Quentovic,2010,NORD-PAS-DE-CALAIS,ETAPLES-SUR-MER,2089,963,3052,
Musée de l'Hôtel Sandelin,2010,NORD-PAS-DE-CALAIS,SAINT-OMER,3705,6851,10556,
Musée de Normandie,2010,BASSE-NORMANDIE,CAEN,39239,76893,116132,
Musée Eugène Boudin,2010,BASSE-NORMANDIE,HONFLEUR,45964,5650,51614,
Musée Municipal,2010,BASSE-NORMANDIE,ORBEC,261,1019,1280,
Musée du Château,2010,BASSE-NORMANDIE,PONTECOULANT,3750,1519,5269,
Musée de Trouville - Villa Montebello,2010,BASSE-NORMANDIE,TROUVILLE-SUR-MER,3219,9138,12357,
Musée et Sites archéologiques de Vieux-la-Romaine,2010,BASSE-NORMANDIE,VIEUX,4523,14427,18950,
Musée Quesnel-Morinière,2010,BASSE-NORMANDIE,COUTANCES,173,8661,8834,
Musée Richard Anacréon,2010,BASSE-NORMANDIE,GRANVILLE,4664,4745,9409,
"Musée du Bocage Normand, ferme du bois Jugan",2010,BASSE-NORMANDIE,SAINT-LO,2670,2717,5387,
Musée Municipal - Musée du Jouet,2010,BASSE-NORMANDIE,LA FERTE-MACE,1285,0,1285,
Musée Louis-Philippe du Château d'Eu,2010,HAUTE-NORMANDIE,EU,9429,3679,13108,
Musée des Terres-Neuvas et de la Pêche,2010,HAUTE-NORMANDIE,FECAMP,14157,24126,38283,
Musée de l'Hôtel Dubocage de Bléville,2010,HAUTE-NORMANDIE,LE HAVRE,0,5522,5522,
Abbaye de Graville - Musée du Prieuré de Graville,2010,HAUTE-NORMANDIE,LE HAVRE,2536,4177,6713,
Musée des Sapeurs-Pompiers de France,2010,HAUTE-NORMANDIE,MONTVILLE,5690,2220,7910,
Association de l'Horlogerie Aliermontaise,2010,HAUTE-NORMANDIE,SAINT-NICOLAS-D'ALIERMONT,3707,1872,5579,
Musée Victor Hugo,2010,HAUTE-NORMANDIE,VILLEQUIER,5358,7938,13296,
"Musée de la Fève, Crèches et Traditions Populaires",2010,PAYS DE LA LOIRE,BLAIN,1273,740,2013,
Musée du Vignoble Nantais,2010,PAYS DE LA LOIRE,LE PALLET,3916,2984,6900,
Muséum d'Histoire Naturelle de Nantes,2010,PAYS DE LA LOIRE,NANTES,23284,60998,84282,
Musées du Parc Naturel Régional de Brière,2010,PAYS DE LA LOIRE,SAINT-JOACHIM,2019,250,2269,
Maison de l'Eclusier /Parc Naturel Régional de Brière,2010,PAYS DE LA LOIRE,SAINT-MALO DE GUERSAC,2494,377,2871,
Muséum des Sciences Naturelles,2010,PAYS DE LA LOIRE,ANGERS,3124,13944,17068,
Musée des Beaux-Arts,2010,PAYS DE LA LOIRE,ANGERS,25864,63034,88898,
Musée du Textile,2010,PAYS DE LA LOIRE,CHOLET,6252,6464,12716,
Musée de la Vigne et du Vin d'Anjou,2010,PAYS DE LA LOIRE,SAINT LAMBERT-DU-LATTAY - VAL-DU-LAYON,4550,1761,6311,
Musée Archéologique Départemental de Jublains,2010,PAYS DE LA LOIRE,JUBLAINS,7563,19101,26664,
Musée de l'Ardoise et de la Géologie,2010,PAYS DE LA LOIRE,RENAZE,900,395,1295,
Musée Vert Véron-de-Forbonnais,2010,PAYS DE LA LOIRE,LE MANS,3996,12730,16726,
Musée Municipal,2010,PAYS DE LA LOIRE,LA ROCHE-SUR-YON,0,7372,7372,
Musée du Château,2010,PAYS DE LA LOIRE,NOIRMOUTIER-EN-L'ILE,38594,6608,45202,
Musée Gallé-Juillet,2010,PICARDIE,CREIL,2174,5860,8034,
Musée Boucher-de-Perthes,2010,PICARDIE,ABBEVILLE,2732,7700,10432,
Musée Départemental de l'Abbaye de Saint-Riquier,2010,PICARDIE,ABBEVILLE,0,31331,31331,
Musée-Historial de la Grande Guerre,2010,PICARDIE,PERONNE,60176,8324,68500,
Musée Cappon,2010,POITOU-CHARENTES,MARANS,22,0,22,
Musée Dupuy-Mestreau,2010,POITOU-CHARENTES,SAINTES,1196,2479,3675,
Musée ethnographique et archéologique du Donjon,2010,POITOU-CHARENTES,NIORT,4848,5373,10221,
Musée Henri Barré,2010,POITOU-CHARENTES,THOUARS,365,1212,1577,
"Musée de la Moto, de l'Automobile et du Vélo",2010,POITOU-CHARENTES,CHATELLERAULT,4369,8569,12938,
Musée Sainte-Croix,2010,POITOU-CHARENTES,POITIERS,3501,17479,20980,
Musée du baptistère Saint-Jean,2010,POITOU-CHARENTES,POITIERS,11489,1233,12722,
Musée de Salagon,2010,PROVENCE-ALPES-CÔTE D'AZUR,MANE,28287,8008,36295,
Musée de la Faïence,2010,PROVENCE-ALPES-CÔTE D'AZUR,MOUSTIERS-SAINTE-MARIE,7620,4273,11893,
Musée départemental de préhistoire,2010,PROVENCE-ALPES-CÔTE D'AZUR,QUINSON,61484,14142,75626,
Musée de la Mer,2010,PROVENCE-ALPES-CÔTE D'AZUR,CANNES,44377,37904,82281,
Villa-Musée Jean-Honoré Fragonard,2010,PROVENCE-ALPES-CÔTE D'AZUR,GRASSE,0,6542,6542,
Musée des Beaux-Arts Jules Chéret,2010,PROVENCE-ALPES-CÔTE D'AZUR,NICE,0,49524,49524,
Musée d'Art et d'Histoire,2010,PROVENCE-ALPES-CÔTE D'AZUR,NICE,0,66452,66452,
Muséon Arlaten,2010,PROVENCE-ALPES-CÔTE D'AZUR,ARLES,0,6010,6010,
Musée Camarguais,2010,PROVENCE-ALPES-CÔTE D'AZUR,ARLES,10646,9827,20473,
Musée Frédéric Mistral,2010,PROVENCE-ALPES-CÔTE D'AZUR,MAILLANE,1645,4264,5909,
Musée des Docks Romains,2010,PROVENCE-ALPES-CÔTE D'AZUR,MARSEILLE,2729,2884,5613,
"Musée d'Arts Africains, Océaniens, Amérindiens",2010,PROVENCE-ALPES-CÔTE D'AZUR,MARSEILLE,3257,16700,19957,
Musée des Beaux-Arts de Marseille,2010,PROVENCE-ALPES-CÔTE D'AZUR,MARSEILLE,3678,18304,21982,
Musée Jean Aicard,2010,PROVENCE-ALPES-CÔTE D'AZUR,LE POUVEREL LA GARDE,0,1509,1509,
Musée de l'Annonciade,2010,PROVENCE-ALPES-CÔTE D'AZUR,SAINT-TROPEZ,58517,8939,67456,
Musée du Vêtement Provençal (Jean Aicard),2010,PROVENCE-ALPES-CÔTE D'AZUR,SOLLIES-VILLE,0,4488,4488,
Musée National de la Marine de Toulon,2010,PROVENCE-ALPES-CÔTE D'AZUR,TOULON,19812,31090,50902,
Muséum d'Histoire Naturelle Esprit Requien,2010,PROVENCE-ALPES-CÔTE D'AZUR,AVIGNON,0,18442,18442,
Musée Sobirats,2010,PROVENCE-ALPES-CÔTE D'AZUR,CARPENTRAS,238,948,1186,
Synagogue Musée Juif Comtadin,2010,PROVENCE-ALPES-CÔTE D'AZUR,CAVAILLON,4838,0,4838,
Musée du Brou,2010,RHONE-ALPES,BOURG-EN-BRESSE,50134,23894,74028,
Musée de la Résistance et de la Déportation de l'Ain,2010,RHONE-ALPES,NANTUA,6033,3694,9727,
Musée du Peigne et de la Plasturgie,2010,RHONE-ALPES,OYONNAX,1749,2821,4570,
Musée de la Batellerie du Rhône,2010,RHONE-ALPES,SERRIERES,932,295,1227,
Château de Grignan,2010,RHONE-ALPES,GRIGNAN,90012,58936,148948,
Musée d'Archéologie Tricastine,2010,RHONE-ALPES,SAINT-PAUL-TROIS-CHATEAUX,1801,3104,4905,
Musée Alpin,2010,RHONE-ALPES,CHAMONIX,13226,8993,22219,
Musée du Chablais,2010,RHONE-ALPES,THONON-LES-BAINS,1644,1929,3573,
Musée d'Huez et de l'Oisans,2010,RHONE-ALPES,ALPE D'HUEZ,1704,250,1954,
Musée Gallo-Romain,2010,RHONE-ALPES,AOSTE,4935,6130,11065,
Musée de la Résistance de la Déportation de l'Isère,2010,RHONE-ALPES,GRENOBLE,0,33007,33007,
Musée Hector Berlioz,2010,RHONE-ALPES,LA-COTE-SAINT-ANDRE,0,12884,12884,
Musée Lucien Mainssieux,2010,RHONE-ALPES,VOIRON,0,6575,6575,
Musée de la Diana,2010,RHONE-ALPES,MONTBRISON,1238,0,1238,
Musée de la Mine / Site Couriot,2010,RHONE-ALPES,SAINT-ETIENNE,30957,26962,57919,
Musée Barthélemy-Thimonnier,2010,RHONE-ALPES,AMPLEPUIS,5410,0,5410,
Musées Gadagne,2010,RHONE-ALPES,LYON,46722,50278,97000,
Centre d'Histoire de la Résistance et de la Déportation,2010,RHONE-ALPES,LYON,16423,40653,57076,
Musée des Beaux-Arts,2010,RHONE-ALPES,LYON,107325,183825,291150,
Musée Henri Malartre,2010,RHONE-ALPES,ROCHETAILLEE-SUR-SAONE,17214,20013,37227,
Musée de la Poterie,2011,ALSACE,BETSCHDORF,1826,316,2142,
Musée du Château des Rohan,2011,ALSACE,SAVERNE,4678,4176,8854,
Musée Alsacien,2011,ALSACE,STRASBOURG,21556,34467,56023,
Musée de la Bataille du 6 Août 1870,2011,ALSACE,WOERTH,2532,290,2822,
Musée Bartholdi,2011,ALSACE,COLMAR,10163,4496,14659,
Musée d'Histoire Naturelle et d'Ethnographie de Colmar,2011,ALSACE,COLMAR,8184,4989,13173,
Musée d'Histoire Local,2011,ALSACE,KAYSERSBERG,342,335,677,
Musée des Beaux-Arts,2011,ALSACE,MULHOUSE,0,22457,22457,
Musée Vauban,2011,ALSACE,NEUF-BRISACH,1882,0,1882,
Musée National de la Préhistoire,2011,AQUITAINE,LES EYZIES-DE-TAYAC,49924,44433,94357,
Musée d'Art et d'Archéologie du Périgord (MAAP),2011,AQUITAINE,PERIGUEUX,8147,18678,26825,
Musée des Arts Décoratifs,2011,AQUITAINE,BORDEAUX,2702,38415,41117,
Musée des Beaux-Arts et d'Archéologie,2011,AQUITAINE,LIBOURNE,0,7756,7756,
Musée Despiau-Wlérick,2011,AQUITAINE,MONT-DE-MARSAN,0,15096,15096,
Musée du Liège et du Bouchon,2011,AQUITAINE,MEZIN,4298,905,5203,
Musée Municipal (Moulin de Gajac),2011,AQUITAINE,VILLENEUVE-SUR-LOT,9297,702,9999,
Musée Edmond Rostand,2011,AQUITAINE,CAMBO-LES-BAINS,59994,10735,70729,
Musée Municipal des Beaux-Arts,2011,AQUITAINE,PAU,39836,0,39836,
Centre National du Costume de Scène et de la Scénographie,2011,AUVERGNE,MOULINS,53974,26339,80313,
Musée Municipal de Souvigny,2011,AUVERGNE,SOUVIGNY,8233,1024,9257,
Ecomusée de Margeride-Haute-Auvergne,2011,AUVERGNE,RUYNES-EN-MARGERIDE,12707,0,12707,
Musée d'Archéologie Bargoin,2011,AUVERGNE,CLERMONT-FERRAND,3182,9898,13080,
Musée Départemental de la Céramique Gallo-Romaine,2011,AUVERGNE,LEZOUX,11324,4280,15604,
Musée Paléontologique,2011,AUVERGNE,MENAT,503,60,563,
Musée Francisque Mandet,2011,AUVERGNE,RIOM,4446,11899,16345,
Musée Alésia - Centre d'Interprétation,2011,BOURGOGNE,ALISE-SAINTE-REINE,30932,3578,34510,
Musée Noisot,2011,BOURGOGNE,FIXIN,379,128,507,
Musée Municipal,2011,BOURGOGNE,SEMUR-EN-AUXOIS,963,4316,5279,
Musée d'Art et d'Histoire Romain Rolland,2011,BOURGOGNE,CLAMECY,2054,2703,4757,
Musée de la Loire,2011,BOURGOGNE,COSNE-SUR-LOIRE,921,2995,3916,
Musée de la Mine,2011,BOURGOGNE,BLANZY,9876,1728,11604,
Musée Denon,2011,BOURGOGNE,CHALON-SUR-SAONE,0,13523,13523,
Musée René Davoine,2011,BOURGOGNE,CHAROLLES,0,70,70,
Musée du Prieuré de Charolles,2011,BOURGOGNE,CHAROLLES,1512,2016,3528,
Musée Départemental de Préhistoire de Solutré,2011,BOURGOGNE,SOLUTRE-POUILLY,16652,13886,30538,
Hôtel Dieu - Musée Greuze,2011,BOURGOGNE,TOURNUS,9502,2058,11560,
Muséum - Maison de l'Eau,2011,BOURGOGNE,AUXERRE,0,10306,10306,
Musée Colette,2011,BOURGOGNE,SAINT-SAUVEUR-EN-PUISAYE,6652,844,7496,
Musée du Château de Dinan,2011,BRETAGNE,DINAN,16347,7793,24140,
Ecomusée des Monts d'Arrée - Moulins de Kerouat,2011,BRETAGNE,COMMANA,9075,2337,11412,
Ecomusée des Monts d'Arrée - Maison Cornec,2011,BRETAGNE,RIVOAL,1397,7485,8882,
Musée Bigouden,2011,BRETAGNE,PONT-L'ABBE,12825,4893,17718,
Musée du Château de Vitré,2011,BRETAGNE,VITRE,12766,5476,18242,
Ecomusée Industriel des Forges,2011,BRETAGNE,INZINZAC-LOCHRIST,2688,1691,4379,
Musée de la Résistance Bretonne,2011,BRETAGNE,SAINT-MARCEL - MALESTROIT,18938,2640,21578,
Musée des Beaux-Arts et d'Histoire Naturelle,2011,CENTRE,CHATEAUDUN,4349,4776,9125,
Musée de l'Hospice Saint-Roch,2011,CENTRE,ISSOUDUN,82,16240,16322,
Musée Ornithologique (Ecomusée de la Brenne),2011,CENTRE,LE BLANC,2185,1157,3342,
Musée de Préhistoire du Grand Pressigny,2011,CENTRE,LE GRAND PRESSIGNY,11871,10328,22199,
Musée de l'Hôtel de Ville,2011,CENTRE,RICHELIEU,4885,1565,6450,
Musée Balzac,2011,CENTRE,SACHE,15750,9021,24771,
Musée Municipal,2011,CENTRE,SAINTE-MAURE-DE-TOURAINE,132,0,132,
Musée François Rabelais,2011,CENTRE,SEUILLY,9964,5537,15501,
Musée Archéologique,2011,CENTRE,THESEE,912,221,1133,
Musée de la Résistance,2011,CHAMPAGNE-ARDENNES,MUSSY-SUR-SEINE,167,3,170,
Musée Vauluisant - Musée de la Bonneterie,2011,CHAMPAGNE-ARDENNES,TROYES,2970,3688,6658,
Musée des Beaux-Arts et d'Archéologie,2011,CHAMPAGNE-ARDENNES,CHAUMONT,810,2043,2853,
Musée Hôtel le Vergeur,2011,CHAMPAGNE-ARDENNES,REIMS,10773,6094,16867,
Musée de l'Ancien Collège des Jésuites/Planétarium,2011,CHAMPAGNE-ARDENNES,REIMS,3406,25244,28650,
Musée des Beaux-Arts de Saint-Denis,2011,CHAMPAGNE-ARDENNES,REIMS,11215,34685,45900,
Musée de Pontarlier,2011,FRANCHE-COMTE,PONTARLIER,1210,7791,9001,
Musée Départemental Albert-et-Félicie Demard - ATP,2011,FRANCHE-COMTE,CHAMPLITTE,6048,7782,13830,
Viséum-Musée de la Lunette,2011,FRANCHE-COMTE,MOREZ HAUTS DE BIENNE,10619,4558,15177,
Musée des Salines,2011,FRANCHE-COMTE,SALINS-LES-BAINS,72732,5468,78200,
Musée de l'Artisanat Jurassien,2011,FRANCHE-COMTE,VOITEUR,0,15820,15820,
Musée-Jardin Paul Landowski,2011,ILE-DE-FRANCE,BOULOGNE-BILLANCOURT,191,764,955,
Musée Roybet Fould,2011,ILE-DE-FRANCE,COURBEVOIE,0,11261,11261,
Musée National de la Marine,2011,ILE-DE-FRANCE,PARIS,146692,62206,208898,
Musée National Gustave Moreau,2011,ILE-DE-FRANCE,PARIS,18862,19230,38092,
Musée de la Vie Romantique,2011,ILE-DE-FRANCE,PARIS,29440,82504,111944,
Musée Zadkine,2011,ILE-DE-FRANCE,PARIS,9892,7182,17074,
Etablissement Public du Musée des Arts Asiatiques Guimet,2011,ILE-DE-FRANCE,PARIS,125198,113719,238917,
Musée des Monuments Français,2011,ILE-DE-FRANCE,PARIS,140067,104754,244821,
Musée National Auguste Rodin,2011,ILE-DE-FRANCE,PARIS,468536,257623,726159,
Musée des Arts Décoratifs (Union Centrale des Arts Décoratifs),2011,ILE-DE-FRANCE,PARIS,260506,225642,486148,
Musée National du Sport,2011,ILE-DE-FRANCE,PARIS,5328,5853,11181,
Musée National d'Art Moderne (Centre National d'Art et de Culture Georges Pompidou),2011,ILE-DE-FRANCE,PARIS,3717251,0,3717251,
Musée Départemental de Préhistoire d'Île de France,2011,ILE-DE-FRANCE,NEMOURS,4629,25302,29931,
Musée de Saint-Maur - Villa Médicis,2011,ILE-DE-FRANCE,LA VARENNE-SAINT-HILAIRE,102,10242,10344,
Musée de Nogent-Sur-Marne,2011,ILE-DE-FRANCE,NOGENT-SUR-MARNE,347,7717,8064,
"MAC VAL, Musée d'Art Contemporain du Val-de-Marne",2011,ILE-DE-FRANCE,VITRY SUR SEINE,10598,57830,68428,
Musée d'Art et d'Histoire Louis Senlecq,2011,ILE-DE-FRANCE,L'ISLE-ADAM,1625,5046,6671,
Musée Tavet Delacour,2011,ILE-DE-FRANCE,PONTOISE,3133,3641,6774,
Musée Municipal - Collections Paul et André Véra,2011,ILE-DE-FRANCE,SAINT-GERMAIN-EN-LAYE,0,2399,2399,
Musée d'Archéologie Nationale (des origines à l'an mille) - Château de st-Germain-en-Laye,2011,ILE-DE-FRANCE,SAINT-GERMAIN-EN-LAYE Cedex,16782,75484,92266,
Musée Lambinet,2011,ILE-DE-FRANCE,VERSAILLES,9674,5759,15433,
Musée Petiet,2011,LANGUEDOC-ROUSSILLON,LIMOUX,701,2585,3286,
Carré d'Art Musée d'Art Contemporain de Nîmes,2011,LANGUEDOC-ROUSSILLON,NIMES,14197,23276,37473,
Musée Municipal Georges Borias,2011,LANGUEDOC-ROUSSILLON,UZES,1285,905,2190,
Musée des Beaux-Arts de Béziers,2011,LANGUEDOC-ROUSSILLON,BEZIERS,2683,14695,17378,
Musée Fabre,2011,LANGUEDOC-ROUSSILLON,MONTPELLIER,216735,74587,291322,
Musée d'Art Moderne - Fonds Peskè,2011,LANGUEDOC-ROUSSILLON,COLLIOURE,7095,2529,9624,
Musée de Cerdagne,2011,LANGUEDOC-ROUSSILLON,SAINTE-LEOCADIE,3089,1344,4433,
Musée de la Mémoire et des Industries Tullistes,2011,LIMOUSIN,TULLE,0,3488,3488,
Musée René Baubérot,2011,LIMOUSIN,CHATEAUPONSAC,3266,595,3861,
Musée de l'Ecole de Nancy,2011,LORRAINE,NANCY,38754,29196,67950,
Muséum- Aquarium de Nancy,2011,LORRAINE,NANCY,28774,60409,89183,
Musée d'Art et d'Histoire de Toul,2011,LORRAINE,TOUL,0,5033,5033,
Musées de la Cour d'Or,2011,LORRAINE,METZ,19814,30889,50703,
Musée de la Mine - Carreau Wendel,2011,LORRAINE,PETITE-ROSSELLE,18261,1856,20117,
Musée Départemental d'Archéologie Précolombienne et de Préhistoire de la Martinique,2011,MARTINIQUE,FORT-DE-FRANCE,1298,1121,2419,
Ecomusée de la Martinique,2011,MARTINIQUE,RIVIERE-PILOTE,4986,2619,7605,
Musée Joseph Vaylet,2011,MIDI-PYRENEES,ESPALION,3945,959,4904,
Musée des Beaux-Arts Denys Puech,2011,MIDI-PYRENEES,RODEZ,886,8868,9754,
Musée Municipal,2011,MIDI-PYRENEES,MARTRES-TOLOSANE,1313,3908,5221,
Musée Archéologique Départemental,2011,MIDI-PYRENEES,SAINT-BERTRAND-DE-COMMINGES,0,37697,37697,
Musée des Transports et des Communications,2011,MIDI-PYRENEES,TOULOUSE,0,709,709,
Musée du Vieux Toulouse,2011,MIDI-PYRENEES,TOULOUSE,5703,991,6694,
Musée-château Gaston Phébus,2011,MIDI-PYRENEES,MAUVEZIN,31360,550,31910,
Musée Murat,2011,MIDI-PYRENEES,CŒUR DE CAUSSE,632,2,634,
"Musée Archéologique ""Armand-Viré""",2011,MIDI-PYRENEES,LUZECH,383,418,801,
Musée Charles Portal - Histoire et Patrimoine,2011,MIDI-PYRENEES,CORDES-SUR-CIEL,596,180,776,
Musée du Protestantisme en Haut-Languedoc,2011,MIDI-PYRENEES,FERRIERES,2308,1831,4139,
Muséum d'histoire naturelle Philadelphe Thomas,2011,MIDI-PYRENEES,GAILLAC,1158,3452,4610,
Musée du Pays Vaurais,2011,MIDI-PYRENEES,LAVAUR,1243,2220,3463,
Musée Départemental de Flandre,2011,NORD-PAS-DE-CALAIS,CASSEL,67551,16517,84068,
Musée d'Archéologie et d'Histoire Locale,2011,NORD-PAS-DE-CALAIS,DENAIN,0,5000,5000,
Musée d'Histoire Naturelle et de Géologie,2011,NORD-PAS-DE-CALAIS,LILLE,61670,0,61670,
Musée d'Histoire Locale de Marchiennes,2011,NORD-PAS-DE-CALAIS,MARCHIENNES,180,486,666,
Musée des Beaux-Arts,2011,NORD-PAS-DE-CALAIS,ROUBAIX,91666,114457,206123,
Musée Communautaire Opale-Sud,2011,NORD-PAS-DE-CALAIS,BERCK-SUR-MER,2920,7224,10144,
Musée Baron Gérard,2011,BASSE-NORMANDIE,BAYEUX,6500,0,6500,
Musée d'Ethnographie et d'Arts Populaires et Musée de la Marine,2011,BASSE-NORMANDIE,HONFLEUR,18025,0,18025,
Musée Municipal,2011,BASSE-NORMANDIE,ORBEC,446,1297,1743,
Château de Saint-Germain de Livet,2011,BASSE-NORMANDIE,SAINT-GERMAIN DE LIVET,7960,12412,20372,
Musée et Sites archéologiques de Vieux-la-Romaine,2011,BASSE-NORMANDIE,VIEUX,3854,14228,18082,
Musée de la Pomme et de la Poire,2011,BASSE-NORMANDIE,BARENTON,655,3311,3966,
Musée de la Guerre et de la Libération,2011,BASSE-NORMANDIE,CHERBOURG-EN-COTENTIN,4431,6346,10777,
Muséum Emmanuel Liais,2011,BASSE-NORMANDIE,CHERBOURG-EN-COTENTIN,0,19268,19268,
Musée du Granit,2011,BASSE-NORMANDIE,SAINT-MICHEL-DE-MONTJOIE,797,263,1060,
Musée Maritime de l'Ile de Tatihou,2011,BASSE-NORMANDIE,SAINT-VAAST-LA-HOUGUE,60125,3338,63463,
Musée du Château,2011,BASSE-NORMANDIE,TORIGNI-SUR-VIRE,952,0,952,
Musée du Château de Flers,2011,BASSE-NORMANDIE,FLERS,2051,3174,5225,
Musée Municipal d'Archéologie,2011,BASSE-NORMANDIE,L'AIGLE,641,496,1137,
Musée Départemental des Arts et Traditions Populaires du Perche,2011,BASSE-NORMANDIE,SAINT-CYR LA ROSIERE,14619,11692,26311,
Musée Départemental d'Art Sacré,2011,BASSE-NORMANDIE,SEES,878,241,1119,
Musée du Verre et de la Pierre,2011,HAUTE-NORMANDIE,CONCHES-EN-OUCHE,2065,2730,4795,
Musée de l'Ancien Evêché,2011,HAUTE-NORMANDIE,EVREUX,0,19825,19825,
Musée Municipal Nicolas Poussin,2011,HAUTE-NORMANDIE,LES ANDELYS,1031,1689,2720,
Musée Alfred Canel,2011,HAUTE-NORMANDIE,PONT-AUDEMER,296,5929,6225,
Musée Alphonse-Georges Poulain,2011,HAUTE-NORMANDIE,VERNON,3139,11119,14258,
Museoseine,2011,HAUTE-NORMANDIE,CAUDEBEC-EN-CAUX,1601,495,2096,
Château-Musée de Dieppe,2011,HAUTE-NORMANDIE,DIEPPE,32054,11804,43858,
Musée de l'Hôtel Dubocage de Bléville,2011,HAUTE-NORMANDIE,LE HAVRE,130,6368,6498,
Abbaye de Graville - Musée du Prieuré de Graville,2011,HAUTE-NORMANDIE,LE HAVRE,574,2897,3471,
Muséum d'Histoire Naturelle,2011,HAUTE-NORMANDIE,LE HAVRE,0,65355,65355,
Musée des Traditions et Arts Normands,2011,HAUTE-NORMANDIE,MARTAINVILLE-EPREVILLE,9536,15726,25262,
Musée des Sapeurs-Pompiers de France,2011,HAUTE-NORMANDIE,MONTVILLE,6484,2710,9194,
Ecomusée de la Basse-Seine,2011,HAUTE-NORMANDIE,NOTRE-DAME-DE-BLIQUETUIT,16515,4953,21468,
Musée-Maison Natale Pierre Corneille,2011,HAUTE-NORMANDIE,ROUEN,0,4954,4954,
Musée Le Secq des Tournelles,2011,HAUTE-NORMANDIE,ROUEN,4652,8227,12879,
"Musée de la Fève, Crèches et Traditions Populaires",2011,PAYS DE LA LOIRE,BLAIN,1178,755,1933,
Musée de la Vigne et du Vin d'Anjou,2011,PAYS DE LA LOIRE,SAINT LAMBERT-DU-LATTAY - VAL-DU-LAYON,4469,1653,6122,
Musée du Vieux Château,2011,PAYS DE LA LOIRE,LAVAL,7009,9789,16798,
Musée des Traditions de l'Île,2011,PAYS DE LA LOIRE,LA GUERINIERE,5188,748,5936,
Musée de l'Abbaye de Sainte-Croix,2011,PAYS DE LA LOIRE,LES SABLES D'OLONNE,3542,13485,17027,
Musée Jean de la Fontaine,2011,PICARDIE,CHATEAU-THIERRY,11926,3944,15870,
Musée d'Art et d'Archéologie,2011,PICARDIE,LAON,1463,5225,6688,
Musée des Beaux-Arts Antoine Lecuyer,2011,PICARDIE,SAINT-QUENTIN,3813,7819,11632,
Musée de La Thiérache,2011,PICARDIE,VERVINS,0,3196,3196,
Musée Pillon,2011,PICARDIE,CHAUMONT-EN-VEXIN,0,427,427,
Musée de l'Archerie et de l'Art Sacré,2011,PICARDIE,CREPY-EN-VALOIS,3942,2126,6068,
Musée-Historial de la Grande Guerre,2011,PICARDIE,PERONNE,66931,5449,72380,
Cité International de la Bande Dessinée et de l'Image - Musée de la Bande Dessinée,2011,POITOU-CHARENTES,ANGOULEME,14130,45176,59306,
Muséum d'Histoire Naturelle,2011,POITOU-CHARENTES,LA ROCHELLE,9020,31392,40412,
Musée Protestant,2011,POITOU-CHARENTES,LA ROCHELLE,1448,797,2245,
Musée d'Orbigny-Bernon,2011,POITOU-CHARENTES,LA ROCHELLE,1701,6202,7903,
Musée National de la Marine,2011,POITOU-CHARENTES,ROCHEFORT,24107,17244,41351,
Musée Archéologique,2011,POITOU-CHARENTES,SAINTES,1182,42283,43465,
Musée de l'Echevinage,2011,POITOU-CHARENTES,SAINTES,800,2115,2915,
Musée de l'Ile d'Oléron,2011,POITOU-CHARENTES,ST-PIERRE D'OLERON,12651,3192,15843,
Musée Bernard d’Agesci,2011,POITOU-CHARENTES,NIORT,4470,7460,11930,
Musée d'Art et d'Histoire Georges Turpin,2011,POITOU-CHARENTES,PARTHENAY,0,8412,8412,
Musée des Traditions Populaires et d'Archéologie,2011,POITOU-CHARENTES,CHAUVIGNY,7890,2984,10874,
Musée Sainte-Croix,2011,POITOU-CHARENTES,POITIERS,3489,18030,21519,
Musée de la Faïence,2011,PROVENCE-ALPES-CÔTE D'AZUR,MOUSTIERS-SAINTE-MARIE,5025,10731,15756,
Musée Archéologique,2011,PROVENCE-ALPES-CÔTE D'AZUR,RIEZ-LA-ROMAINE,223,90,313,
Musée Fernand Léger,2011,PROVENCE-ALPES-CÔTE D'AZUR,BIOT,17745,15954,33699,
Musée-Château de Cagnes,2011,PROVENCE-ALPES-CÔTE D'AZUR,CAGNES-SUR-MER,17854,19780,37634,
Villa-Musée Jean-Honoré Fragonard,2011,PROVENCE-ALPES-CÔTE D'AZUR,GRASSE,0,6267,6267,
Musée International de la Parfumerie,2011,PROVENCE-ALPES-CÔTE D'AZUR,GRASSE,61943,31647,93590,
Musée Jean Cocteau Collection Séverin Wunderman,2011,PROVENCE-ALPES-CÔTE D'AZUR,MENTON,13269,9465,22734,
Musée des Beaux-Arts Jules Chéret,2011,PROVENCE-ALPES-CÔTE D'AZUR,NICE,0,50036,50036,
Musée du Palais Lascaris,2011,PROVENCE-ALPES-CÔTE D'AZUR,NICE,0,81131,81131,
Musée du Parlement de Provence et du Vieil Aix,2011,PROVENCE-ALPES-CÔTE D'AZUR,AIX-EN-PROVENCE,0,15911,15911,
Musée Camarguais,2011,PROVENCE-ALPES-CÔTE D'AZUR,ARLES,9622,8881,18503,
Musée Réattu,2011,PROVENCE-ALPES-CÔTE D'AZUR,ARLES,9752,20093,29845,
Musée Départemental de l'Arles Antique,2011,PROVENCE-ALPES-CÔTE D'AZUR,ARLES,49364,109450,158814,
Musée Folklorique du Vieux Lambesc,2011,PROVENCE-ALPES-CÔTE D'AZUR,LAMBESC,0,3900,3900,
Musée d'Histoire et d'Archéologie des Baux-de-Provence,2011,PROVENCE-ALPES-CÔTE D'AZUR,LES BAUX DE PROVENCE,221250,27859,249109,
Musée des Docks Romains,2011,PROVENCE-ALPES-CÔTE D'AZUR,MARSEILLE,5543,0,5543,
Musée d'Art Contemporain - Galeries Contemporaines,2011,PROVENCE-ALPES-CÔTE D'AZUR,MARSEILLE,24829,0,24829,
Musée Cantini,2011,PROVENCE-ALPES-CÔTE D'AZUR,MARSEILLE,23993,0,23993,
Musée Ziem,2011,PROVENCE-ALPES-CÔTE D'AZUR,MARTIGUES,0,15637,15637,
Musée Départemental des Hautes-Alpes,2011,PROVENCE-ALPES-CÔTE D'AZUR,GAP,0,16452,16452,
Musée des Arts et d’Histoire,2011,PROVENCE-ALPES-CÔTE D'AZUR,BORMES-LES-MIMOSAS,0,5322,5322,
Musée de l'Artillerie,2011,PROVENCE-ALPES-CÔTE D'AZUR,DRAGUIGNAN,0,20250,20250,
Musée Archéologique,2011,PROVENCE-ALPES-CÔTE D'AZUR,SAINT-RAPHAËL,0,17067,17067,
Musée de l'Annonciade,2011,PROVENCE-ALPES-CÔTE D'AZUR,SAINT-TROPEZ,32099,7682,39781,
Muséum d'Histoire Naturelle de Toulon,2011,PROVENCE-ALPES-CÔTE D'AZUR,TOULON,0,44159,44159,
Musée d'Art et d'Archéologie,2011,PROVENCE-ALPES-CÔTE D'AZUR,TOULON,0,23852,23852,
Musée Jean Garcin 39-45 : L'appel de la Liberté,2011,PROVENCE-ALPES-CÔTE D'AZUR,FONTAINE-DE-VAUCLUSE,2884,7818,10702,
Musée de la Résistance et de la Déportation de l'Ain,2011,RHONE-ALPES,NANTUA,5971,4423,10394,
Musée de la Bresse - Domaine des Planons,2011,RHONE-ALPES,SAINT-CYR-SUR-MENTHON,12092,8437,20529,
Musée du Rhône,2011,RHONE-ALPES,TOURNON-SUR-RHÔNE,7788,7164,14952,
Musée du site Préhistorique,2011,RHONE-ALPES,VASSIEUX-EN-VERCORS,13654,0,13654,
Musée-château d'Annecy,2011,RHONE-ALPES,ANNECY,40659,39454,80113,
Musée Jadis Allevard,2011,RHONE-ALPES,ALLEVARD-LES-BAINS,1004,3994,4998,
Musée de la Résistance de la Déportation de l'Isère,2011,RHONE-ALPES,GRENOBLE,0,31220,31220,
Muséum d'Histoire Naturelle de Grenoble,2011,RHONE-ALPES,GRENOBLE,14672,52318,66990,
Musée Hébert,2011,RHONE-ALPES,LA TRONCHE,0,29628,29628,
Musée des Beaux-Arts et d'Archéologie,2011,RHONE-ALPES,VIENNE,1353,2549,3902,
Musée d'Art Moderne et Contemporain,2011,RHONE-ALPES,SAINT-ETIENNE,30729,22825,53554,
Musée Folklorique et Traditions Populaires Marius Audin,2011,RHONE-ALPES,BEAUJEU,1895,619,2514,
Centre d'Histoire de la Résistance et de la Déportation,2011,RHONE-ALPES,LYON,12618,35577,48195,
Musée Historique,2012,ALSACE,HAGUENAU,1988,6061,8049,
Musée Historique,2012,ALSACE,STRASBOURG,10785,26945,37730,
Cabinet des Estampes et des Dessins,2012,ALSACE,STRASBOURG,0,494,494,
Musée J.F. Oberlin,2012,ALSACE,WALDERSBACH,20410,7453,27863,
Musée de la Bataille du 6 Août 1870,2012,ALSACE,WOERTH,2182,334,2516,
Musée du Vignoble et des Vins d'Alsace,2012,ALSACE,KAYSERSBERG VIGNOBLE,4180,0,4180,
Musée National de l'Automobile - Collection Schlumpf,2012,ALSACE,MULHOUSE,154734,32276,187010,
Musée Vauban,2012,ALSACE,NEUF-BRISACH,2335,0,2335,
Musée des Amis de Thann,2012,ALSACE,THANN,847,1346,2193,
Musée d'Art et d'Archéologie du Périgord (MAAP),2012,AQUITAINE,PERIGUEUX,7381,17066,24447,
CAPC Musée d'Art Contemporain de Bordeaux,2012,AQUITAINE,BORDEAUX,26287,107016,133303,
Musée des Beaux-Arts et d'Archéologie,2012,AQUITAINE,LIBOURNE,0,16243,16243,
Musée Historique de l'Hydravion,2012,AQUITAINE,BISCARROSSE,15342,3455,18797,
Musée Despiau-Wlérick,2012,AQUITAINE,MONT-DE-MARSAN,0,12873,12873,
Musée de la Faïence et des arts de la table,2012,AQUITAINE,SAMADET,3437,2915,6352,
Muséum d'Histoire Naturelle,2012,AQUITAINE,BAYONNE,0,20266,20266,
Musée Municipal de Gannat,2012,AUVERGNE,GANNAT,865,1040,1905,
Musée Anne de Beaujeu,2012,AUVERGNE,MOULINS,21401,3031,24432,
Musée de la Dentelle,2012,AUVERGNE,ARLANC,1093,55,1148,
Musée d'Art Roger-Quillot,2012,AUVERGNE,CLERMONT-FERRAND,44300,0,44300,
Musée Alésia - Centre d'Interprétation,2012,BOURGOGNE,ALISE-SAINTE-REINE,115977,24357,140334,
Musée du Vin de Bourgogne,2012,BOURGOGNE,BEAUNE,16825,4280,21105,
Musée Archéologique,2012,BOURGOGNE,DIJON,0,28459,28459,
Musée des Beaux-Arts,2012,BOURGOGNE,DIJON,7011,134850,141861,
Musée des Beaux-Arts,2012,BOURGOGNE,MONTBARD,0,906,906,
Musée Municipal François Pompon,2012,BOURGOGNE,SAULIEU,2998,5581,8579,
Musée de la Mine,2012,BOURGOGNE,BLANZY,9297,1771,11068,
Ecomusée de la Communauté Le Creusot-Monceau-Les-Mines,2012,BOURGOGNE,LE CREUSOT,8012,3255,11267,
Musée des Ursulines,2012,BOURGOGNE,MACON,1930,19053,20983,
Musée Départemental de Préhistoire de Solutré,2012,BOURGOGNE,SOLUTRE-POUILLY,17360,12010,29370,
Muséum - Maison de l'Eau,2012,BOURGOGNE,AUXERRE,0,21588,21588,
Musée Colette,2012,BOURGOGNE,SAINT-SAUVEUR-EN-PUISAYE,6954,0,6954,
Musée de Morlaix,2012,BRETAGNE,MORLAIX,11537,8832,20369,
Musée de Préhistoire J. Miln- Z. Le-Rouzic,2012,BRETAGNE,CARNAC,25737,8415,34152,
Ecomusée de l'Île de Groix,2012,BRETAGNE,ILE DE GROIX,3431,1167,4598,
Ecomusée Industriel des Forges,2012,BRETAGNE,INZINZAC-LOCHRIST,2477,774,3251,
Musée du Berry,2012,CENTRE,BOURGES,0,14681,14681,
Musée d'Histoire Naturelle Gabriel Foucher,2012,CENTRE,BOURGES,21072,10941,32013,
Musée Emile Chénon,2012,CENTRE,CHATEAUMEILLANT,436,3041,3477,
Musée des Beaux-Arts et d'Histoire Naturelle,2012,CENTRE,CHATEAUDUN,3428,4850,8278,
Musée d'Art et d'Histoire de Dreux,2012,CENTRE,DREUX,1706,6239,7945,
Musée de l'Hospice Saint-Roch,2012,CENTRE,ISSOUDUN,149,15422,15571,
Musée Lansyer,2012,CENTRE,LOCHES,0,24178,24178,
Musée François Rabelais,2012,CENTRE,SEUILLY,10500,3543,14043,
Musée de la Maison de la Dernière Cartouche,2012,CHAMPAGNE-ARDENNES,BAZEILLES,1308,1404,2712,
Musée Arthur Rimbaud,2012,CHAMPAGNE-ARDENNES,CHARLEVILLE-MEZIERES,10880,9443,20323,
Musée du Château-Fort,2012,CHAMPAGNE-ARDENNES,SEDAN,53674,1806,55480,
Musée Municipal,2012,CHAMPAGNE-ARDENNES,CHALONS-EN-CHAMPAGNE,1093,19202,20295,
Musée des Beaux-Arts de Saint-Denis,2012,CHAMPAGNE-ARDENNES,REIMS,11380,26032,37412,
Musée de la Corse,2012,CORSE,CORTE,59255,10162,69417,
Muséum de Besançon,2012,FRANCHE-COMTE,BESANCON,244525,0,244525,
Musée Départemental Albert-et-Félicie Demard - ATP,2012,FRANCHE-COMTE,CHAMPLITTE,5466,5202,10668,
Ecomusée du Pays de la Cerise,2012,FRANCHE-COMTE,FOUGEROLLES,5887,735,6622,
Musée de la Vigne et du Vin,2012,FRANCHE-COMTE,ARBOIS,3136,1285,4421,
Musée de l'Abbaye/Donations Guy Bardone - René Genis,2012,FRANCHE-COMTE,SAINT-CLAUDE,4816,5964,10780,
Musée du Septennat,2012,FRANCHE-COMTE,CHATEAU-CHINON,10970,3783,14753,
Musée d'Art et d'Histoire,2012,FRANCHE-COMTE,BELFORT,21355,0,21355,
Musée Précolombien Edgar Clerc,2012,GUADELOUPE,LE MOULE,0,8916,8916,
Musée Territorial Alexandre Franconie,2012,GUYANE,CAYENNE,529,7860,8389,
Musée-Jardin Paul Landowski,2012,ILE-DE-FRANCE,BOULOGNE-BILLANCOURT,304,714,1018,
Musée d'Art et d'Histoire,2012,ILE-DE-FRANCE,MEUDON,0,9148,9148,
Maison de Victor Hugo,2012,ILE-DE-FRANCE,PARIS,32034,161520,193554,
Musée National Jean-Jacques Henner,2012,ILE-DE-FRANCE,PARIS,6107,4979,11086,
Musée de l'Assistance Publique - Hôpitaux de Paris,2012,ILE-DE-FRANCE,PARIS,8749,181,8930,
Musée d'Art Moderne de la ville de Paris,2012,ILE-DE-FRANCE,PARIS,158427,239973,398400,
Musée National Eugène Delacroix,2012,ILE-DE-FRANCE,PARIS,39083,20568,59651,
Musée Bossuet,2012,ILE-DE-FRANCE,MEAUX,5523,4553,10076,
Musée des Pays de Seine-et-Marne,2012,ILE-DE-FRANCE,SAINT-CYR-SUR-MORIN,1221,7215,8436,
Musée de l'Histoire Vivante,2012,ILE-DE-FRANCE,MONTREUIL-SOUS-BOIS,386,3767,4153,
Ecomusée du Val de Bièvre,2012,ILE-DE-FRANCE,FRESNES,0,10244,10244,
Musée de la Renaissance - Château d'Ecouen,2012,ILE-DE-FRANCE,ECOUEN,17492,40766,58258,
Musée Camille Pissarro,2012,ILE-DE-FRANCE,PONTOISE,0,3925,3925,
Musée National de Port Royal des Champs,2012,ILE-DE-FRANCE,MAGNY-LES-HAMEAUX,6181,11203,17384,
Muséum Agricole et Industriel Stella Matutina,2012,LA REUNION,PITON-SAINT-LEU,0,14500,14500,
Musée des Corbières,2012,LANGUEDOC-ROUSSILLON,SIGEAN,594,255,849,
Musée Archéologique,2012,LANGUEDOC-ROUSSILLON,NIMES,0,48357,48357,
Musée Paul Raymond,2012,LANGUEDOC-ROUSSILLON,PONT-SAINT-ESPRIT,0,1512,1512,
Musée de la Maison Romane,2012,LANGUEDOC-ROUSSILLON,SAINT-GILLES-DU-GARD,57,7246,7303,
Musée Municipal Georges Borias,2012,LANGUEDOC-ROUSSILLON,UZES,1412,1185,2597,
Musée Fleury,2012,LANGUEDOC-ROUSSILLON,LODEVE,31301,10156,41457,
Musée de Vulliod Saint-Germain,2012,LANGUEDOC-ROUSSILLON,PEZENAS,2979,5115,8094,
Musée Paul Valéry,2012,LANGUEDOC-ROUSSILLON,SETE,50719,7121,57840,
Ecomusée du Mont Lozère,2012,LANGUEDOC-ROUSSILLON,LE PONT DE MONTVERT,2695,1636,4331,
Musée de Tautavel,2012,LANGUEDOC-ROUSSILLON,TAUTAVEL,60554,9061,69615,
Musée de l'Histoire du Fer,2012,LORRAINE,JARVILLE-LA-MALGRANGE,4255,8226,12481,
Musée du Château de Lunéville,2012,LORRAINE,LUNEVILLE,0,191128,191128,
Musée d'Art et d'Histoire de Toul,2012,LORRAINE,TOUL,0,5333,5333,
Musée Militaire et Erckmann-Chatrian,2012,LORRAINE,PHALSBOURG,817,235,1052,
Musée Régional d'Histoire et d'Ethnologie,2012,MARTINIQUE,FORT-DE-FRANCE,2136,3423,5559,
Ecomusée de la Martinique,2012,MARTINIQUE,RIVIERE-PILOTE,6619,3887,10506,
Musée Départemental de l'Ariège,2012,MIDI-PYRENEES,FOIX,80472,6433,86905,
Musée du Palais des Evêques,2012,MIDI-PYRENEES,SAINT-LIZIER,10055,1977,12032,
Musée Joseph Vaylet,2012,MIDI-PYRENEES,ESPALION,2470,1504,3974,
Musée des Arts et Métiers Traditionnels,2012,MIDI-PYRENEES,SALLES-LA-SOURCE,5859,2061,7920,
Musée Archéologique Départemental,2012,MIDI-PYRENEES,SAINT-BERTRAND-DE-COMMINGES,0,38542,38542,
Le Musée - Arts et Figures des Pyrénées Centrales,2012,MIDI-PYRENEES,SAINT-GAUDENS,0,8167,8167,
Musée du Vieux Toulouse,2012,MIDI-PYRENEES,TOULOUSE,4758,1125,5883,
Musée Saint-Raymond,2012,MIDI-PYRENEES,TOULOUSE,14007,43170,57177,
Musée Pyrénéen,2012,MIDI-PYRENEES,LOURDES,64293,6243,70536,
Musée Départemental de Cuzals,2012,MIDI-PYRENEES,SAULIAC-SUR-CELE,6307,2781,9088,
Musée Charles Portal - Histoire et Patrimoine,2012,MIDI-PYRENEES,CORDES-SUR-CIEL,580,252,832,
Musée du Pays Rabastinois,2012,MIDI-PYRENEES,RABASTENS,917,2898,3815,
Musée Théodore Calbet,2012,MIDI-PYRENEES,GRISOLLES,0,3303,3303,
Musée du Mont-de-Piété,2012,NORD-PAS-DE-CALAIS,BERGUES,926,2962,3888,
Musée Municipal de Cambrai,2012,NORD-PAS-DE-CALAIS,CAMBRAI,3157,16169,19326,
Musée de la Chartreuse,2012,NORD-PAS-DE-CALAIS,DOUAI,6852,33729,40581,
Musée Portuaire,2012,NORD-PAS-DE-CALAIS,DUNKERQUE,26031,26040,52071,
Musée des Beaux-Arts,2012,NORD-PAS-DE-CALAIS,DUNKERQUE,5313,1253,6566,
Musée du Dessin et de l'Estampe Originale,2012,NORD-PAS-DE-CALAIS,GRAVELINES,4659,12040,16699,
Musée Municipal d'Hazebrouck,2012,NORD-PAS-DE-CALAIS,HAZEBROUCK,487,3180,3667,
Musée d'Histoire Naturelle et de Géologie,2012,NORD-PAS-DE-CALAIS,LILLE,70083,0,70083,
Musée Municipal,2012,NORD-PAS-DE-CALAIS,SAINT-AMAND-LES-EAUX,0,14006,14006,
Musée des Beaux-Arts,2012,NORD-PAS-DE-CALAIS,ARRAS,89903,84146,174049,
Musée Communautaire Opale-Sud,2012,NORD-PAS-DE-CALAIS,BERCK-SUR-MER,1407,5822,7229,
Musée d'Art et d'Histoire Roger Rodière,2012,NORD-PAS-DE-CALAIS,MONTREUIL-SUR-MER,1949,4125,6074,
Musée Jean-Charles Cazin,2012,NORD-PAS-DE-CALAIS,SAMER,0,638,638,
Musée Eugène Boudin,2012,BASSE-NORMANDIE,HONFLEUR,28924,1893,30817,
Musée de la Mine,2012,BASSE-NORMANDIE,LE MOLAY-LITTRY,3910,1274,5184,
Musée du Château,2012,BASSE-NORMANDIE,PONTECOULANT,2951,1195,4146,
Musée de la Bataille de Tilly-Sur-Seulles 1944,2012,BASSE-NORMANDIE,TILLY-SUR-SEULLES,516,724,1240,
Musée Municipal,2012,BASSE-NORMANDIE,VIRE NORMANDIE,2009,6105,8114,
Musée Quesnel-Morinière,2012,BASSE-NORMANDIE,COUTANCES,237,6510,6747,
Musée Richard Anacréon,2012,BASSE-NORMANDIE,GRANVILLE,7098,5384,12482,
Musée Municipal - Musée du Jouet,2012,BASSE-NORMANDIE,LA FERTE-MACE,675,357,1032,
Musée d'Art Moderne André Malraux - MuMa,2012,HAUTE-NORMANDIE,LE HAVRE,43070,28405,71475,
Muséum d'Histoire Naturelle,2012,HAUTE-NORMANDIE,LE HAVRE,0,55948,55948,
Musée des Sapeurs-Pompiers de France,2012,HAUTE-NORMANDIE,MONTVILLE,5648,3334,8982,
Musées du Parc Naturel Régional de Brière,2012,PAYS DE LA LOIRE,SAINT-JOACHIM,1466,0,1466,
Musée d'Art et d'Histoire,2012,PAYS DE LA LOIRE,CHOLET,1969,13345,15314,
Musée du Textile,2012,PAYS DE LA LOIRE,CHOLET,6567,7012,13579,
Château-Musée,2012,PAYS DE LA LOIRE,SAUMUR,72157,18320,90477,
Musée du Château,2012,PAYS DE LA LOIRE,NOIRMOUTIER-EN-L'ILE,36700,7080,43780,
Musée Franco-Américain du Château de Blérancourt,2012,PICARDIE,BLERANCOURT,355,779,1134,
Familistère de Guise,2012,PICARDIE,GUISE,45744,7729,53473,
Musée Alexandre Dumas,2012,PICARDIE,VILLERS COTTERETS,702,774,1476,
Musée Départemental de l'Oise,2012,PICARDIE,BEAUVAIS,0,27710,27710,
Musée Pillon,2012,PICARDIE,CHAUMONT-EN-VEXIN,0,461,461,
Musée Antoine Vivenel,2012,PICARDIE,COMPIEGNE,1417,8721,10138,
Musée Jean Calvin,2012,PICARDIE,NOYON,1980,1036,3016,
Musée Boucher-de-Perthes,2012,PICARDIE,ABBEVILLE,3192,5737,8929,
Musée Lombart,2012,PICARDIE,DOULLENS,277,4583,4860,
Musée des Beaux-Arts,2012,POITOU-CHARENTES,ANGOULEME,6119,28642,34761,
Musée Protestant,2012,POITOU-CHARENTES,LA ROCHELLE,1845,1565,3410,
Musée National de la Marine,2012,POITOU-CHARENTES,ROCHEFORT,22872,21766,44638,
Musée de l'Echevinage,2012,POITOU-CHARENTES,SAINTES,203,6028,6231,
Musée de l'Ile d'Oléron,2012,POITOU-CHARENTES,ST-PIERRE D'OLERON,10517,2721,13238,
Musée de Bressuire,2012,POITOU-CHARENTES,BRESSUIRE,0,1642,1642,
Musée Henri Barré,2012,POITOU-CHARENTES,THOUARS,408,1382,1790,
Musée de Préhistoire Raymond Touchard,2012,POITOU-CHARENTES,LUSSAC-LES-CHATEAUX,1880,1089,2969,
Musée Municipal de la Maison-Dieu,2012,POITOU-CHARENTES,MONTMORILLON,0,2847,2847,
Musée Fernand Léger,2012,PROVENCE-ALPES-CÔTE D'AZUR,BIOT,15549,17847,33396,
Musée de la Castre,2012,PROVENCE-ALPES-CÔTE D'AZUR,CANNES,13836,15075,28911,
Musée de la Mer,2012,PROVENCE-ALPES-CÔTE D'AZUR,CANNES,43317,36718,80035,
Musée International de la Parfumerie,2012,PROVENCE-ALPES-CÔTE D'AZUR,GRASSE,64521,32016,96537,
Musée du Vieux-Logis de Nice,2012,PROVENCE-ALPES-CÔTE D'AZUR,NICE,0,166,166,
Musée du Palais Lascaris,2012,PROVENCE-ALPES-CÔTE D'AZUR,NICE,0,95341,95341,
Musée du Parlement de Provence et du Vieil Aix,2012,PROVENCE-ALPES-CÔTE D'AZUR,AIX-EN-PROVENCE,0,31675,31675,
Musée des Tapisseries,2012,PROVENCE-ALPES-CÔTE D'AZUR,AIX-EN-PROVENCE,4829,15862,20691,
Musée de la Légion Etrangère,2012,PROVENCE-ALPES-CÔTE D'AZUR,AUBAGNE/PUYLOUBIER,0,11876,11876,
Musée Municipal Méditerranéen de Cassis A.T.P.,2012,PROVENCE-ALPES-CÔTE D'AZUR,CASSIS,0,9003,9003,
Musée d'Histoire et d'Archéologie des Baux-de-Provence,2012,PROVENCE-ALPES-CÔTE D'AZUR,LES BAUX DE PROVENCE,229250,23750,253000,
Musée des Docks Romains,2012,PROVENCE-ALPES-CÔTE D'AZUR,MARSEILLE,0,6830,6830,
Musée de la Faïence,2012,PROVENCE-ALPES-CÔTE D'AZUR,MARSEILLE,2225,3861,6086,
Musée des A.T.P. de Moyenne Provence,2012,PROVENCE-ALPES-CÔTE D'AZUR,DRAGUIGNAN,2445,8726,11171,
Musée des Troupes de Marine,2012,PROVENCE-ALPES-CÔTE D'AZUR,FREJUS,0,15976,15976,
Musée du Vêtement Provençal (Jean Aicard),2012,PROVENCE-ALPES-CÔTE D'AZUR,SOLLIES-VILLE,0,6108,6108,
Muséum d'Histoire Naturelle de Toulon et du Var,2012,PROVENCE-ALPES-CÔTE D'AZUR,TOULON,0,91244,91244,
Musée National de la Marine de Toulon,2012,PROVENCE-ALPES-CÔTE D'AZUR,TOULON,22670,37394,60064,
Musée Jean Garcin 39-45 : L'appel de la Liberté,2012,PROVENCE-ALPES-CÔTE D'AZUR,FONTAINE-DE-VAUCLUSE,2911,9205,12116,
Musée Municipal Camille Pautet,2012,PROVENCE-ALPES-CÔTE D'AZUR,MAZAN,0,1846,1846,
Musée du Brou,2012,RHONE-ALPES,BOURG-EN-BRESSE,37587,36635,74222,
Musée du Peigne et de la Plasturgie,2012,RHONE-ALPES,OYONNAX,2278,5408,7686,
Musée de la Bresse - Domaine des Planons,2012,RHONE-ALPES,SAINT-CYR-SUR-MENTHON,11229,8500,19729,
Musée du site Préhistorique,2012,RHONE-ALPES,VASSIEUX-EN-VERCORS,12625,0,12625,
Musée-château d'Annecy,2012,RHONE-ALPES,ANNECY,53729,44427,98156,
Musée Géo-Charles,2012,RHONE-ALPES,ECHIROLLES,0,7542,7542,
Musée de Grenoble,2012,RHONE-ALPES,GRENOBLE,87397,99263,186660,
Musée Lapidaire Saint-Pierre,2012,RHONE-ALPES,VIENNE,4752,8170,12922,
Musée d'Histoire du  20ème Siècle - Résistance et Déportation,2012,RHONE-ALPES,ESTIVAREILLES,2028,697,2725,
Musée d'Archéologie,2012,RHONE-ALPES,FEURS,1719,4146,5865,
Musée des Sapeurs-Pompiers de Lyon,2012,RHONE-ALPES,LYON,3608,1516,5124,
Musée d'Art Contemporain de Lyon,2012,RHONE-ALPES,LYON,123032,0,123032,
Musée archéologique et minéralogique Pierre Borrione,2012,RHONE-ALPES,AIME-EN-TARENTAISE,540,332,872,
Musée des Beaux-Arts,2012,RHONE-ALPES,CHAMBERY,31895,12579,44474,
Musée du Fer,2013,ALSACE,REICHSHOFFEN,845,672,1517,
Musée de la Bataille du 6 Août 1870,2013,ALSACE,WOERTH,1792,257,2049,
Musée Sundgauvien d'Altkirch,2013,ALSACE,ALTKIRCH,1030,2168,3198,
Musée Théodore Deck et des Pays du Florival,2013,ALSACE,GUEBWILLER,1335,4594,5929,
Musée Historique et Militaire de Huningue,2013,ALSACE,HUNINGE,168,188,356,
Cité du Train,2013,ALSACE,MULHOUSE,78346,9125,87471,
Musée EDF Electropolis,2013,ALSACE,MULHOUSE,30679,7302,37981,
Musée du Dolder,2013,ALSACE,RIQUEWIHR,1666,467,2133,
Musée d'Aquitaine,2013,AQUITAINE,BORDEAUX,16796,130263,147059,
Musée de Borda,2013,AQUITAINE,DAX,2553,6614,9167,
Musée de la Chalosse,2013,AQUITAINE,MONTFORT-EN-CHALOSSE,5729,2412,8141,
Musée Municipal du Lac,2013,AQUITAINE,SANGUINET,1281,330,1611,
Musée du Château Henri IV,2013,AQUITAINE,NERAC,17469,8353,25822,
Musée Municipal de Guéthary,2013,AQUITAINE,GUETHARY,525,1528,2053,
Musée National du Château,2013,AQUITAINE,PAU,52299,38269,90568,
Musée Bernadotte,2013,AQUITAINE,PAU,1345,3205,4550,
Musée Municipal de Gannat,2013,AUVERGNE,GANNAT,401,1003,1404,
Musée d'Art Roger-Quillot,2013,AUVERGNE,CLERMONT-FERRAND,5295,21077,26372,
Musée Départemental de la Céramique Gallo-Romaine,2013,AUVERGNE,LEZOUX,6673,4762,11435,
Musée Francisque Mandet,2013,AUVERGNE,RIOM,3408,14176,17584,
Musée Régional d'Auvergne,2013,AUVERGNE,RIOM,357,1227,1584,
Musée du Vin de Bourgogne,2013,BOURGOGNE,BEAUNE,17469,4126,21595,
Musée Archéologique,2013,BOURGOGNE,DIJON,0,27409,27409,
Musée des Beaux-Arts,2013,BOURGOGNE,MONTBARD,0,1770,1770,
Musée du Septennat,2013,BOURGOGNE,CHATEAU-CHINON,9344,3469,12813,
Musée du Grès de Puisaye,2013,BOURGOGNE,SAINT-AMAND-EN-PUISAYE,2413,0,2413,
Musée Auguste Grasset,2013,BOURGOGNE,VARZY,2288,0,2288,
Musée Saint-Nazaire,2013,BOURGOGNE,BOURBON-LANCY,0,892,892,
Musée du Prieuré de Charolles,2013,BOURGOGNE,CHAROLLES,1148,1260,2408,
Muséum - Maison de l'Eau,2013,BOURGOGNE,AUXERRE,0,17259,17259,
Musée d'Art et d'Histoire,2013,BOURGOGNE,AUXERRE,7576,25528,33104,
Musée Leblanc-Duvernois,2013,BOURGOGNE,AUXERRE,0,882,882,
Musée de l'Aventure du Son,2013,BOURGOGNE,SAINT-FARGEAU,3980,789,4769,
Musée Mathurin Meheut,2013,BRETAGNE,LAMBALLE,4232,1008,5240,
Musée des Phares et Balises,2013,BRETAGNE,OUESSANT,12869,2747,15616,
Musée International du Long-Cours Cap-Hornier,2013,BRETAGNE,SAINT-MALO,7191,4583,11774,
Musée de la Compagnie des Indes,2013,BRETAGNE,PORT-LOUIS,33839,29209,63048,
Musée de la Résistance Bretonne,2013,BRETAGNE,SAINT-MARCEL - MALESTROIT,15920,2211,18131,
Musée du Berry,2013,CENTRE,BOURGES,0,13613,13613,
Musée d'Histoire Naturelle Gabriel Foucher,2013,CENTRE,BOURGES,26314,5372,31686,
Musée Saint-Vic,2013,CENTRE,SAINT-AMAND-MONTROND,0,3398,3398,
Musée de l'Histoire du Perche,2013,CENTRE,NOGENT-LE-ROTROU,8744,6471,15215,
Musées de Châteauroux - Hôtel Bertrand,2013,CENTRE,CHATEAUROUX,236,17195,17431,
Musée Archéologique d'Argentomagus,2013,CENTRE,SAINT-MARCEL,7858,6455,14313,
Musée du Savignéen,2013,CENTRE,SAVIGNE-SUR-LATHAN,1915,352,2267,
Musée des Beaux-Arts,2013,CENTRE,TOURS,17547,36723,54270,
Muséum d'Histoire Naturelle,2013,CENTRE,BLOIS,5998,7684,13682,
Musée de Sologne,2013,CENTRE,ROMORANTIN-LANTHENAY,4746,10198,14944,
Musée Historique et Archéologique,2013,CENTRE,ORLEANS,997,8165,9162,
Musée Arthur Rimbaud,2013,CHAMPAGNE-ARDENNES,CHARLEVILLE-MEZIERES,5410,5981,11391,
Musée Paul Dubois-Alfred Boucher,2013,CHAMPAGNE-ARDENNES,NOGENT-SUR-SEINE,2226,4297,6523,
Maison de l'Outil  et de la Pensée Ouvrière,2013,CHAMPAGNE-ARDENNES,TROYES,10845,6488,17333,
Musée Hôtel le Vergeur,2013,CHAMPAGNE-ARDENNES,REIMS,9527,414,9941,
Musée de l'Ancien Collège des Jésuites/Planétarium,2013,CHAMPAGNE-ARDENNES,REIMS,6842,12670,19512,
Musée de la Maison Bonaparte,2013,CORSE,AJACCIO,43690,24224,67914,
Musée d'archéologie d'Aleria - Jérôme Carcopino,2013,CORSE,ALERIA,30633,25173,55806,
Musée Départemental Pascal Paoli,2013,CORSE,MOROSAGLIA,7136,2351,9487,
Musée Beurnier-Rossel,2013,FRANCHE-COMTE,MONTBELIARD,961,3643,4604,
Musée du Château des Ducs de Wurtemberg,2013,FRANCHE-COMTE,MONTBELIARD,5442,12687,18129,
Musée Départemental Albert-et-Félicie Demard - ATP,2013,FRANCHE-COMTE,CHAMPLITTE,6627,5308,11935,
Musée des Beaux-Arts,2013,FRANCHE-COMTE,DOLE,0,21681,21681,
Viséum-Musée de la Lunette,2013,FRANCHE-COMTE,MOREZ HAUTS DE BIENNE,9906,6202,16108,
Musée de l'Abbaye/Donations Guy Bardone - René Genis,2013,FRANCHE-COMTE,SAINT-CLAUDE,3854,5568,9422,
Donation Maurice Jardot,2013,FRANCHE-COMTE,BELFORT,6491,0,6491,
Forge-Musée,2013,FRANCHE-COMTE,ETUEFFONT,857,1179,2036,
Musée Municipal Saint-John Perse,2013,GUADELOUPE,POINTE-A-PITRE,1949,1159,3108,
Musée Intercommunal d'Etampes,2013,ILE-DE-FRANCE,ETAMPES,616,6062,6678,
Musée d'Art et d'Histoire,2013,ILE-DE-FRANCE,MEUDON,3318,7063,10381,
Musée - Atelier Rodin (Annexe du musée de Paris),2013,ILE-DE-FRANCE,MEUDON,6820,9964,16784,
Galerie de Botanique (Muséum National National d'Histoire Naturelle),2013,ILE-DE-FRANCE,PARIS,2127,2043,4170,
"Petit Palais, Musée des Beaux-Arts de la ville de Paris",2013,ILE-DE-FRANCE,PARIS,164506,364466,528972,
Musée de la Franc-Maçonnerie,2013,ILE-DE-FRANCE,PARIS,11644,2683,14327,
Musée de Montmartre,2013,ILE-DE-FRANCE,PARIS,81000,4000,85000,
Mémorial du Maréchal Leclerc de Hauteclocque et de la Libération de Paris-musée Jean Moulin,2013,ILE-DE-FRANCE,PARIS,5039,13654,18693,
Musée National Auguste Rodin,2013,ILE-DE-FRANCE,PARIS,442403,247479,689882,
Etablissement public du musée d'Orsay et de l'Orangerie - Musée d'Orsay,2013,ILE-DE-FRANCE,PARIS,2017847,1449474,3467321,
Établissement Public de la Porte Dorée - Cité Nationale de l’Histoire de l’Immigration,2013,ILE-DE-FRANCE,PARIS,38486,53594,92080,
Musée Municipal de Chelles Alfred Bonno,2013,ILE-DE-FRANCE,CHELLES,0,3150,3150,
Musée du Château de Fontainebleau,2013,ILE-DE-FRANCE,FONTAINEBLEAU,245658,208214,453872,
Musée Bossuet,2013,ILE-DE-FRANCE,MEAUX,5028,4518,9546,
Musée Départemental de Préhistoire d'Île de France,2013,ILE-DE-FRANCE,NEMOURS,6607,27646,34253,
Ecomusée,2013,ILE-DE-FRANCE,SAVIGNY-LE-TEMPLE,665,7914,8579,
Musée Archéologique du Val d'Oise,2013,ILE-DE-FRANCE,GUIRY-EN-VEXIN,0,10901,10901,
Musée Camille Pissarro,2013,ILE-DE-FRANCE,PONTOISE,0,4003,4003,
Musée Promenade Marly/Louveciennes,2013,ILE-DE-FRANCE,LOUVECIENNES,7430,2881,10311,
Musée du Jouet Pierre Pinel,2013,ILE-DE-FRANCE,POISSY,11658,5967,17625,
Musée Municipal - Collections Paul et André Véra,2013,ILE-DE-FRANCE,SAINT-GERMAIN-EN-LAYE,0,2176,2176,
Musée Départemental de la Réunion - Musée Léon Dierx,2013,LA REUNION,SAINT-DENIS,2528,17959,20487,
Musée Albert André,2013,LANGUEDOC-ROUSSILLON,BAGNOLS-SUR-CEZE,29,4805,4834,
Musée Léon Alègre,2013,LANGUEDOC-ROUSSILLON,BAGNOLS-SUR-CEZE,0,1702,1702,
Musée Municipal de la Vignasse,2013,LANGUEDOC-ROUSSILLON,BEAUCAIRE,1598,2673,4271,
Musée du Biterrois,2013,LANGUEDOC-ROUSSILLON,BEZIERS,1904,11925,13829,
Musée de l'Ephèbe,2013,LANGUEDOC-ROUSSILLON,LE CAP D'AGDE,9060,6899,15959,
Musée Archéologique,2013,LANGUEDOC-ROUSSILLON,MINERVE,4118,0,4118,
Musée d'Art Moderne - Fonds Peskè,2013,LANGUEDOC-ROUSSILLON,COLLIOURE,10505,3969,14474,
Muséum d'Histoire Naturelle,2013,LANGUEDOC-ROUSSILLON,PERPIGNAN,0,11811,11811,
Musée du Président Jacques Chirac,2013,LIMOUSIN,SARRAN,25413,6609,32022,
Musée du Pays d'Ussel,2013,LIMOUSIN,USSEL,0,2636,2636,
Musée du Château de Lunéville,2013,LORRAINE,LUNEVILLE,9557,132745,142302,
Palais des ducs de Lorraine - Musée Historique Lorrain,2013,LORRAINE,NANCY,26174,37053,63227,
Musée d'Art et d'Histoire de Toul,2013,LORRAINE,TOUL,0,5239,5239,
Musées de la Cour d'Or,2013,LORRAINE,METZ,18732,26174,44906,
Musée du Pays de Sarrebourg,2013,LORRAINE,SARREBOURG,8690,9743,18433,
Musée Pierre Noël - Musée de la Vie dans les Hautes-Vosges,2013,LORRAINE,SAINT-DIE-DES-VOSGES,2440,13404,15844,
Ecomusée de la Martinique,2013,MARTINIQUE,RIVIERE-PILOTE,6467,4541,11008,
Musée Volcanologique Franck Arnold Perret,2013,MARTINIQUE,SAINT-PIERRE,22491,957,23448,
Musée Joseph Abeilhé,2013,MIDI-PYRENEES,MARCIAC,110,55,165,
Musée Archéologique Départemental,2013,MIDI-PYRENEES,SAINT-BERTRAND-DE-COMMINGES,0,58393,58393,
Musée du Vieux Toulouse,2013,MIDI-PYRENEES,TOULOUSE,6346,935,7281,
Musée Henri Martin,2013,MIDI-PYRENEES,CAHORS,3041,6936,9977,
Musée Murat,2013,MIDI-PYRENEES,CŒUR DE CAUSSE,704,149,853,
Musée Champollion - Les Ecriture du Monde,2013,MIDI-PYRENEES,FIGEAC,28935,11353,40288,
Musée du Vieux Figeac,2013,MIDI-PYRENEES,FIGEAC,347,615,962,
Musée Départemental de Cuzals,2013,MIDI-PYRENEES,SAULIAC-SUR-CELE,6937,2755,9692,
Musée Raymond Lafage,2013,MIDI-PYRENEES,LISLE-SUR-TARN,2324,4924,7248,
Musée Départemental de Flandre,2013,NORD-PAS-DE-CALAIS,CASSEL,27085,22941,50026,
Musée Municipal d'Escaudain,2013,NORD-PAS-DE-CALAIS,ESCAUDAIN,0,327,327,
Ecomusée de la Région,2013,NORD-PAS-DE-CALAIS,FOURMIES,20045,12533,32578,
Musée Municipal d'Hazebrouck,2013,NORD-PAS-DE-CALAIS,HAZEBROUCK,2155,6415,8570,
Musée de l'Hospice Comtesse,2013,NORD-PAS-DE-CALAIS,LILLE,89900,0,89900,
Musée d'Histoire Naturelle et de Géologie,2013,NORD-PAS-DE-CALAIS,LILLE,67520,0,67520,
Musée du Verre,2013,NORD-PAS-DE-CALAIS,SARS-POTERIES,9437,9271,18708,
Musée des Beaux-Arts,2013,NORD-PAS-DE-CALAIS,ARRAS,56170,81097,137267,
Musée Régional d'Ethnologie,2013,NORD-PAS-DE-CALAIS,BETHUNE,0,1620,1620,
Musée d'Art et d'Histoire Roger Rodière,2013,NORD-PAS-DE-CALAIS,MONTREUIL-SUR-MER,13830,12226,26056,
Musée de l'Hôtel Sandelin,2013,NORD-PAS-DE-CALAIS,SAINT-OMER,7635,8610,16245,
Musée du Débarquement,2013,BASSE-NORMANDIE,ARROMANCHES,286417,11835,298252,
Château de Saint-Germain de Livet,2013,BASSE-NORMANDIE,SAINT-GERMAIN DE LIVET,9535,8421,17956,
Musée de la Bataille de Tilly-Sur-Seulles 1944,2013,BASSE-NORMANDIE,TILLY-SUR-SEULLES,432,734,1166,
Musée Barbey d'Aurevilly,2013,BASSE-NORMANDIE,SAINT-SAUVEUR-LE-VICOMTE,722,185,907,
Musée Maritime de l'Ile de Tatihou,2013,BASSE-NORMANDIE,SAINT-VAAST-LA-HOUGUE,58859,5118,63977,
Musée Municipal d'Archéologie,2013,BASSE-NORMANDIE,L'AIGLE,527,397,924,
Musée Municipal Nicolas Poussin,2013,HAUTE-NORMANDIE,LES ANDELYS,1188,2521,3709,
Château-Musée de Dieppe,2013,HAUTE-NORMANDIE,DIEPPE,22444,10210,32654,
Musée d'Art Moderne André Malraux - MuMa,2013,HAUTE-NORMANDIE,LE HAVRE,61627,45852,107479,
Abbaye de Graville - Musée du Prieuré de Graville,2013,HAUTE-NORMANDIE,LE HAVRE,1163,4861,6024,
Musée Mathon-Durand,2013,HAUTE-NORMANDIE,NEUFCHATEL-EN-BRAY,449,2376,2825,
Musée de la Céramique,2013,HAUTE-NORMANDIE,ROUEN,3681,4099,7780,
Muséum d'Histoire Naturelle,2013,HAUTE-NORMANDIE,ROUEN,14740,13863,28603,
Musée des Beaux-Arts,2013,HAUTE-NORMANDIE,ROUEN,145344,105836,251180,
Musée Victor Hugo,2013,HAUTE-NORMANDIE,VILLEQUIER,4900,7802,12702,
Musée d'Art de Nantes,2013,PAYS DE LA LOIRE,NANTES,17621,136028,153649,
Ecomusée de Saint-Nazaire,2013,PAYS DE LA LOIRE,SAINT-NAZAIRE,28139,14912,43051,
Musée Jean Lurcat et de la Tapisserie Contemporaine,2013,PAYS DE LA LOIRE,ANGERS,15386,43502,58888,
Musée de la Vigne et du Vin d'Anjou,2013,PAYS DE LA LOIRE,SAINT LAMBERT-DU-LATTAY - VAL-DU-LAYON,6250,1466,7716,
Château-Musée,2013,PAYS DE LA LOIRE,SAUMUR,77110,19659,96769,
Musée Communal Robert Tatin,2013,PAYS DE LA LOIRE,COSSE-LE-VIVIEN,16889,3963,20852,
Musée de la Reine Bérengère,2013,PAYS DE LA LOIRE,LE MANS,2316,6124,8440,
Musée de l'Abbaye de Sainte-Croix,2013,PAYS DE LA LOIRE,LES SABLES D'OLONNE,7064,15033,22097,
Musée Clemenceau et de Lattre-de-Tassigny,2013,PAYS DE LA LOIRE,MOUILLERON-EN-PAREDS,1517,2856,4373,
Musée Franco-Américain du Château de Blérancourt,2013,PICARDIE,BLERANCOURT,179,620,799,
Musée Départemental de l'Oise,2013,PICARDIE,BEAUVAIS,0,19913,19913,
Musée Napoléonien et Africain,2013,POITOU-CHARENTES,ILE D'AIX,11319,10556,21875,
Musée National de la Marine,2013,POITOU-CHARENTES,ROCHEFORT,18786,19094,37880,
Musée de l'Ile d'Oléron,2013,POITOU-CHARENTES,ST-PIERRE D'OLERON,9330,3462,12792,
Musée Henri Barré,2013,POITOU-CHARENTES,THOUARS,386,2066,2452,
Musée Charbonneau-Lassay,2013,POITOU-CHARENTES,LOUDUN,0,911,911,
Musée de Salagon,2013,PROVENCE-ALPES-CÔTE D'AZUR,MANE,35228,0,35228,
Musée départemental de préhistoire,2013,PROVENCE-ALPES-CÔTE D'AZUR,QUINSON,60634,9601,70235,
Musée archéologique,2013,PROVENCE-ALPES-CÔTE D'AZUR,VACHERES,500,222,722,
Musée Picasso,2013,PROVENCE-ALPES-CÔTE D'AZUR,ANTIBES,85728,43366,129094,
Musée Fernand Léger,2013,PROVENCE-ALPES-CÔTE D'AZUR,BIOT,14644,13920,28564,
Musée-Château de Cagnes,2013,PROVENCE-ALPES-CÔTE D'AZUR,CAGNES-SUR-MER,18629,13642,32271,
Musée de la Mer,2013,PROVENCE-ALPES-CÔTE D'AZUR,CANNES,44519,35981,80500,
Musée du Palais Lascaris,2013,PROVENCE-ALPES-CÔTE D'AZUR,NICE,21295,81225,102520,
Musée d'Art et d'Histoire,2013,PROVENCE-ALPES-CÔTE D'AZUR,NICE,24055,52781,76836,
Musée d'Art Moderne et d'Art Contemporain,2013,PROVENCE-ALPES-CÔTE D'AZUR,NICE,24953,134242,159195,
Musée d'Art Contemporain - Galeries Contemporaines,2013,PROVENCE-ALPES-CÔTE D'AZUR,MARSEILLE,10842,16329,27171,
Musée Municipal Paul Lafran,2013,PROVENCE-ALPES-CÔTE D'AZUR,SAINT-CHAMAS,0,4487,4487,
Musée des A.T.P. de Moyenne Provence,2013,PROVENCE-ALPES-CÔTE D'AZUR,DRAGUIGNAN,2376,7603,9979,
Musée Municipal,2013,PROVENCE-ALPES-CÔTE D'AZUR,HYERES,4744,4032,8776,
Musée de l'Annonciade,2013,PROVENCE-ALPES-CÔTE D'AZUR,SAINT-TROPEZ,33831,7586,41417,
Musée d'Art et d'Archéologie,2013,PROVENCE-ALPES-CÔTE D'AZUR,TOULON,0,23825,23825,
Musée Calvet (et musée Lapidaire),2013,PROVENCE-ALPES-CÔTE D'AZUR,AVIGNON,12917,21016,33933,
Musée Sobirats,2013,PROVENCE-ALPES-CÔTE D'AZUR,CARPENTRAS,333,730,1063,
Synagogue Musée Juif Comtadin,2013,PROVENCE-ALPES-CÔTE D'AZUR,CAVAILLON,2861,1995,4856,
Musée-Bibliothèque François Pétrarque,2013,PROVENCE-ALPES-CÔTE D'AZUR,FONTAINE-DE-VAUCLUSE,2095,1535,3630,
Musée Jean Garcin 39-45 : L'appel de la Liberté,2013,PROVENCE-ALPES-CÔTE D'AZUR,FONTAINE-DE-VAUCLUSE,3117,7387,10504,
Musée Départemental du Cartonnage et de l'Imprimerie,2013,PROVENCE-ALPES-CÔTE D'AZUR,VALREAS,2275,1753,4028,
Musée Archéologique,2013,RHONE-ALPES,IZERNORE,940,1590,2530,
Musée du Peigne et de la Plasturgie,2013,RHONE-ALPES,OYONNAX,1452,4097,5549,
Musée Louis Jourdan,2013,RHONE-ALPES,SAINT-PAUL-DE-VARAX,217,47,264,
Musée d'Art Sacré,2013,RHONE-ALPES,MOURS SAINT-EUSEBE,227,598,825,
"Notre histoire, Musée de Rumilly",2013,RHONE-ALPES,RUMILLY,2197,0,2197,
Musée Gallo-Romain,2013,RHONE-ALPES,AOSTE,5334,7507,12841,
Musée de Bourgoin-Jallieu,2013,RHONE-ALPES,BOURGOIN-JALLIEU,2512,6283,8795,
Musée - Parc Archéologique du Lac de Paladru,2013,RHONE-ALPES,CHARAVINES,5474,758,6232,
Musée de la Soierie,2013,RHONE-ALPES,CHARLIEU,5440,1888,7328,
Atelier - Musée du Chapeau,2013,RHONE-ALPES,CHAZELLES-SUR-LYON,16051,10219,26270,
Musée d'Archéologie,2013,RHONE-ALPES,FEURS,1133,4041,5174,
Musée d'Art Moderne et Contemporain,2013,RHONE-ALPES,SAINT-ETIENNE,34770,37641,72411,
Musée Barthélemy-Thimonnier,2013,RHONE-ALPES,AMPLEPUIS,3853,3416,7269,
Musée Historique des Tissus,2013,RHONE-ALPES,LYON,34707,22283,56990,
Musée des Beaux-Arts,2013,RHONE-ALPES,LYON,116757,214690,331447,
Musée de l'Imprimerie et de la Communication Graphique,2013,RHONE-ALPES,LYON,17453,13817,31270,
Musée Paul Dini,2013,RHONE-ALPES,VILLEFRANCHE-SUR-SAONE,7413,14771,22184,
Musée Municipal,2013,ST PIERRE ET MIQUELON,SAINT-PIERRE ET MIQUELON,2098,577,2675,
Musée de la Folie Marco,2014,ALSACE,BARR,1865,2685,4550,
Musée de la Poterie,2014,ALSACE,BETSCHDORF,2020,293,2313,
Maison de l'Archéologie des Vosges du Nord,2014,ALSACE,NIEDERBRONN-LES-BAINS,2008,680,2688,
Cabinet des Estampes et des Dessins,2014,ALSACE,STRASBOURG,0,543,543,
Musée Lalique,2014,ALSACE,WINGEN-SUR-MODER,41478,10448,51926,
Musée Westercamp,2014,ALSACE,WISSEMBOURG,0,6492,6492,
Musée d'Unterlinden,2014,ALSACE,COLMAR,154080,30679,184759,
Musée de l'Impression sur Etoffes,2014,ALSACE,MULHOUSE,36951,0,36951,
Château de Bourdeilles,2014,AQUITAINE,BOURDEILLES,27680,281,27961,
Musée Paul Reclus,2014,AQUITAINE,DOMME,0,17590,17590,
Musée des Arts et Traditions Populaires du Périgord,2014,AQUITAINE,MUSSIDAN,891,1057,1948,
Musée d'Art et d'Archéologie du Périgord (MAAP),2014,AQUITAINE,PERIGUEUX,6794,17518,24312,
Musée des Arts Décoratifs et du Design,2014,AQUITAINE,BORDEAUX,11004,35036,46040,
Musée Charles-Louis Philippe,2014,AUVERGNE,CERILLY,168,258,426,
Musée Municipal de Gannat,2014,AUVERGNE,GANNAT,521,549,1070,
Musée des Musiques Populaires - MuPop,2014,AUVERGNE,MONTLUCON,22582,2221,24803,
Centre National du Costume de Scène et de la Scénographie,2014,AUVERGNE,MOULINS,53201,14132,67333,
Musée de la Haute Auvergne,2014,AUVERGNE,SAINT-FLOUR,1618,5264,6882,
Château de Grignan,2014,AUVERGNE,GRIGNAN,99745,72584,172329,
Musée du Château des Adhémars,2014,AUVERGNE,MONTELIMAR,11445,7631,19076,
Musée des Arts et Traditions Populaires de Haute Loire,2014,AUVERGNE,LAVAUDIEU,8694,655,9349,
Musée de la Loire,2014,BOURGOGNE,COSNE-SUR-LOIRE,1247,3989,5236,
"L'Atelier d'un Journal"" de Louhans - Musée Municipal",2014,BOURGOGNE,LOUHANS,1496,3531,5027,
Ecomusée de la Bresse Bourguignonne,2014,BOURGOGNE,PIERRE-DE-BRESSE,26033,15560,41593,
Musée Zervos - Maison Romain Rolland,2014,BOURGOGNE,VEZELAY,6128,2939,9067,
Musée des Beaux-Arts de Brest,2014,BRETAGNE,BREST,5797,16067,21864,
Ecomusée d'Ouessant - Vivre sur une Ile,2014,BRETAGNE,OUESSANT,8095,1173,9268,
Musée de Pont-Aven,2014,BRETAGNE,PONT-AVEN,316,7560,7876,
Musée des Beaux-Arts,2014,BRETAGNE,QUIMPER,77888,13880,91768,
Musée des Rochers-Sévigné,2014,BRETAGNE,VITRE,4664,0,4664,
Musée du Château de Vitré,2014,BRETAGNE,VITRE,15339,6828,22167,
Musée de Préhistoire J. Miln- Z. Le-Rouzic,2014,BRETAGNE,CARNAC,28647,6409,35056,
Musée de la Compagnie des Indes,2014,BRETAGNE,PORT-LOUIS,37898,29049,66947,
Musée d'Histoire et d'Archéologie de Vannes,2014,BRETAGNE,VANNES,1822,3478,5300,
Musée Municipal,2014,CENTRE,VIERZON,0,7095,7095,
Musées de Châteauroux - Hôtel Bertrand,2014,CENTRE,CHATEAUROUX,0,22564,22564,
Musée de l'Hospice Saint-Roch,2014,CENTRE,ISSOUDUN,374,16282,16656,
Musée Ornithologique (Ecomusée de la Brenne),2014,CENTRE,LE BLANC,1533,1442,2975,
Musée Archéologique d'Argentomagus,2014,CENTRE,SAINT-MARCEL,7792,6527,14319,
Musée Municipal,2014,CENTRE,SAINTE-MAURE-DE-TOURAINE,0,335,335,
Musée du Savignéen,2014,CENTRE,SAVIGNE-SUR-LATHAN,1912,0,1912,
Musée François Rabelais,2014,CENTRE,SEUILLY,9854,2523,12377,
Musée du Compagnonnage,2014,CENTRE,TOURS,27806,17145,44951,
Maison de la Magie,2014,CENTRE,BLOIS,68895,20693,89588,
Atelier Musée Louis Leygue,2014,CENTRE,NAVEIL,0,52,52,
Maison des Ailleurs - Arthur Rimbaud (Annexe du musée Rimbaud),2014,CHAMPAGNE-ARDENNES,CHARLEVILLE-MEZIERES,5446,0,5446,
Musée du Feutre,2014,CHAMPAGNE-ARDENNES,MOUZON,3614,974,4588,
Musée des Beaux-Arts,2014,CHAMPAGNE-ARDENNES,TROYES,3313,16801,20114,
Musée Municipal,2014,CHAMPAGNE-ARDENNES,SAINT-DIZIER,0,6710,6710,
Musée Garinet,2014,CHAMPAGNE-ARDENNES,CHALONS-EN-CHAMPAGNE,194,1072,1266,
Musée des Beaux-Arts de Saint-Denis,2014,CHAMPAGNE-ARDENNES,REIMS,22782,24777,47559,
Musée Palais Fesch,2014,CORSE,AJACCIO,23667,16508,40175,
Musée de l'Alta Rocca,2014,CORSE,LEVIE,5619,12610,18229,
Musée du Temps,2014,FRANCHE-COMTE,BESANCON,8029,32118,40147,
Forge-Musée,2014,FRANCHE-COMTE,ETUEFFONT,816,1079,1895,
Musée Territorial Alexandre Franconie,2014,GUYANE,CAYENNE,2857,5332,8189,
Musée du Château,2014,ILE-DE-FRANCE,DOURDAN,10472,7020,17492,
Musée Belmondo et de la Sculpture Figurative du XXè siècle,2014,ILE-DE-FRANCE,BOULOGNE-BILLANCOURT,6148,0,6148,
Musée Roybet Fould,2014,ILE-DE-FRANCE,COURBEVOIE,0,13122,13122,
MUS - Musée d'Histoire Urbaine et Sociale,2014,ILE-DE-FRANCE,SURESNES,1059,5876,6935,
Les Catacombes,2014,ILE-DE-FRANCE,PARIS,301204,55558,356762,
Musée National de la Marine,2014,ILE-DE-FRANCE,PARIS,100377,51983,152360,
Musée de l'Armée,2014,ILE-DE-FRANCE,PARIS,1004340,520690,1525030,
Musée Bourdelle,2014,ILE-DE-FRANCE,PARIS,6124,23942,30066,
Musée Zadkine,2014,ILE-DE-FRANCE,PARIS,27188,21419,48607,
Etablissement Public du Musée des Arts Asiatiques Guimet,2014,ILE-DE-FRANCE,PARIS,163212,148173,311385,
Musée des Monuments Français,2014,ILE-DE-FRANCE,PARIS,191456,170204,361660,
"Musée Cognacq-Jay, Musée du XVIIIe siècle de la ville de Paris",2014,ILE-DE-FRANCE,PARIS,21368,32481,53849,
Musée de la Chasse et de la Nature,2014,ILE-DE-FRANCE,PARIS,22600,30762,53362,
Musée des Arts Décoratifs (Union Centrale des Arts Décoratifs),2014,ILE-DE-FRANCE,PARIS,164693,144008,308701,
Musée Nissim de Camondo (Union Centrale des Arts Décoratifs),2014,ILE-DE-FRANCE,PARIS,33904,13783,47687,
Musée Municipal des Capucins,2014,ILE-DE-FRANCE,COULOMMIERS,1028,2784,3812,
Musée Municipal,2014,ILE-DE-FRANCE,MORET-SUR-LOING,0,9910,9910,
Château-musée de Nemours,2014,ILE-DE-FRANCE,NEMOURS,4323,5781,10104,
Musée Fragonard,2014,ILE-DE-FRANCE,MAISONS-ALFORT,3267,5055,8322,
Musée d'Art et d'Histoire Louis Senlecq,2014,ILE-DE-FRANCE,L'ISLE-ADAM,1916,4948,6864,
ARCHEA - Archéologie en Pays de France,2014,ILE-DE-FRANCE,LOUVRES,5834,3216,9050,
Musée Tavet Delacour,2014,ILE-DE-FRANCE,PONTOISE,4991,8457,13448,
Musée National de Port Royal des Champs,2014,ILE-DE-FRANCE,MAGNY-LES-HAMEAUX,4791,20816,25607,
Musée de la Ville,2014,ILE-DE-FRANCE,MONTIGNY LE BRETONNEUX,2400,7144,9544,
Musée Archéologique,2014,LANGUEDOC-ROUSSILLON,SALLELES D'AUDE,6084,4469,10553,
Musée du Colombier,2014,LANGUEDOC-ROUSSILLON,ALES,0,12332,12332,
Musée Départemental d'Art Sacré du Gard,2014,LANGUEDOC-ROUSSILLON,PONT-SAINT-ESPRIT,99,8979,9078,
Musée de la Cloche et de la Sonnaille,2014,LANGUEDOC-ROUSSILLON,HEREPIAN,1498,1660,3158,
Site Archéologique Lattara - Musée Henri Prades de Montpellier Agglomération,2014,LANGUEDOC-ROUSSILLON,LATTES,14964,11226,26190,
Musée Hyacinthe Rigaud,2014,LANGUEDOC-ROUSSILLON,PERPIGNAN,0,518,518,
Musée Départemental de la Tapisserie,2014,LIMOUSIN,AUBUSSON,13038,4368,17406,
Les Sources d'Hercule,2014,LORRAINE,DENEUVRE,2603,774,3377,
Musées de la Cour d'Or,2014,LORRAINE,METZ,23863,25641,49504,
Musée des Mines de fer de Lorraine,2014,LORRAINE,NEUFCHEF,17601,1585,19186,
Musée du Pays de Sarrebourg,2014,LORRAINE,SARREBOURG,9026,6986,16012,
Musée Départemental d'Archéologie Précolombienne et de Préhistoire de la Martinique,2014,MARTINIQUE,FORT-DE-FRANCE,4574,2043,6617,
Musée du Textile et du Peigne en Corne,2014,MIDI-PYRENEES,LAVELANET,1810,531,2341,
Musée Fenaille,2014,MIDI-PYRENEES,RODEZ,27639,11090,38729,
Musée des Beaux-Arts Denys Puech,2014,MIDI-PYRENEES,RODEZ,0,10750,10750,
Musée des Jacobins,2014,MIDI-PYRENEES,AUCH,5397,11167,16564,
Musée Campanaire,2014,MIDI-PYRENEES,L'ISLE JOURDAIN,11378,0,11378,
Musée du Vieux Toulouse,2014,MIDI-PYRENEES,TOULOUSE,5959,1072,7031,
Musée de Préhistoire Amédée Lémozi,2014,MIDI-PYRENEES,CABRERETS,77500,0,77500,
Musée Murat,2014,MIDI-PYRENEES,CŒUR DE CAUSSE,864,74,938,
Musée Charles Portal - Histoire et Patrimoine,2014,MIDI-PYRENEES,CORDES-SUR-CIEL,742,260,1002,
Musée Raymond Lafage,2014,MIDI-PYRENEES,LISLE-SUR-TARN,1127,2566,3693,
Musée du Pays Rabastinois,2014,MIDI-PYRENEES,RABASTENS,1002,3415,4417,
Musée du Vieil Auvillar,2014,MIDI-PYRENEES,AUVILLAR,2168,885,3053,
"Forum Antique de Bavay, Musée Archéologique du Département du Nord",2014,NORD-PAS-DE-CALAIS,BAVAY,18884,4179,23063,
Musée du Mont-de-Piété,2014,NORD-PAS-DE-CALAIS,BERGUES,4166,0,4166,
Musée Municipal de Cambrai,2014,NORD-PAS-DE-CALAIS,CAMBRAI,2784,10654,13438,
Musée des Beaux-Arts,2014,NORD-PAS-DE-CALAIS,DUNKERQUE,5580,6042,11622,
Musée du Verre,2014,NORD-PAS-DE-CALAIS,SARS-POTERIES,8962,6808,15770,
Musée des Beaux-Arts,2014,NORD-PAS-DE-CALAIS,VALENCIENNES,31504,0,31504,
Musée Municipal,2014,NORD-PAS-DE-CALAIS,LE TOUQUET-PARIS-PLAGE,10674,5847,16521,
Musée d'Art et d'Histoire Roger Rodière,2014,NORD-PAS-DE-CALAIS,MONTREUIL-SUR-MER,12851,11135,23986,
Musée d'Art et d'Histoire de Lisieux,2014,BASSE-NORMANDIE,LISIEUX,157,5319,5476,
Musée de Trouville - Villa Montebello,2014,BASSE-NORMANDIE,TROUVILLE-SUR-MER,13313,0,13313,
Musée et Sites archéologiques de Vieux-la-Romaine,2014,BASSE-NORMANDIE,VIEUX,10594,8051,18645,
Musée Municipal,2014,BASSE-NORMANDIE,EQUEURDREVILLLE-HAINNEVILLE,0,2310,2310,
Musée Richard Anacréon,2014,BASSE-NORMANDIE,GRANVILLE,7900,8526,16426,
Musée du Granit,2014,BASSE-NORMANDIE,SAINT-MICHEL-DE-MONTJOIE,0,1717,1717,
Musée Barbey d'Aurevilly,2014,BASSE-NORMANDIE,SAINT-SAUVEUR-LE-VICOMTE,653,229,882,
Musée du Château de Flers,2014,BASSE-NORMANDIE,FLERS,0,2950,2950,
Musée Municipal - Musée du Jouet,2014,BASSE-NORMANDIE,LA FERTE-MACE,675,0,675,
Musée Municipal,2014,HAUTE-NORMANDIE,LOUVIERS,0,6205,6205,
Abbaye de Graville - Musée du Prieuré de Graville,2014,HAUTE-NORMANDIE,LE HAVRE,1321,7226,8547,
Musée des Traditions et Arts Normands,2014,HAUTE-NORMANDIE,MARTAINVILLE-EPREVILLE,8982,16795,25777,
Musée Mathon-Durand,2014,HAUTE-NORMANDIE,NEUFCHATEL-EN-BRAY,612,755,1367,
Musée des Beaux-Arts,2014,HAUTE-NORMANDIE,ROUEN,54417,70090,124507,
Association de l'Horlogerie Aliermontaise,2014,HAUTE-NORMANDIE,SAINT-NICOLAS-D'ALIERMONT,4955,2524,7479,
Musée d'Art de Nantes,2014,PAYS DE LA LOIRE,NANTES,18470,200187,218657,
Musées du Parc Naturel Régional de Brière,2014,PAYS DE LA LOIRE,SAINT-JOACHIM,6864,0,6864,
Musée d'Art et d'Histoire,2014,PAYS DE LA LOIRE,CHOLET,1928,13697,15625,
Musée des Tisserands Mayennais,2014,PAYS DE LA LOIRE,AMBRIERES-LES-VALLEES,312,40,352,
Centre Minier de Faymoreau,2014,PAYS DE LA LOIRE,FAYMOREAU,17666,3843,21509,
Musée Clemenceau et de Lattre-de-Tassigny,2014,PAYS DE LA LOIRE,MOUILLERON-EN-PAREDS,2439,3810,6249,
Musée Antoine Vivenel,2014,PICARDIE,COMPIEGNE,1233,14444,15677,
Musée Lombart,2014,PICARDIE,DOULLENS,143,4047,4190,
Musée-Historial de la Grande Guerre,2014,PICARDIE,PERONNE,90384,23275,113659,
Cité International de la Bande Dessinée et de l'Image - Musée de la Bande Dessinée,2014,POITOU-CHARENTES,ANGOULEME,14134,39970,54104,
Musée de la Mytiliculture,2014,POITOU-CHARENTES,ESNANDES,2352,306,2658,
Musée Napoléonien et Africain,2014,POITOU-CHARENTES,ILE D'AIX,10259,9275,19534,
Hôtel Hèbre de Saint-Clément - Musée d'Art et d'Histoire,2014,POITOU-CHARENTES,ROCHEFORT,9023,9901,18924,
Musée de l'Ile d'Oléron,2014,POITOU-CHARENTES,ST-PIERRE D'OLERON,9518,2666,12184,
Musée des Tumulus de Bougon,2014,POITOU-CHARENTES,BOUGON,12887,5864,18751,
Musée de Bressuire,2014,POITOU-CHARENTES,BRESSUIRE,0,2363,2363,
Musée Bernard d’Agesci,2014,POITOU-CHARENTES,NIORT,3718,6658,10376,
Musée d'Art et d'Histoire Georges Turpin,2014,POITOU-CHARENTES,PARTHENAY,0,8622,8622,
Musée Municipal de Civray,2014,POITOU-CHARENTES,CIVRAY,0,153,153,
Musée de l'hypogée des Dunes,2014,POITOU-CHARENTES,POITIERS,0,725,725,
Musée Renoir,2014,PROVENCE-ALPES-CÔTE D'AZUR,CAGNES-SUR-MER,33888,18931,52819,
Musée de la Castre,2014,PROVENCE-ALPES-CÔTE D'AZUR,CANNES,17330,18844,36174,
Musée Bonnard,2014,PROVENCE-ALPES-CÔTE D'AZUR,LE CANNET,26197,12168,38365,
Musée de Préhistoire Régionale,2014,PROVENCE-ALPES-CÔTE D'AZUR,MENTON,0,12036,12036,
Musée Archéologique - Site de  Cimiez,2014,PROVENCE-ALPES-CÔTE D'AZUR,NICE,0,34689,34689,
Ecomusée du Pays de la Roudoule,2014,PROVENCE-ALPES-CÔTE D'AZUR,PUGET-ROSTANG,975,484,1459,
Musée Picasso la guerre et la paix à Vallauris,2014,PROVENCE-ALPES-CÔTE D'AZUR,VALLAURIS,17921,16255,34176,
Musée Départemental de l'Arles Antique,2014,PROVENCE-ALPES-CÔTE D'AZUR,ARLES,59990,97275,157265,
Musée Alphonse Daudet,2014,PROVENCE-ALPES-CÔTE D'AZUR,FONTVIEILLE,2797,561,3358,
Musée d'Histoire et d'Archéologie des Baux-de-Provence,2014,PROVENCE-ALPES-CÔTE D'AZUR,LES BAUX DE PROVENCE,283847,0,283847,
Musée Ziem,2014,PROVENCE-ALPES-CÔTE D'AZUR,MARTIGUES,0,10775,10775,
Musée de la Société d’Etudes Scientifiques et Achéologiques,2014,PROVENCE-ALPES-CÔTE D'AZUR,DRAGUIGNAN,0,300,300,
Musée Archéologique,2014,PROVENCE-ALPES-CÔTE D'AZUR,SAINT-RAPHAËL,1881,18388,20269,
Muséum d'Histoire Naturelle de Toulon et du Var,2014,PROVENCE-ALPES-CÔTE D'AZUR,TOULON,0,67108,67108,
Musée de l'Hôtel Dieu,2014,PROVENCE-ALPES-CÔTE D'AZUR,CAVAILLON,456,879,1335,
Musée du Brou,2014,RHONE-ALPES,BOURG-EN-BRESSE,53088,41560,94648,
Musée du Bugey-Valmorey,2014,RHONE-ALPES,LOCHIEU,2869,2007,4876,
Musée Vivarois César Filhol,2014,RHONE-ALPES,ANNONAY,410,1681,2091,
Musée et Site Archéologiques,2014,RHONE-ALPES,SOYONS,12400,1782,14182,
Musée des Beaux-Arts,2014,RHONE-ALPES,VALENCE,26265,38207,64472,
Musée des Vallées de Thônes,2014,RHONE-ALPES,THONES,32,0,32,
Musée Hector Berlioz,2014,RHONE-ALPES,LA-COTE-SAINT-ANDRE,0,15020,15020,
Musée Départemental de la Révolution Française,2014,RHONE-ALPES,VIZILLE,4143,58640,62783,
Musée Folklorique du Vieux Saint-Etienne,2014,RHONE-ALPES,SAINT-ETIENNE,1266,2395,3661,
Musée de la Mine / Site Couriot,2014,RHONE-ALPES,SAINT-ETIENNE,28630,30486,59116,
Musée Rural,2014,RHONE-ALPES,USSON-EN-FOREZ,3542,971,4513,
Musée des Sapeurs-Pompiers de Lyon,2014,RHONE-ALPES,LYON,4058,2486,6544,
Musée archéologique et minéralogique Pierre Borrione,2014,RHONE-ALPES,AIME-EN-TARENTAISE Cedex,894,358,1252,
Musée du docteur Faure,2014,RHONE-ALPES,AIX-LES-BAINS,5848,4463,10311,
Musée Alsacien,2015,ALSACE,HAGUENAU,1147,1654,2801,
Musée Historique,2015,ALSACE,STRASBOURG,21653,27259,48912,
Musée Alsacien,2015,ALSACE,STRASBOURG,35629,24771,60400,
Cabinet des Estampes et des Dessins,2015,ALSACE,STRASBOURG,0,345,345,
Musée Historique et Militaire de Huningue,2015,ALSACE,HUNINGE,210,240,450,
Musée du Dolder,2015,ALSACE,RIQUEWIHR,1657,391,2048,
Musée Paul Reclus,2015,AQUITAINE,DOMME,0,18232,18232,
Musée des Arts et Traditions Populaires du Périgord,2015,AQUITAINE,MUSSIDAN,808,1212,2020,
Centre National Jean Moulin,2015,AQUITAINE,BORDEAUX,0,37879,37879,
Musée des Beaux-Arts et d'Archéologie,2015,AQUITAINE,LIBOURNE,0,10831,10831,
Musée Départemental de la Faïence et des Arts de la table,2015,AQUITAINE,SAMADET,2953,1867,4820,
Musée des Beaux-Arts,2015,AQUITAINE,AGEN,7506,11135,18641,
Muséum d'Histoire Naturelle,2015,AQUITAINE,BAYONNE,0,20800,20800,
Musée Basque et de l'Histoire de Bayonne,2015,AQUITAINE,BAYONNE,20179,26749,46928,
Musée des Musiques Populaires - MuPop,2015,AUVERGNE,MONTLUCON,24225,805,25030,
Musée des Arts et Traditions Populaires de Haute Loire,2015,AUVERGNE,LAVAUDIEU,9100,770,9870,
Musée de la Dentelle,2015,AUVERGNE,ARLANC,728,52,780,
Musée d'Archéologie Bargoin,2015,AUVERGNE,CLERMONT-FERRAND,3601,11705,15306,
Musée Départemental de la Céramique Gallo-Romaine,2015,AUVERGNE,LEZOUX,5133,3691,8824,
Musée des Peintres de l'Ecole de Murols,2015,AUVERGNE,MUROL,4627,219,4846,
Musée Alésia - Centre d'Interprétation,2015,BOURGOGNE,ALISE-SAINTE-REINE,72306,16058,88364,
Musée du Pays Châtillonnais - Trésor de Vix,2015,BOURGOGNE,CHATILLON-SUR-SEINE,12966,7233,20199,
Muséum - Jardin des Sciences,2015,BOURGOGNE,DIJON,14393,107405,121798,
Musée Archéologique,2015,BOURGOGNE,DIJON,0,34528,34528,
Musée Buffon,2015,BOURGOGNE,MONTBARD,0,8569,8569,
Musée d'Art et d'Histoire Romain Rolland,2015,BOURGOGNE,CLAMECY,2012,2687,4699,
Musée René Davoine,2015,BOURGOGNE,CHAROLLES,0,84,84,
Musée Lamartine,2015,BOURGOGNE,MACON,1285,3557,4842,
Musée de la Tour du Moulin,2015,BOURGOGNE,MARCIGNY,1096,603,1699,
Musée du Terroir,2015,BOURGOGNE,ROMENAY,2258,1528,3786,
Ecomusée des Monts d'Arrée - Moulins de Kerouat,2015,BRETAGNE,COMMANA,7121,1780,8901,
Le Port-Musée,2015,BRETAGNE,DOUARNENEZ,37035,8059,45094,
Musée de Morlaix,2015,BRETAGNE,MORLAIX,12104,12912,25016,
Musée des Phares et Balises,2015,BRETAGNE,OUESSANT,12358,3212,15570,
Musée Départemental Breton,2015,BRETAGNE,QUIMPER,17700,19286,36986,
Musée International du Long-Cours Cap-Hornier,2015,BRETAGNE,SAINT-MALO,8242,6017,14259,
Musée Saint-Nicolas,2015,BRETAGNE,VITRE,486,0,486,
Musée du Château de Vitré,2015,BRETAGNE,VITRE,16613,4240,20853,
Ecomusée Industriel des Forges,2015,BRETAGNE,INZINZAC-LOCHRIST,1555,1761,3316,
Musée du Faouët,2015,BRETAGNE,LE FAOUET,11375,3272,14647,
Musée Emile Chénon,2015,CENTRE,CHATEAUMEILLANT,1138,1172,2310,
Musée Saint-Vic,2015,CENTRE,SAINT-AMAND-MONTROND,0,5238,5238,
"Le Carroi, Musée d’Arts et d’Histoire",2015,CENTRE,CHINON,1103,1796,2899,
Musée de Préhistoire du Grand Pressigny,2015,CENTRE,LE GRAND PRESSIGNY,9453,6667,16120,
Musée des Sciences Naturelles,2015,CENTRE,ORLEANS,6558,35687,42245,
Maison des Ailleurs - Arthur Rimbaud (Annexe),2015,CHAMPAGNE-ARDENNES,CHARLEVILLE-MEZIERES,2409,6693,9102,
Musée de la Bonneterie,2015,CHAMPAGNE-ARDENNES,TROYES,2804,4374,7178,
Musée Municipal,2015,CHAMPAGNE-ARDENNES,SAINT-DIZIER,0,5383,5383,
Musée du Cloître de Notre-Dame-en-Vaux,2015,CHAMPAGNE-ARDENNES,CHALONS-EN-CHAMPAGNE,866,2075,2941,
Musée Palais Fesch,2015,CORSE,AJACCIO,21804,16483,38287,
Musée d'Histoire de Bastia,2015,CORSE,BASTIA,10289,10460,20749,
Musée de la résistance et de la Déportation,2015,FRANCHE-COMTE,BESANCON,44408,14800,59208,
Musée Départemental Albert-et-Félicie Demard - ATP,2015,FRANCHE-COMTE,CHAMPLITTE,7300,3380,10680,
Musée Sarret de Grozon,2015,FRANCHE-COMTE,ARBOIS,461,2268,2729,
Musée Municipal d'Archéologie,2015,FRANCHE-COMTE,CHAMPAGNOLE,221,190,411,
Musée des Beaux-Arts,2015,FRANCHE-COMTE,DOLE,0,18229,18229,
Viséum-Musée de la Lunette,2015,FRANCHE-COMTE,MOREZ HAUTS DE BIENNE,9386,6169,15555,
Musée des Salines,2015,FRANCHE-COMTE,SALINS-LES-BAINS,61992,5509,67501,
Musée des Années Trente,2015,ILE-DE-FRANCE,BOULOGNE-BILLANCOURT,22734,0,22734,
Musée Français de la Carte à Jouer,2015,ILE-DE-FRANCE,ISSY-LES-MOULINEAUX,3818,17763,21581,
Crypte Archéologique du Parvis Notre-Dame,2015,ILE-DE-FRANCE,PARIS,165628,0,165628,
Musée National de la Légion d'Honneur et des Ordres de Chevalerie,2015,ILE-DE-FRANCE,PARIS,0,50111,50111,
Musée Zadkine,2015,ILE-DE-FRANCE,PARIS,0,23249,23249,
Musée de la Musique,2015,ILE-DE-FRANCE,PARIS,297151,82643,379794,
Etablissement public de la Porte Dorée - Aquarium Tropical,2015,ILE-DE-FRANCE,PARIS,116583,51782,168365,
Musée des Arts Décoratifs (Union Centrale des Arts Décoratifs),2015,ILE-DE-FRANCE,PARIS,141092,106107,247199,
Musée National des Techniques,2015,ILE-DE-FRANCE,PARIS,82367,143731,226098,
Institut du Monde Arabe,2015,ILE-DE-FRANCE,PARIS,269940,125802,395742,
Musée du Quai Branly,2015,ILE-DE-FRANCE,PARIS,317688,716938,1034626,
Musée Municipal de Chelles Alfred Bonno,2015,ILE-DE-FRANCE,CHELLES,0,2806,2806,
Maison Natale de Louis Braille,2015,ILE-DE-FRANCE,COUPVRAY,3130,1752,4882,
Musée de la Gendarmerie Nationale,2015,ILE-DE-FRANCE,MELUN,2068,8831,10899,
Musée d'Art et d'Histoire de Melun,2015,ILE-DE-FRANCE,MELUN,549,6209,6758,
Musée d'Art et d'Histoire,2015,ILE-DE-FRANCE,SAINT-DENIS,2277,12752,15029,
Musée de la Batellerie et des Voies Navigables,2015,ILE-DE-FRANCE,CONFLANS-SAINTE-HONORINE,7608,843,8451,
Musée Rambolitrain,2015,ILE-DE-FRANCE,RAMBOUILLET,13696,2150,15846,
Musée d'Archéologie Nationale (des origines à l'an mille) - Château de st-Germain-en-Laye,2015,ILE-DE-FRANCE,SAINT-GERMAIN-EN-LAYE,19288,82819,102107,
Eburomagus Musée Archéologique,2015,LANGUEDOC-ROUSSILLON,BRAM,931,1245,2176,
Musée des Corbières,2015,LANGUEDOC-ROUSSILLON,SIGEAN,210,1355,1565,
Musée Albert André,2015,LANGUEDOC-ROUSSILLON,BAGNOLS-SUR-CEZE,87,3979,4066,
Musée Cévenol,2015,LANGUEDOC-ROUSSILLON,LE VIGAN,1580,1932,3512,
Musée Pierre de Luxembourg,2015,LANGUEDOC-ROUSSILLON,VILLENEUVE-LES-AVIGNON,2676,3251,5927,
Musée des Beaux-Arts de Béziers,2015,LANGUEDOC-ROUSSILLON,BEZIERS,5158,11014,16172,
Musée du Biterrois,2015,LANGUEDOC-ROUSSILLON,BEZIERS,713,21108,21821,
Musée du Vieux Montpellier,2015,LANGUEDOC-ROUSSILLON,MONTPELLIER,739,4892,5631,
Musée du Cloître de Tulle André Mazeyrie,2015,LIMOUSIN,TULLE,0,10435,10435,
Musée National du Château,2015,LIMOUSIN,PAU,50080,45351,95431,
Muséum- Aquarium de Nancy,2015,LORRAINE,NANCY,26906,61772,88678,
Musée Barrois,2015,LORRAINE,BAR-LE-DUC,2301,7741,10042,
Musée de la Princerie,2015,LORRAINE,VERDUN,1300,3191,4491,
Musée Militaire et Erckmann-Chatrian,2015,LORRAINE,PHALSBOURG,733,977,1710,
"Jardin d'Hiver, Musée de La Faïence",2015,LORRAINE,SARREGUEMINES,5316,5108,10424,
Musée Départemental d'Art Ancien et Contemporain,2015,LORRAINE,EPINAL,2588,15194,17782,
Musée de la Lutherie et de l'Archèterie Française,2015,LORRAINE,MIRECOURT,5963,4027,9990,
Musée Charles de Bruyères,2015,LORRAINE,REMIREMONT,430,2874,3304,
Musée Départemental d'Archéologie Précolombienne et de Préhistoire de la Martinique,2015,MARTINIQUE,FORT-DE-FRANCE,4031,2192,6223,
Musée Régional d'Histoire et d'Ethnologie,2015,MARTINIQUE,FORT-DE-FRANCE,2264,2701,4965,
Musée de la Préhistoire,2015,MIDI-PYRENEES,LE MAS D'AZIL,12926,838,13764,
Musée Archéologique,2015,MIDI-PYRENEES,EAUZE,7358,2212,9570,
Musée du Vieux Toulouse,2015,MIDI-PYRENEES,TOULOUSE,6296,1299,7595,
Musée du Pays de Guérande et de la Porte Saint Michel,2015,MIDI-PYRENEES,GUERANDE,20616,9127,29743,
Musée Départemental de Cuzals,2015,MIDI-PYRENEES,SAULIAC-SUR-CELE,5840,2520,8360,
Musée Municipal,2015,MIDI-PYRENEES,VAYRAC,146,0,146,
Musée Toulouse Lautrec,2015,MIDI-PYRENEES,ALBI,138158,31712,169870,
Musée Eugénie et Maurice Guérin,2015,MIDI-PYRENEES,ANDILLAC,1079,2045,3124,
Musée du Vieil Auvillar,2015,MIDI-PYRENEES,AUVILLAR,2107,910,3017,
Musée de Préhistoire,2015,MIDI-PYRENEES,SAINT-ANTONIN-NOBLE-VAL,0,2135,2135,
Musée des Beaux-Arts,2015,NORD-PAS-DE-CALAIS,VALENCIENNES,7745,12318,20063,
Musée des Beaux-Arts,2015,NORD-PAS-DE-CALAIS,ARRAS,76982,0,76982,
Musée de Boulogne-sur-Mer,2015,NORD-PAS-DE-CALAIS,BOULOGNE-SUR-MER,12076,11461,23537,
Cité Internationale de la Dentelle et de la Mode de Calais,2015,NORD-PAS-DE-CALAIS,CALAIS,44366,18043,62409,
Musée d'Histoire et d'Archéologie,2015,NORD-PAS-DE-CALAIS,HARNES,0,2315,2315,
Musée Municipal Bruno Danvin,2015,NORD-PAS-DE-CALAIS,SAINT-POL-SUR-TERNOISE,0,5127,5127,
Musée Jean-Charles Cazin,2015,NORD-PAS-DE-CALAIS,SAMER,0,550,550,
Musée du Débarquement,2015,BASSE-NORMANDIE,ARROMANCHES,300540,12324,312864,
Musée d'Initiation à la Nature,2015,BASSE-NORMANDIE,CAEN,0,5225,5225,
Château de Saint-Germain de Livet,2015,BASSE-NORMANDIE,SAINT-GERMAIN DE LIVET,10387,7880,18267,
Musée de la Bataille de Tilly-Sur-Seulles 1944,2015,BASSE-NORMANDIE,TILLY-SUR-SEULLES,744,509,1253,
Musée de la Guerre et de la Libération,2015,BASSE-NORMANDIE,CHERBOURG-EN-COTENTIN,3641,6378,10019,
Musée d'Art et d'Histoire de Granville,2015,BASSE-NORMANDIE,GRANVILLE,5182,0,5182,
Ferme-Musée du Cotentin,2015,BASSE-NORMANDIE,SAINTE-MERE-EGLISE,7339,3549,10888,
Musée des Beaux-Arts,2015,BASSE-NORMANDIE,SAINT-LO,1484,5947,7431,
Musée des Beaux-Arts et de la Dentelle,2015,BASSE-NORMANDIE,ALENCON,8663,7171,15834,
Musée Municipal d'Archéologie,2015,BASSE-NORMANDIE,L'AIGLE,438,631,1069,
Musée d'Elbeuf,2015,HAUTE-NORMANDIE,ELBEUF,0,37685,37685,
Musée du Prieuré,2015,HAUTE-NORMANDIE,HARFLEUR,181,599,780,
Musée des Traditions et Arts Normands,2015,HAUTE-NORMANDIE,MARTAINVILLE-EPREVILLE,8362,14866,23228,
Musée des Sapeurs-Pompiers de France,2015,HAUTE-NORMANDIE,MONTVILLE,5750,4407,10157,
Musée Mathon-Durand,2015,HAUTE-NORMANDIE,NEUFCHATEL-EN-BRAY,789,254,1043,
Ecomusée de la Basse-Seine,2015,HAUTE-NORMANDIE,NOTRE-DAME-DE-BLIQUETUIT,26229,4201,30430,
Musée de la Céramique,2015,HAUTE-NORMANDIE,ROUEN,3244,3595,6839,
Musée Municipal des Ivoires,2015,HAUTE-NORMANDIE,YVETOT,678,289,967,
Musée Jean Lurcat et de la Tapisserie Contemporaine,2015,PAYS DE LA LOIRE,ANGERS,15793,38340,54133,
Galerie David d'Angers,2015,PAYS DE LA LOIRE,ANGERS,8852,26548,35400,
Musée Joseph Denais,2015,PAYS DE LA LOIRE,BEAUFORT-EN-VALLEE,7185,3061,10246,
Musée Communal Robert Tatin,2015,PAYS DE LA LOIRE,COSSE-LE-VIVIEN,19554,5054,24608,
Musée du Vieux Château,2015,PAYS DE LA LOIRE,LAVAL,8058,18801,26859,
Musée de Tessé,2015,PAYS DE LA LOIRE,LE MANS,16668,12934,29602,
Centre Minier de Faymoreau,2015,PAYS DE LA LOIRE,FAYMOREAU,16606,2688,19294,
Musée Milcendeau Jean-Yole,2015,PAYS DE LA LOIRE,SOULLANS,3351,0,3351,
Musée Jeanne d'Aboville,2015,PICARDIE,LA FERE,361,1897,2258,
Musée de la Figurine Historique,2015,PICARDIE,COMPIEGNE,2609,6605,9214,
Musée d'Art et d'Archéologie,2015,PICARDIE,SENLIS,4813,9945,14758,
Musée-Historial de la Grande Guerre,2015,PICARDIE,PERONNE,72076,8706,80782,
Musée de la Mytiliculture,2015,POITOU-CHARENTES,ESNANDES,4787,303,5090,
Musée Régional de Fouras,2015,POITOU-CHARENTES,FOURAS,6669,1451,8120,
Musée Archéologique,2015,POITOU-CHARENTES,SAINTES,52,29125,29177,
Musée de l'Echevinage,2015,POITOU-CHARENTES,SAINTES,2671,5265,7936,
Musée d'Art et d'Histoire Georges Turpin,2015,POITOU-CHARENTES,PARTHENAY,0,9169,9169,
Musée Henri Barré,2015,POITOU-CHARENTES,THOUARS,177,1540,1717,
Musée Gassendi,2015,PROVENCE-ALPES-CÔTE D'AZUR,DIGNE-LES-BAINS,2721,16483,19204,
Musée archéologique,2015,PROVENCE-ALPES-CÔTE D'AZUR,VACHERES,789,193,982,
Musée d'Art et d'Histoire de Provence,2015,PROVENCE-ALPES-CÔTE D'AZUR,GRASSE,0,20080,20080,
Musée Jean Cocteau Collection Séverin Wunderman,2015,PROVENCE-ALPES-CÔTE D'AZUR,MENTON,30231,13192,43423,
Musée des Beaux-Arts Jules Chéret,2015,PROVENCE-ALPES-CÔTE D'AZUR,NICE,15742,14194,29936,
Musée du Palais Lascaris,2015,PROVENCE-ALPES-CÔTE D'AZUR,NICE,17295,11947,29242,
Musée d'Art et d'Histoire,2015,PROVENCE-ALPES-CÔTE D'AZUR,NICE,20070,26335,46405,
Musée d'Art Moderne et d'Art Contemporain,2015,PROVENCE-ALPES-CÔTE D'AZUR,NICE,38533,47802,86335,
Musée- Atelier de Paul Cézanne,2015,PROVENCE-ALPES-CÔTE D'AZUR,AIX-EN-PROVENCE,60651,8304,68955,
Musée Municipal Méditerranéen de Cassis A.T.P.,2015,PROVENCE-ALPES-CÔTE D'AZUR,CASSIS,166,9851,10017,
Musée Alphonse Daudet,2015,PROVENCE-ALPES-CÔTE D'AZUR,FONTVIEILLE,1460,1642,3102,
Musée des Beaux-Arts de Marseille,2015,PROVENCE-ALPES-CÔTE D'AZUR,MARSEILLE,11265,25112,36377,
Muséum d'Histoire Naturelle,2015,PROVENCE-ALPES-CÔTE D'AZUR,MARSEILLE,13241,52136,65377,
Musée Archéologique Gallo-Romaine du Var,2015,PROVENCE-ALPES-CÔTE D'AZUR,FREJUS,3918,2482,6400,
Musée de l'Annonciade,2015,PROVENCE-ALPES-CÔTE D'AZUR,SAINT-TROPEZ,30406,9039,39445,
Musée National de la Marine de Toulon,2015,PROVENCE-ALPES-CÔTE D'AZUR,TOULON,21446,36443,57889,
Musée du Petit Palais,2015,PROVENCE-ALPES-CÔTE D'AZUR,AVIGNON,14075,12782,26857,
Musée Comtadin-Duplessis,2015,PROVENCE-ALPES-CÔTE D'AZUR,CARPENTRAS,602,3933,4535,
Musée Sobirats,2015,PROVENCE-ALPES-CÔTE D'AZUR,CARPENTRAS,438,578,1016,
Musée Jouve,2015,PROVENCE-ALPES-CÔTE D'AZUR,CAVAILLON,0,4501,4501,
Musée de l'Hôtel Dieu,2015,PROVENCE-ALPES-CÔTE D'AZUR,CAVAILLON,339,981,1320,
Musée Municipal,2015,PROVENCE-ALPES-CÔTE D'AZUR,ORANGE,56584,0,56584,
Musée Départemental du Cartonnage et de l'Imprimerie,2015,PROVENCE-ALPES-CÔTE D'AZUR,VALREAS,3982,1497,5479,
Musée Départemental du Revermont,2015,RHONE-ALPES,VAL-REVERMONT,2929,7301,10230,
MuséAL - Musée Archéologique d'Alba,2015,RHONE-ALPES,ALBA-LA-ROMAINE,11818,2778,14596,
Musée d'Histoire et d'Archéologie,2015,RHONE-ALPES,DIE,634,4683,5317,
Musée International de la Chaussure,2015,RHONE-ALPES,ROMANS,17111,10861,27972,
Musée du site Préhistorique,2015,RHONE-ALPES,VASSIEUX-EN-VERCORS,11915,0,11915,
Musée Léon Marès,2015,RHONE-ALPES,LOVAGNY,18500,0,18500,
Musée Gallo-Romain,2015,RHONE-ALPES,AOSTE,4179,1983,6162,
Musée - Parc Archéologique du Lac de Paladru,2015,RHONE-ALPES,CHARAVINES,6374,952,7326,
Musée Stendhal,2015,RHONE-ALPES,GRENOBLE,1750,775,2525,
Maison du Patrimoine de Hières-sur-Amby,2015,RHONE-ALPES,HIERES SUR AMBY,6385,2122,8507,
Musée Matheysin,2015,RHONE-ALPES,LA MURE,13349,1913,15262,
Musée Départemental de la Révolution Française,2015,RHONE-ALPES,VIZILLE,4152,60923,65075,
Musée Lucien Mainssieux,2015,RHONE-ALPES,VOIRON,0,5834,5834,
Musée d'Allard,2015,RHONE-ALPES,MONTBRISON,1145,8509,9654,
Musée Folklorique du Vieux Saint-Etienne,2015,RHONE-ALPES,SAINT-ETIENNE,1795,1054,2849,
Musée de la Mine / Site Couriot,2015,RHONE-ALPES,SAINT-ETIENNE,28347,38185,66532,
Musée Barthélemy-Thimonnier,2015,RHONE-ALPES,AMPLEPUIS,1565,3191,4756,
Musée des Confluences,2015,RHONE-ALPES,LYON,396269,484327,880596,
Musée du docteur Faure,2015,RHONE-ALPES,AIX-LES-BAINS,5621,5080,10701,
Musée de l'Académie de La Val d'Isère,2015,RHONE-ALPES,MOÛTIERS,59,197,256,
Musée Louis Jourdan,2016,AUVERGNE-RHONE-ALPES,SAINT-PAUL-DE-VARAX,204,131,335,
Musée Rieckotter,2016,AUVERGNE-RHONE-ALPES,NERIS-LES-BAINS,620,810,1430,
Musée des Arts D'Afrique et D'Asie,2016,AUVERGNE-RHONE-ALPES,VICHY,1394,0,1394,
Cité de Préhistoire,2016,AUVERGNE-RHONE-ALPES,ORGNAC-L'AVEN,136145,32046,168191,
Ecomusée de Margeride-Haute-Auvergne,2016,AUVERGNE-RHONE-ALPES,RUYNES-EN-MARGERIDE,9065,249,9314,
Musée d'art et d'histoire Alfred Douët,2016,AUVERGNE-RHONE-ALPES,SAINT-FLOUR,1272,1359,2631,
Musée d'Histoire et d'Archéologie,2016,AUVERGNE-RHONE-ALPES,DIE,579,4843,5422,
Musée d'Archéologie Tricastine,2016,AUVERGNE-RHONE-ALPES,SAINT-PAUL-TROIS-CHATEAUX,3132,4789,7921,
Musée Jadis Allevard,2016,AUVERGNE-RHONE-ALPES,ALLEVARD-LES-BAINS,1532,1787,3319,
Musée Dauphinois,2016,AUVERGNE-RHONE-ALPES,GRENOBLE,0,76413,76413,
Musée de la Résistance de la Déportation de l'Isère,2016,AUVERGNE-RHONE-ALPES,GRENOBLE,0,31146,31146,
Musée-Cloître Saint-André-Le-Bas,2016,AUVERGNE-RHONE-ALPES,VIENNE,3568,3788,7356,
Musée Lucien Mainssieux,2016,AUVERGNE-RHONE-ALPES,VOIRON,0,5303,5303,
Atelier - Musée du Chapeau,2016,AUVERGNE-RHONE-ALPES,CHAZELLES-SUR-LYON,15683,6700,22383,
Musée d'Allard,2016,AUVERGNE-RHONE-ALPES,MONTBRISON,1324,5838,7162,
Musée des Civilisations,2016,AUVERGNE-RHONE-ALPES,SAINT-JUST-SAINT-RAMBERT,4452,1281,5733,
Musée Rural,2016,AUVERGNE-RHONE-ALPES,USSON-EN-FOREZ,2705,737,3442,
Musée Paléontologique,2016,AUVERGNE-RHONE-ALPES,MENAT,374,76,450,
Musée Municipal de la Coutellerie,2016,AUVERGNE-RHONE-ALPES,THIERS,19019,3896,22915,
Musée de la Civilisation Gallo-Romaine,2016,AUVERGNE-RHONE-ALPES,LYON,27099,67377,94476,
Musée Archéologique,2016,AUVERGNE-RHONE-ALPES,AIX-LES-BAINS,0,130,130,
Musée des Beaux-Arts,2016,AUVERGNE-RHONE-ALPES,CHAMBERY,3851,16551,20402,
Musée Savoisien,2016,AUVERGNE-RHONE-ALPES,CHAMBERY,1187,30537,31724,
Musée de l'Académie de La Val d'Isère,2016,AUVERGNE-RHONE-ALPES,MOÛTIERS,57,305,362,
Musée Municipal,2016,BOURGOGNE-FRANCHE-COMTE,NUITS-SAINT-GEORGES,204,3603,3807,
Musée Baron Martin,2016,BOURGOGNE-FRANCHE-COMTE,GRAY,2301,2242,4543,
Musée Municipal d'Archéologie,2016,BOURGOGNE-FRANCHE-COMTE,CHAMPAGNOLE,225,819,1044,
Musée du Jouet,2016,BOURGOGNE-FRANCHE-COMTE,MOIRANS-EN-MONTAGNE,37811,9516,47327,
Musée des Salines,2016,BOURGOGNE-FRANCHE-COMTE,SALINS-LES-BAINS,60297,5036,65333,
Musée d'Art et d'Histoire Romain Rolland,2016,BOURGOGNE-FRANCHE-COMTE,CLAMECY,2095,2698,4793,
Musée de la Mine,2016,BOURGOGNE-FRANCHE-COMTE,LA MACHINE,5491,798,6289,
Musée de la Faïence et des Beaux-Arts,2016,BOURGOGNE-FRANCHE-COMTE,NEVERS,7085,6651,13736,
Musée du Grès de Puisaye,2016,BOURGOGNE-FRANCHE-COMTE,SAINT-AMAND-EN-PUISAYE,1692,0,1692,
Musée Frédéric Japy,2016,BOURGOGNE-FRANCHE-COMTE,BEAUCOURT,952,1618,2570,
Musée d'Art et d'Histoire,2016,BOURGOGNE-FRANCHE-COMTE,BELFORT,3952,18798,22750,
Musée de l'Avallonnais,2016,BOURGOGNE-FRANCHE-COMTE,AVALLON,965,2766,3731,
Musée d'Art et d'Histoire,2016,BRETAGNE,SAINT-BRIEUC,0,16339,16339,
Musée du Château de Vitré,2016,BRETAGNE,VITRE,15495,6961,22456,
Musée de Préhistoire J. Miln- Z. Le-Rouzic,2016,BRETAGNE,CARNAC,28306,6199,34505,
Musée National de la Marine,2016,BRETAGNE,PORT-LOUIS,37439,28890,66329,
Musée de la Résistance Bretonne,2016,BRETAGNE,SAINT-MARCEL - MALESTROIT,11984,1662,13646,
Musée d'Histoire et d'Archéologie de Vannes,2016,BRETAGNE,VANNES,2817,4276,7093,
"La Cohue, Musée des Beaux-Arts de vannes",2016,BRETAGNE,VANNES,6660,112518,119178,
Musée Estève,2016,CENTRE-VAL DE LOIRE,BOURGES,0,14181,14181,
Musée des Arts Décoratifs,2016,CENTRE-VAL DE LOIRE,BOURGES,0,12471,12471,
Musée des Meilleurs Ouvriers de France,2016,CENTRE-VAL DE LOIRE,BOURGES,0,19174,19174,
Musée Municipal,2016,CENTRE-VAL DE LOIRE,VIERZON,1449,6603,8052,
Château Musée,2016,CENTRE-VAL DE LOIRE,AZAY-LE-FERRON,13847,4010,17857,
Musée Ornithologique (Ecomusée de la Brenne),2016,CENTRE-VAL DE LOIRE,LE BLANC,2190,1576,3766,
Ecomusée du Véron,2016,CENTRE-VAL DE LOIRE,SAVIGNY-EN-VERON,7365,3587,10952,
Musée des Beaux-Arts,2016,CENTRE-VAL DE LOIRE,TOURS,23319,45435,68754,
Musée de la Corse,2016,CORSE,CORTE,56456,10285,66741,
Musée de la Maison de la Dernière Cartouche,2016,GRAND EST,BAZEILLES,1044,984,2028,
Musée d'Art Moderne,2016,GRAND EST,TROYES,10276,21176,31452,
Musée de la Poterie,2016,GRAND EST,BETSCHDORF,2141,332,2473,
Musée Historique,2016,GRAND EST,HAGUENAU,1331,3587,4918,
Musée de l'Image Populaire de Pfaffenhoffen,2016,GRAND EST,PFAFFENHOFFEN,1124,1005,2129,
Musée Zoologique de Strasbourg,2016,GRAND EST,STRASBOURG,9571,30927,40498,
Musée Lalique,2016,GRAND EST,WINGEN-SUR-MODER,40198,12378,52576,
"Musée de l'Affiche - Le Signe, Centre national du Graphisme",2016,GRAND EST,CHAUMONT,0,15494,15494,
Musée Gallo-Romain,2016,GRAND EST,BIESHEIM,559,1396,1955,
Musée de la Porte de Thann,2016,GRAND EST,CERNAY,167,338,505,
Musée National de l'Automobile - Collection Schlumpf,2016,GRAND EST,MULHOUSE,161617,27383,189000,
Musée EDF Electropolis,2016,GRAND EST,MULHOUSE,31601,11904,43505,
Cité du Train,2016,GRAND EST,MULHOUSE,64390,18062,82452,
Maison du Sundgau - Musée Paysan,2016,GRAND EST,OLTINGUE,962,308,1270,
Musée de la Bière et du Pays de Stenay,2016,GRAND EST,STENAY,7101,13172,20273,
Musée de la Mine - Carreau Wendel,2016,GRAND EST,PETITE-ROSSELLE,41608,4456,46064,
Musée Départemental Georges de la Tour,2016,GRAND EST,VIC-SUR-SEILLE,2684,3447,6131,
Musée Pierre Noël - Musée de la Vie dans les Hautes-Vosges,2016,GRAND EST,SAINT-DIE-DES-VOSGES,3543,23538,27081,
Musée Franco-Américain du Château de Blérancourt,2016,HAUTS-DE-FRANCE,BLERANCOURT,246,501,747,
Musée Jeanne d'Aboville,2016,HAUTS-DE-FRANCE,LA FERE,342,1348,1690,
Musée Municipal de Soissons,2016,HAUTS-DE-FRANCE,SOISSONS,4927,3866,8793,
Musée de La Thiérache,2016,HAUTS-DE-FRANCE,VERVINS,0,7535,7535,
Musée des Dentelles et Broderies,2016,HAUTS-DE-FRANCE,CAUDRY,7353,4708,12061,
Musée d'Archéologie et d'Histoire Locale,2016,HAUTS-DE-FRANCE,DENAIN,0,5000,5000,
Musée du Verre,2016,HAUTS-DE-FRANCE,SARS-POTERIES,3260,43743,47003,
MUba - Musée des Beaux-Arts Eugène Leroy de Tourcoing,2016,HAUTS-DE-FRANCE,TOURCOING,20682,8292,28974,
Musée Antoine Vivenel,2016,HAUTS-DE-FRANCE,COMPIEGNE,2079,12095,14174,
Musée de la Figurine Historique,2016,HAUTS-DE-FRANCE,COMPIEGNE,2586,5306,7892,
Musée de la Nacre et de la Tabletterie,2016,HAUTS-DE-FRANCE,MERU,13669,4437,18106,
Musée d'Art et d'Archéologie,2016,HAUTS-DE-FRANCE,SENLIS,4375,8648,13023,
Musée Communautaire Opale-Sud,2016,HAUTS-DE-FRANCE,BERCK-SUR-MER,1968,5201,7169,
Musée Régional d'Ethnologie,2016,HAUTS-DE-FRANCE,BETHUNE,0,3999,3999,
Cité Internationale de la Dentelle et de la Mode de Calais,2016,HAUTS-DE-FRANCE,CALAIS,32704,15739,48443,
Musée du Touquet Paris-Plage,2016,HAUTS-DE-FRANCE,LE TOUQUET-PARIS-PLAGE,8066,6695,14761,
Musée Municipal Bruno Danvin,2016,HAUTS-DE-FRANCE,SAINT-POL-SUR-TERNOISE,0,4144,4144,
Musée Français de la Photographie,2016,ILE-DE-FRANCE,BIEVRES,1932,2052,3984,
Musée Municipal Robert Dubois-Corneau,2016,ILE-DE-FRANCE,BRUNOY,65,4059,4124,
Musée Roybet Fould,2016,ILE-DE-FRANCE,COURBEVOIE,374,10571,10945,
Cité de la céramique - Sèvres & Limoges,2016,ILE-DE-FRANCE,SEVRES,40409,24464,64873,
Musée de la Chasse et de la Nature,2016,ILE-DE-FRANCE,PARIS,30529,40042,70571,
Musée d'Art et d'Histoire du Judaïsme,2016,ILE-DE-FRANCE,PARIS,52721,31983,84704,
"Musée Cognacq-Jay, Musée du XVIIIe siècle de la ville de Paris",2016,ILE-DE-FRANCE,PARIS,15037,38312,53349,
Musée Carnavalet-Histoire de Paris,2016,ILE-DE-FRANCE,PARIS,8388,187404,195792,
Musée Zadkine,2016,ILE-DE-FRANCE,PARIS,3349,17400,20749,
Musée de la Vie Romantique,2016,ILE-DE-FRANCE,PARIS,36318,81688,118006,
Maison de Balzac,2016,ILE-DE-FRANCE,PARIS,4377,29286,33663,
Maison Natale de Louis Braille,2016,ILE-DE-FRANCE,COUPVRAY,4406,1417,5823,
Musée des Pays de Seine-et-Marne,2016,ILE-DE-FRANCE,SAINT-CYR-SUR-MORIN,3858,5860,9718,
Ecomusée du Val de Bièvre,2016,ILE-DE-FRANCE,FRESNES,0,9229,9229,
Musée Fragonard,2016,ILE-DE-FRANCE,MAISONS-ALFORT,4518,5232,9750,
"MAC VAL, Musée d'Art Contemporain du Val-de-Marne",2016,ILE-DE-FRANCE,VITRY SUR SEINE,8752,59631,68383,
Musée du Vieil Argenteuil,2016,ILE-DE-FRANCE,ARGENTEUIL,0,672,672,
ARCHEA - Archéologie en Pays de France,2016,ILE-DE-FRANCE,LOUVRES,7986,4744,12730,
Musée jean-Jacques Rousseau,2016,ILE-DE-FRANCE,MONTMORENCY,1294,727,2021,
Musée de la Batellerie et des Voies Navigables,2016,ILE-DE-FRANCE,CONFLANS-SAINTE-HONORINE,9631,2803,12434,
Musée Départemental Maurice Denis,2016,ILE-DE-FRANCE,SAINT-GERMAIN-EN-LAYE,10976,5189,16165,
Musée Régional d'Histoire et d'Ethnologie,2016,MARTINIQUE,FORT-DE-FRANCE,1799,3542,5341,
Ecomusée de la Martinique,2016,MARTINIQUE,RIVIERE-PILOTE,5043,5427,10470,
Musée du Débarquement,2016,NORMANDIE,ARROMANCHES,268915,10885,279800,
Musée de la Bataille de Tilly-Sur-Seulles 1944,2016,NORMANDIE,TILLY-SUR-SEULLES,759,517,1276,
Musée et Sites archéologiques de Vieux-la-Romaine,2016,NORMANDIE,VIEUX,11399,5933,17332,
Musée Alphonse-Georges Poulain,2016,NORMANDIE,VERNON,10301,14274,24575,
Musée du Vieux Château,2016,NORMANDIE,BRICQUEBEC-EN-COTENTIN,351,0,351,
Musée Christian Dior,2016,NORMANDIE,GRANVILLE,37418,6586,44004,
Musée Régional du Cidre et du Calvados,2016,NORMANDIE,VALOGNES,1187,947,2134,
Musée de la Poeslerie,2016,NORMANDIE,VILLEDIEU-LES-POELES-ROUFFIGNY,4849,661,5510,
Musée Municipal - Musée du Jouet,2016,NORMANDIE,LA FERTE-MACE,881,0,881,
Musée Départemental des Arts et Traditions Populaires du Perche,2016,NORMANDIE,SAINT-CYR LA ROSIERE,10068,12013,22081,
Musée Départemental d'Art Sacré,2016,NORMANDIE,SEES,453,433,886,
Musée des Terres-Neuvas et de la Pêche,2016,NORMANDIE,FECAMP,3544,648,4192,
Musée d'Art Moderne André Malraux - MuMa,2016,NORMANDIE,LE HAVRE,53464,46059,99523,
Muséum d'Histoire Naturelle,2016,NORMANDIE,LE HAVRE,2675,40000,42675,
Musée des Beaux-Arts,2016,NORMANDIE,ROUEN,67754,110546,178300,
Musée Victor Hugo,2016,NORMANDIE,VILLEQUIER,4689,7147,11836,
Cité International de la Bande Dessinée et de l'Image - Musée de la Bande Dessinée,2016,NOUVELLE-AQUITAINE,ANGOULEME,15011,41423,56434,
Musée Municipal de Cognac,2016,NOUVELLE-AQUITAINE,COGNAC,2945,2953,5898,
Hôtel Hèbre de Saint-Clément - Musée d'Art et d'Histoire,2016,NOUVELLE-AQUITAINE,ROCHEFORT,8659,9861,18520,
Musée Archéologique,2016,NOUVELLE-AQUITAINE,SAINTES,964,4641,5605,
Musée du Cloître de Tulle André Mazeyrie,2016,NOUVELLE-AQUITAINE,TULLE,0,9868,9868,
Musée des Arts Décoratifs et du Design,2016,NOUVELLE-AQUITAINE,BORDEAUX,15856,32407,48263,
Centre National Jean Moulin,2016,NOUVELLE-AQUITAINE,BORDEAUX,0,39543,39543,
Musée du Château Henri IV,2016,NOUVELLE-AQUITAINE,NERAC,8409,6817,15226,
Musée Municipal de Guéthary,2016,NOUVELLE-AQUITAINE,GUETHARY,1157,3010,4167,
Musée National du Château,2016,NOUVELLE-AQUITAINE,PAU,49921,43826,93747,
Musée du Textile et du Peigne en Corne,2016,OCCITANIE,LAVELANET,1934,386,2320,
Musée Petiet,2016,OCCITANIE,LIMOUX,467,2549,3016,
"Musée des Mœurs et Coutumes, Musée du Rouergue",2016,OCCITANIE,ESPALION,34,962,996,
Musée des Arts et Métiers Traditionnels,2016,OCCITANIE,SALLES-LA-SOURCE,3974,1783,5757,
Musée Léon Alègre,2016,OCCITANIE,BAGNOLS-SUR-CEZE,0,949,949,
Musée Cévenol,2016,OCCITANIE,LE VIGAN,1491,1721,3212,
Musée Archéologique,2016,OCCITANIE,NIMES,0,7240,7240,
Musée des Cultures Taurines (Annexe du Vieux Nîmes),2016,OCCITANIE,NIMES,2738,6735,9473,
Musée d'Histoire Naturelle et de Préhistoire,2016,OCCITANIE,NIMES,10387,29208,39595,
Musée Municipal,2016,OCCITANIE,MARTRES-TOLOSANE,637,2761,3398,
Musée Saint-Raymond,2016,OCCITANIE,TOULOUSE,16398,43976,60374,
Musée du Vieux Toulouse,2016,OCCITANIE,TOULOUSE,6130,1317,7447,
Musée Fleury,2016,OCCITANIE,LODEVE,8901,2592,11493,
Musée Louis Médard,2016,OCCITANIE,LUNEL,0,4939,4939,
Musée Archéologique Paul Soyris,2016,OCCITANIE,MURVIEL-LES-MONTPELLIER,258,1034,1292,
Musée Champollion - Les Ecriture du Monde,2016,OCCITANIE,FIGEAC,35003,5362,40365,
Musée Gallo-Romain d'Uxellodunum,2016,OCCITANIE,MARTEL,295,87,382,
Musée Départemental de Cuzals,2016,OCCITANIE,SAULIAC-SUR-CELE,6437,3968,10405,
Muséum d'Histoire Naturelle,2016,OCCITANIE,PERPIGNAN,0,10133,10133,
Musée Toulouse Lautrec,2016,OCCITANIE,ALBI,131178,32677,163855,
Musée Goya,2016,OCCITANIE,CASTRES,12213,10435,22648,
Musée de l'Abbaye Saint-Michel,2016,OCCITANIE,GAILLAC,1655,749,2404,
Musée Théodore Calbet,2016,OCCITANIE,GRISOLLES,0,2827,2827,
Musée d'Histoire Naturelle Victor Brun,2016,OCCITANIE,MONTAUBAN,1619,8439,10058,
Musée du Vignoble Nantais,2016,PAYS DE LA LOIRE,LE PALLET,3432,4995,8427,
Musée d'Art de Nantes,2016,PAYS DE LA LOIRE,NANTES,4592,95545,100137,
Musée du Château des Ducs de Bretagne,2016,PAYS DE LA LOIRE,NANTES,79692,152032,231724,
Musée du Vieux Château,2016,PAYS DE LA LOIRE,LAVAL,9986,23638,33624,
Musée du Château de Mayenne,2016,PAYS DE LA LOIRE,MAYENNE,7899,9274,17173,
Musée Vert Véron-de-Forbonnais,2016,PAYS DE LA LOIRE,LE MANS,3597,11808,15405,
Bibliothèque-musée,2016,PAYS DE LA LOIRE,SAINT-CALAIS,0,3140,3140,
Centre Minier de Faymoreau,2016,PAYS DE LA LOIRE,FAYMOREAU,14708,3869,18577,
Musée de Fontenay-le-Comte,2016,PAYS DE LA LOIRE,FONTENAY-LE-COMTE,2400,2526,4926,
Musée ornithologique Charles-Payraudeau,2016,PAYS DE LA LOIRE,LA-CHAIZE-LE-VICOMTE,116,413,529,
Historial de la Vendée,2016,PAYS DE LA LOIRE,LES LUCS-SUR-BOULOGNE,19288,48421,67709,
Musée d'Histoire Locale,2016,PROVENCE-ALPES-CÔTE D'AZUR,BIOT,2528,0,2528,
Musée de la Castre,2016,PROVENCE-ALPES-CÔTE D'AZUR,CANNES,12271,11424,23695,
Musée Jean Cocteau Collection Séverin Wunderman,2016,PROVENCE-ALPES-CÔTE D'AZUR,MENTON,27314,11156,38470,
Musée Archéologique - Site de  Cimiez,2016,PROVENCE-ALPES-CÔTE D'AZUR,NICE,3959,24729,28688,
Musée du Palais Lascaris,2016,PROVENCE-ALPES-CÔTE D'AZUR,NICE,15825,15399,31224,
Musée de la Légion Etrangère,2016,PROVENCE-ALPES-CÔTE D'AZUR,AUBAGNE/PUYLOUBIER,0,31969,31969,
Musée Grobet-Labadié,2016,PROVENCE-ALPES-CÔTE D'AZUR,MARSEILLE,0,1917,1917,
Musée Cantini,2016,PROVENCE-ALPES-CÔTE D'AZUR,MARSEILLE,54189,18614,72803,
Musée de l'Artillerie,2016,PROVENCE-ALPES-CÔTE D'AZUR,DRAGUIGNAN,0,21124,21124,
Musée Calvet (et musée Lapidaire),2016,PROVENCE-ALPES-CÔTE D'AZUR,AVIGNON,13175,20867,34042,
Musée Départemental des Pays De l'Ain,2017,AUVERGNE-RHONE-ALPES,BOURG-EN-BRESSE,0,68,68,
Musée de la Résistance et de la Déportation de l'Ain,2017,AUVERGNE-RHONE-ALPES,NANTUA,1764,2433,4197,
Musée du Peigne et de la Plasturgie,2017,AUVERGNE-RHONE-ALPES,OYONNAX,1464,3085,4549,
Musée Louis Jourdan,2017,AUVERGNE-RHONE-ALPES,SAINT-PAUL-DE-VARAX,236,222,458,
Musée Charles-Louis Philippe,2017,AUVERGNE-RHONE-ALPES,CERILLY,140,167,307,
Musée des Musiques Populaires - MuPop,2017,AUVERGNE-RHONE-ALPES,MONTLUCON,22887,300,23187,
Musée d'Histoire et d'Archéologie,2017,AUVERGNE-RHONE-ALPES,DIE,812,4425,5237,
Musée d'Art Sacré,2017,AUVERGNE-RHONE-ALPES,MOURS SAINT-EUSEBE,150,60,210,
Musée International de la Chaussure,2017,AUVERGNE-RHONE-ALPES,ROMANS,11142,14294,25436,
Musée des Vallées de Thônes,2017,AUVERGNE-RHONE-ALPES,THONES,752,1068,1820,
Musée d'Huez et de l'Oisans,2017,AUVERGNE-RHONE-ALPES,ALPE D'HUEZ,0,1503,1503,
Musée Géo-Charles,2017,AUVERGNE-RHONE-ALPES,ECHIROLLES,0,2569,2569,
Musée de la Grande Chartreuse,2017,AUVERGNE-RHONE-ALPES,SAINT-PIERRE-DE-CHARTREUSE,35900,1924,37824,
Musée des Beaux-Arts et d'Archéologie,2017,AUVERGNE-RHONE-ALPES,VIENNE,2050,3209,5259,
Musée-Cloître Saint-André-Le-Bas,2017,AUVERGNE-RHONE-ALPES,VIENNE,3066,3964,7030,
Musée Lucien Mainssieux,2017,AUVERGNE-RHONE-ALPES,VOIRON,0,4755,4755,
Musée des Beaux-Arts et d'Archéologie J. Dechelette,2017,AUVERGNE-RHONE-ALPES,ROANNE,1958,10676,12634,
Musée Départemental de la Céramique Gallo-Romaine,2017,AUVERGNE-RHONE-ALPES,LEZOUX,5518,4108,9626,
Musée Francisque Mandet,2017,AUVERGNE-RHONE-ALPES,RIOM,11780,2671,14451,
Musée Barthélemy-Thimonnier,2017,AUVERGNE-RHONE-ALPES,AMPLEPUIS,2096,1667,3763,
Musée Folklorique et Traditions Populaires Marius Audin,2017,AUVERGNE-RHONE-ALPES,BEAUJEU,718,463,1181,
Musée de l'Imprimerie et de la Communication Graphique,2017,AUVERGNE-RHONE-ALPES,LYON,20305,11924,32229,
Musée des Confluences,2017,AUVERGNE-RHONE-ALPES,LYON,369027,354556,723583,
Musée d'Art Contemporain de Lyon,2017,AUVERGNE-RHONE-ALPES,LYON,36707,75189,111896,
Musée archéologique et minéralogique Pierre Borrione,2017,AUVERGNE-RHONE-ALPES,AIME-EN-TARENTAISE,467,49,516,
Musée du Vin de Bourgogne,2017,BOURGOGNE-FRANCHE-COMTE,BEAUNE,11426,3884,15310,
Musée Archéologique,2017,BOURGOGNE-FRANCHE-COMTE,DIJON,0,22776,22776,
Musée de la résistance et de la Déportation,2017,BOURGOGNE-FRANCHE-COMTE,BESANCON,36488,12162,48650,
Musée Beurnier-Rossel,2017,BOURGOGNE-FRANCHE-COMTE,MONTBELIARD,499,2934,3433,
Musée du Château des Ducs de Wurtemberg,2017,BOURGOGNE-FRANCHE-COMTE,MONTBELIARD,4956,11116,16072,
Musée de Pontarlier,2017,BOURGOGNE-FRANCHE-COMTE,PONTARLIER,660,6593,7253,
Ecomusée du Pays de la Cerise,2017,BOURGOGNE-FRANCHE-COMTE,FOUGEROLLES,6281,2624,8905,
Musée Départemental de la Montagne Albert Demard,2017,BOURGOGNE-FRANCHE-COMTE,LE HAUT-DU-THEM,3955,2577,6532,
Musée Sarret de Grozon,2017,BOURGOGNE-FRANCHE-COMTE,ARBOIS,602,1577,2179,
Musée Municipal d'Archéologie,2017,BOURGOGNE-FRANCHE-COMTE,CHAMPAGNOLE,519,564,1083,
Musée du Jouet,2017,BOURGOGNE-FRANCHE-COMTE,MOIRANS-EN-MONTAGNE,34412,10658,45070,
Musée de la Faïence et des Beaux-Arts,2017,BOURGOGNE-FRANCHE-COMTE,NEVERS,6620,4573,11193,
Musée de la Mine,2017,BOURGOGNE-FRANCHE-COMTE,BLANZY,9452,1168,10620,
Musée Denon,2017,BOURGOGNE-FRANCHE-COMTE,CHALON-SUR-SAONE,27,13124,13151,
Ecomusée de la Communauté Le Creusot-Monceau-Les-Mines,2017,BOURGOGNE-FRANCHE-COMTE,LE CREUSOT,6008,7797,13805,
Musée Eucharistique du Hiéron,2017,BOURGOGNE-FRANCHE-COMTE,PARAY-LE-MONIAL,4050,6895,10945,
Ecomusée de la Bresse Bourguignonne,2017,BOURGOGNE-FRANCHE-COMTE,PIERRE-DE-BRESSE,23845,17142,40987,
Musée Frédéric Japy,2017,BOURGOGNE-FRANCHE-COMTE,BEAUCOURT,1231,941,2172,
Musée d'Art et d'Histoire,2017,BOURGOGNE-FRANCHE-COMTE,BELFORT,4254,19598,23852,
Musée des Arts Naïfs et Populaires de Noyers sur Serein,2017,BOURGOGNE-FRANCHE-COMTE,NOYERS-SUR-SEREIN,1580,588,2168,
Musée de l'Aventure du Son,2017,BOURGOGNE-FRANCHE-COMTE,SAINT-FARGEAU,3388,0,3388,
Musée Mathurin Meheut,2017,BRETAGNE,LAMBALLE,6290,1020,7310,
Ecomusée des Monts d'Arrée - Moulins de Kerouat,2017,BRETAGNE,COMMANA,7912,2670,10582,
Musée de la Pêche,2017,BRETAGNE,CONCARNEAU,21274,17543,38817,
Musée Départemental Breton,2017,BRETAGNE,QUIMPER,19443,24289,43732,
Musée de l'Ecole Rurale en Bretagne,2017,BRETAGNE,TREGARVAN,8609,2087,10696,
Ecomusée du Pays de Rennes,2017,BRETAGNE,RENNES,20962,37062,58024,
Musée du Château de Vitré,2017,BRETAGNE,VITRE,15572,4817,20389,
Musée de Préhistoire J. Miln- Z. Le-Rouzic,2017,BRETAGNE,CARNAC,31907,5899,37806,
Musée Saint-Vic,2017,CENTRE-VAL DE LOIRE,SAINT-AMAND-MONTROND,0,4791,4791,
Musée des Beaux-Arts,2017,CENTRE-VAL DE LOIRE,CHARTRES,0,13213,13213,
Conservatoire du Machinisme et des Pratiques Agricoles,2017,CENTRE-VAL DE LOIRE,CHARTRES-MAINVILLIERS,8755,18664,27419,
Musée George Sand et de la Vallée Noire,2017,CENTRE-VAL DE LOIRE,LA CHATRE,2425,5399,7824,
Musée Balzac,2017,CENTRE-VAL DE LOIRE,SACHE,12355,5090,17445,
Musée Municipal Théâtre Forain et Archéologique,2017,CENTRE-VAL DE LOIRE,ARTENAY,5528,2634,8162,
Musée d'Art et d'Archéologie,2017,CENTRE-VAL DE LOIRE,CHATILLON-COLIGNY,0,700,700,
Musée des Beaux-Arts,2017,CENTRE-VAL DE LOIRE,ORLEANS,12352,50976,63328,
Musée Palais Fesch,2017,CORSE,AJACCIO,21490,19797,41287,
Musée de Préhistoire Corse,2017,CORSE,SARTENE,5905,3140,9045,
Musée de la Corse,2017,CORSE,CORTE,59986,14300,74286,
Musée Départemental Pascal Paoli,2017,CORSE,MOROSAGLIA,3966,1324,5290,
Musée de l'Ardenne,2017,GRAND EST,CHARLEVILLE-MEZIERES,6660,45901,52561,
Musée Camille Claudel,2017,GRAND EST,NOGENT-SUR-SEINE,30961,20558,51519,
Musée de la Poterie,2017,GRAND EST,BETSCHDORF,2124,379,2503,
Maison de l'Archéologie des Vosges du Nord,2017,GRAND EST,NIEDERBRONN-LES-BAINS,1946,730,2676,
Musée du Fer,2017,GRAND EST,REICHSHOFFEN,868,1275,2143,
Musée Archéologique,2017,GRAND EST,STRASBOURG,23685,29700,53385,
Musée J.F. Oberlin,2017,GRAND EST,WALDERSBACH,22026,7716,29742,
"Musée de l'Affiche - Le Signe, Centre national du Graphisme",2017,GRAND EST,CHAUMONT,0,22193,22193,
Musée d'Histoire Naturelle et d'Ethnographie de Colmar,2017,GRAND EST,COLMAR,10097,6754,16851,
Musée d'Histoire Local,2017,GRAND EST,KAYSERSBERG,0,3782,3782,
Musée du Vignoble et des Vins d'Alsace,2017,GRAND EST,KAYSERSBERG VIGNOBLE,2645,20,2665,
Musée des Beaux-Arts,2017,GRAND EST,MULHOUSE,0,7284,7284,
Musée Minéralogique de la Société Industrielle de Mulhouse,2017,GRAND EST,MULHOUSE,0,60,60,
Maison du Sundgau - Musée Paysan,2017,GRAND EST,OLTINGUE,938,402,1340,
Musée du Dolder,2017,GRAND EST,RIQUEWIHR,2703,728,3431,
Musée de l'Ancien Collège des Jésuites/Planétarium,2017,GRAND EST,REIMS,23257,17544,40801,
Musée des Beaux-Arts de Saint-Denis,2017,GRAND EST,REIMS,18520,26502,45022,
Musée de l'Argonne Viard-Morel,2017,GRAND EST,SAINTE-MENEHOULD,531,1420,1951,
Musée Départemental de la Guerre de 70,2017,GRAND EST,GRAVELOTTE,11035,6150,17185,
Musée de la Mine - Carreau Wendel,2017,GRAND EST,PETITE-ROSSELLE,57042,5600,62642,
"Moulin de la Blies - Musée des Techniques Faïencières (+ Jardin d'Hiver, Musée de La Faïence)",2017,GRAND EST,SARREGUEMINES,10431,22578,33009,
Musée de l'Image,2017,GRAND EST,EPINAL,14032,2247,16279,
Musée Territorial Alexandre Franconie,2017,GUYANE,CAYENNE,2475,6283,8758,
Ecomusée Municipal d'Approuague-Kaw,2017,GUYANE,REGINA,578,3027,3605,
Musée de l'Ostrevant,2017,HAUTS-DE-FRANCE,BOUCHAIN,158,892,1050,
Musée des Dentelles et Broderies,2017,HAUTS-DE-FRANCE,CAUDRY,9498,4622,14120,
Ecomusée de la Région,2017,HAUTS-DE-FRANCE,FOURMIES,22949,16052,39001,
"Centre Historique Minier, Musée de la Mine, Centre d'Archives, Centre de Culture Scientifique de l'Energie",2017,HAUTS-DE-FRANCE,LEWARDE,147080,10401,157481,
Musée d'Histoire Locale de Marchiennes,2017,HAUTS-DE-FRANCE,MARCHIENNES,102,399,501,
MusVerre,2017,HAUTS-DE-FRANCE,SARS-POTERIES,26402,20233,46635,
MUba - Musée des Beaux-Arts Eugène Leroy de Tourcoing,2017,HAUTS-DE-FRANCE,TOURCOING,18066,12587,30653,
Musée de la Figurine Historique,2017,HAUTS-DE-FRANCE,COMPIEGNE,2407,5766,8173,
Musée de la Nacre et de la Tabletterie,2017,HAUTS-DE-FRANCE,MERU,12759,4254,17013,
Musée de Boulogne-sur-Mer,2017,HAUTS-DE-FRANCE,BOULOGNE-SUR-MER,14452,14247,28699,
Musée des Beaux-Arts et de la Dentelle,2017,HAUTS-DE-FRANCE,CALAIS,6139,15658,21797,
Musée-Jardin Paul Landowski,2017,ILE-DE-FRANCE,BOULOGNE-BILLANCOURT,1914,7669,9583,
Musée des Années Trente,2017,ILE-DE-FRANCE,BOULOGNE-BILLANCOURT,7726,11432,19158,
Musée Belmondo et de la Sculpture Figurative du XXè siècle,2017,ILE-DE-FRANCE,BOULOGNE-BILLANCOURT,2913,4049,6962,
Musée d'Histoire Locale - Mémoire de la Ville,2017,ILE-DE-FRANCE,RUEIL-MALMAISON,0,9931,9931,
Musée des Avelines - Musée d'Art et d'Histoire,2017,ILE-DE-FRANCE,SAINT-CLOUD,3837,13443,17280,
Musée du Domaine Départemental de Sceaux,2017,ILE-DE-FRANCE,SCEAUX,20912,14376,35288,
Galerie de Botanique (Muséum National National d'Histoire Naturelle),2017,ILE-DE-FRANCE,PARIS,6880,2185,9065,
Musée de l'Homme (Muséum National d'Histoire Naturelle),2017,ILE-DE-FRANCE,PARIS,60482,176158,236640,
Galerie de Minéralogie et de Géologie (Muséum d'Histoire Naturelle),2017,ILE-DE-FRANCE,PARIS,50496,11845,62341,
Maison de Victor Hugo,2017,ILE-DE-FRANCE,PARIS,44859,121221,166080,
Musée Carnavalet-Histoire de Paris,2017,ILE-DE-FRANCE,PARIS,0,8187,8187,
Les Catacombes,2017,ILE-DE-FRANCE,PARIS,446486,91449,537935,
Musée de la Vie Romantique,2017,ILE-DE-FRANCE,PARIS,97165,0,97165,
Etablissement Public du Musée des Arts Asiatiques Guimet,2017,ILE-DE-FRANCE,PARIS,145397,172359,317756,
Palais Galliera - Musée de la Mode de la ville de Paris,2017,ILE-DE-FRANCE,PARIS,97830,41928,139758,
Musée du Maréchal Leclerc de Hauteclocque et de la Libération de Paris - musée Jean Moulin,2017,ILE-DE-FRANCE,PARIS,809,13030,13839,
Musée du Louvre,2017,ILE-DE-FRANCE,PARIS,5411926,2610343,8022269,
Musée National Eugène Delacroix,2017,ILE-DE-FRANCE,PARIS,40262,35336,75598,
"Musée Cernuschi, Musée des Arts de l'Asie de la ville de Paris",2017,ILE-DE-FRANCE,PARIS,29138,23376,52514,
Musée National Picasso,2017,ILE-DE-FRANCE,PARIS,401173,171931,573104,
Musée des Arts Décoratifs (Union Centrale des Arts Décoratifs),2017,ILE-DE-FRANCE,PARIS,624635,245162,869797,
Musée du 11 Conti - Monnaie de Paris,2017,ILE-DE-FRANCE,PARIS,74000,26000,100000,
Musée du Quai Branly - Jacques Chirac,2017,ILE-DE-FRANCE,PARIS,546417,627297,1173714,
Musée du Château de Fontainebleau,2017,ILE-DE-FRANCE,FONTAINEBLEAU,190342,168294,358636,
Musée Gatien Bonnet,2017,ILE-DE-FRANCE,LAGNY-SUR-MARNE,0,6021,6021,
Musée Henri Chapu,2017,ILE-DE-FRANCE,LE MEE-SUR-SEINE,0,234,234,
Musée de la Grande Guerre du Pays de Meaux,2017,ILE-DE-FRANCE,MEAUX,64233,26767,91000,
Musée de Provins et du Provinois,2017,ILE-DE-FRANCE,PROVINS,16340,4985,21325,
Musée d'Art et d'Histoire,2017,ILE-DE-FRANCE,SAINT-DENIS,12487,4526,17013,
"MAC VAL, Musée d'Art Contemporain du Val-de-Marne",2017,ILE-DE-FRANCE,VITRY SUR SEINE,8209,60758,68967,
Musée du Vieil Argenteuil,2017,ILE-DE-FRANCE,ARGENTEUIL,0,833,833,
Musée d'Archéologie Nationale (des origines à l'an mille) - Château de st-Germain-en-Laye,2017,ILE-DE-FRANCE,SAINT-GERMAIN-EN-LAYE,23661,78905,102566,
Muséum Agricole et Industriel Stella Matutina,2017,LA REUNION,PITON-SAINT-LEU,97025,6842,103867,
Ecomusée de la Martinique,2017,MARTINIQUE,RIVIERE-PILOTE,1351,10476,11827,
Mémorial de Caen,2017,NORMANDIE,CAEN,319707,52045,371752,
Musée Eugène Boudin,2017,NORMANDIE,HONFLEUR,29103,6362,35465,
Musée Artisanal et Industriel d'Instruments à Vent,2017,NORMANDIE,LA COUTURE-BOUSSEY,0,3449,3449,
Muséum Emmanuel Liais,2017,NORMANDIE,CHERBOURG-EN-COTENTIN,2366,5827,8193,
Musée Barbey d'Aurevilly,2017,NORMANDIE,SAINT-SAUVEUR-LE-VICOMTE,747,282,1029,
Musée Municipal - Musée du Jouet,2017,NORMANDIE,LA FERTE-MACE,1032,0,1032,
Musée Départemental d'Art Sacré,2017,NORMANDIE,SEES,496,164,660,
Pavillon Flaubert,2017,NORMANDIE,CANTELEU,0,725,725,
Musée Louis-Philippe du Château d'Eu,2017,NORMANDIE,EU,14114,3728,17842,
Musée du Prieuré,2017,NORMANDIE,HARFLEUR,150,2000,2150,
Musée Départemental Pierre Corneille,2017,NORMANDIE,LE PETIT-COURONNE,0,3348,3348,
"Juliobona, Musée Gallo-Romain de Lillebonne",2017,NORMANDIE,LILLEBONNE,1791,2260,4051,
Ecomusée de la Basse-Seine,2017,NORMANDIE,NOTRE-DAME-DE-BLIQUETUIT,19933,3245,23178,
Musée-Maison Natale Pierre Corneille,2017,NORMANDIE,ROUEN,0,5953,5953,
Muséum d'Histoire Naturelle,2017,NORMANDIE,ROUEN,4855,44682,49537,
Association de l'Horlogerie Aliermontaise,2017,NORMANDIE,SAINT-NICOLAS-D'ALIERMONT,3666,1323,4989,
Musée Victor Hugo,2017,NORMANDIE,VILLEQUIER,5193,6919,12112,
Musée des Arts du Cognac (Annexe musée municipal),2017,NOUVELLE-AQUITAINE,COGNAC,6232,2044,8276,
Musée du Pays d'Ussel,2017,NOUVELLE-AQUITAINE,USSEL,734,1904,2638,
Musée Départemental de la Tapisserie,2017,NOUVELLE-AQUITAINE,AUBUSSON,32527,12030,44557,
Musée de Bressuire,2017,NOUVELLE-AQUITAINE,BRESSUIRE,0,3315,3315,
Musée Bernard d’Agesci,2017,NOUVELLE-AQUITAINE,NIORT,6200,12057,18257,
Château de Bourdeilles,2017,NOUVELLE-AQUITAINE,BOURDEILLES,27832,0,27832,
Centre National Jean Moulin,2017,NOUVELLE-AQUITAINE,BORDEAUX,0,43741,43741,
Musée des Beaux-Arts,2017,NOUVELLE-AQUITAINE,BORDEAUX,50023,62084,112107,
Musée Historique de l'Hydravion,2017,NOUVELLE-AQUITAINE,BISCARROSSE,16112,2596,18708,
Musée Départemental de la Faïence et des Arts de la table,2017,NOUVELLE-AQUITAINE,SAMADET,2406,2351,4757,
Musée Municipal Albert Marzelles,2017,NOUVELLE-AQUITAINE,MARMANDE,0,6516,6516,
Musée du Château Henri IV,2017,NOUVELLE-AQUITAINE,NERAC,13768,3177,16945,
Musée Municipal de la Maison-Dieu,2017,NOUVELLE-AQUITAINE,MONTMORILLON,0,6575,6575,
Musée du Palais des Evêques,2017,OCCITANIE,SAINT-LIZIER,11121,1276,12397,
Musée Archéologique,2017,OCCITANIE,SALLELES D'AUDE,6858,5920,12778,
Musée des Beaux-Arts Denys Puech,2017,OCCITANIE,RODEZ,0,8086,8086,
Musée Soulages,2017,OCCITANIE,RODEZ,103241,35963,139204,
Musée Albert André,2017,OCCITANIE,BAGNOLS-SUR-CEZE,152,4335,4487,
Musée du Vieux Nîmes,2017,OCCITANIE,NIMES,1200,12680,13880,
Musée Départemental d'Art Sacré du Gard,2017,OCCITANIE,PONT-SAINT-ESPRIT,169,8804,8973,
Musée de l'Etang de Thau,2017,OCCITANIE,BOUZIGUES,11277,2153,13430,
Musée de l'Ephèbe,2017,OCCITANIE,LE CAP D'AGDE,8607,5436,14043,
Musée Louis Médard,2017,OCCITANIE,LUNEL,0,6748,6748,
Musée de Préhistoire Régionale et du Mégalithisme,2017,OCCITANIE,SAINT-PONS-DE-THOMIERES,1577,0,1577,
Musée de Préhistoire Amédée Lémozi,2017,OCCITANIE,CABRERETS,80195,0,80195,
Musée Champollion - Les Ecriture du Monde,2017,OCCITANIE,FIGEAC,25946,13376,39322,
"Musée Archéologique ""Armand-Viré""",2017,OCCITANIE,LUZECH,222,261,483,
Musée Toulouse Lautrec,2017,OCCITANIE,ALBI,135171,30766,165937,
Musée Eugénie et Maurice Guérin,2017,OCCITANIE,ANDILLAC,1433,2064,3497,
Musée Jean Jaurès,2017,OCCITANIE,CASTRES,2665,6890,9555,
Musée du Vieil Auvillar,2017,OCCITANIE,AUVILLAR,2220,705,2925,
Musée d'Histoire Naturelle Victor Brun,2017,OCCITANIE,MONTAUBAN,1581,7724,9305,
"Musée de la Fève, Crèches et Traditions Populaires",2017,PAYS DE LA LOIRE,BLAIN,714,58,772,
Musée du Château des Ducs de Bretagne,2017,PAYS DE LA LOIRE,NANTES,94794,175448,270242,
Musée Pincé,2017,PAYS DE LA LOIRE,ANGERS,0,144,144,
Musée d'Art et d'Histoire,2017,PAYS DE LA LOIRE,CHOLET,1763,12228,13991,
Musée du Textile,2017,PAYS DE LA LOIRE,CHOLET,4840,7827,12667,
Château-Musée,2017,PAYS DE LA LOIRE,SAUMUR,79766,14581,94347,
Musée d'Art et d'Archéologie Hôtel Fouquet,2017,PAYS DE LA LOIRE,CHATEAU-GONTIER,506,923,1429,
Musée de Fontenay-le-Comte,2017,PAYS DE LA LOIRE,FONTENAY-LE-COMTE,1830,1557,3387,
Musée ornithologique Charles-Payraudeau,2017,PAYS DE LA LOIRE,LA-CHAIZE-LE-VICOMTE,259,302,561,
Historial de la Vendée,2017,PAYS DE LA LOIRE,LES LUCS-SUR-BOULOGNE,18952,37005,55957,
Musée Milcendeau Jean-Yole,2017,PAYS DE LA LOIRE,SOULLANS,2569,1024,3593,
Musée Municipal,2017,PROVENCE-ALPES-CÔTE D'AZUR,FORCALQUIER,0,1997,1997,
Musée de la Faïence,2017,PROVENCE-ALPES-CÔTE D'AZUR,MOUSTIERS-SAINTE-MARIE,6539,1738,8277,
Musée Gallo-Romain Sisteron,2017,PROVENCE-ALPES-CÔTE D'AZUR,SISTERON,235,8214,8449,
Musée d'Histoire et d'Archéologie,2017,PROVENCE-ALPES-CÔTE D'AZUR,ANTIBES,5412,6175,11587,
Musée-Château de Cagnes,2017,PROVENCE-ALPES-CÔTE D'AZUR,CAGNES-SUR-MER,13031,7317,20348,
Musée Renoir,2017,PROVENCE-ALPES-CÔTE D'AZUR,CAGNES-SUR-MER,23370,14203,37573,
Musée Bonnard,2017,PROVENCE-ALPES-CÔTE D'AZUR,LE CANNET,22317,12017,34334,
Musée Départemental des Arts Asiatiques,2017,PROVENCE-ALPES-CÔTE D'AZUR,NICE,7356,46332,53688,
Muséum d'Histoire Naturelle,2017,PROVENCE-ALPES-CÔTE D'AZUR,NICE,1522,4027,5549,
Musée Matisse,2017,PROVENCE-ALPES-CÔTE D'AZUR,NICE,66164,53464,119628,
Musée Départemental des Merveilles,2017,PROVENCE-ALPES-CÔTE D'AZUR,TENDE,0,24987,24987,
Musée Picasso la guerre et la paix à Vallauris,2017,PROVENCE-ALPES-CÔTE D'AZUR,VALLAURIS,13516,6714,20230,
"Musée Magnelli, Musée de la Céramique",2017,PROVENCE-ALPES-CÔTE D'AZUR,VALLAURIS,13226,10780,24006,
Musée Départemental de l'Arles Antique,2017,PROVENCE-ALPES-CÔTE D'AZUR,ARLES,47832,94933,142765,
Musée de la Légion Etrangère,2017,PROVENCE-ALPES-CÔTE D'AZUR,AUBAGNE/PUYLOUBIER,0,20164,20164,
Musée de l'Uniforme - Musée de la Légion Etrangère,2017,PROVENCE-ALPES-CÔTE D'AZUR,PUYLOUBIER,0,6492,6492,
Fondation Louis Jou,2017,PROVENCE-ALPES-CÔTE D'AZUR,LES-BAUX-DE-PROVENCE,0,1200,1200,
Musée d'Archéologie Méditerranéenne,2017,PROVENCE-ALPES-CÔTE D'AZUR,MARSEILLE,40401,60031,100432,
Musée Cantini,2017,PROVENCE-ALPES-CÔTE D'AZUR,MARSEILLE,18493,21710,40203,
Musée Départemental des Hautes-Alpes,2017,PROVENCE-ALPES-CÔTE D'AZUR,GAP,0,18153,18153,
Musée du Vêtement Provençal (Jean Aicard),2017,PROVENCE-ALPES-CÔTE D'AZUR,SOLLIES-VILLE,0,5952,5952,
Musée National de la Marine de Toulon,2017,PROVENCE-ALPES-CÔTE D'AZUR,TOULON,30710,24762,55472,
Musée d'Apt,2017,PROVENCE-ALPES-CÔTE D'AZUR,APT,3003,5520,8523,
Musée du Petit Palais,2017,PROVENCE-ALPES-CÔTE D'AZUR,AVIGNON,15124,16579,31703,
Musée Départemental du Cartonnage et de l'Imprimerie,2017,PROVENCE-ALPES-CÔTE D'AZUR,VALREAS,2857,1796,4653,
Musée du Brou,2018,AUVERGNE-RHONE-ALPES,BOURG-EN-BRESSE,62284,35932,98216,
Musée Louis Jourdan,2018,AUVERGNE-RHONE-ALPES,SAINT-PAUL-DE-VARAX,238,190,428,
Musée Municipal de Souvigny,2018,AUVERGNE-RHONE-ALPES,SOUVIGNY,7063,2631,9694,
Musée de la Haute Auvergne,2018,AUVERGNE-RHONE-ALPES,SAINT-FLOUR,2573,5620,8193,
Musée des Beaux-Arts,2018,AUVERGNE-RHONE-ALPES,VALENCE,18806,20379,39185,
Musée des Arts et Traditions Populaires de Haute Loire,2018,AUVERGNE-RHONE-ALPES,LAVAUDIEU,6459,75,6534,
"Notre histoire, Musée de Rumilly",2018,AUVERGNE-RHONE-ALPES,RUMILLY,1548,662,2210,
Musée de Bourgoin-Jallieu,2018,AUVERGNE-RHONE-ALPES,BOURGOIN-JALLIEU,4695,5234,9929,
Musée - Parc Archéologique du Lac de Paladru,2018,AUVERGNE-RHONE-ALPES,CHARAVINES,0,460,460,
Musée Départemental de la Révolution Française,2018,AUVERGNE-RHONE-ALPES,VIZILLE,0,69610,69610,
Musée d'Archéologie,2018,AUVERGNE-RHONE-ALPES,FEURS,1979,3464,5443,
Musée de la Mine / Site Couriot,2018,AUVERGNE-RHONE-ALPES,SAINT-ETIENNE,30551,23101,53652,
Musée d'Art et d'Industrie,2018,AUVERGNE-RHONE-ALPES,SAINT-ETIENNE,16545,14659,31204,
Musée des Civilisations : Daniel Pouget,2018,AUVERGNE-RHONE-ALPES,SAINT-JUST-SAINT-RAMBERT,3926,1992,5918,
Musée Départemental de la Céramique Gallo-Romaine,2018,AUVERGNE-RHONE-ALPES,LEZOUX,7590,3871,11461,
Musée Historique des Tissus,2018,AUVERGNE-RHONE-ALPES,LYON,35711,18335,54046,
Musée des Confluences,2018,AUVERGNE-RHONE-ALPES,LYON,340291,340292,680583,
Musée Municipal d'Albertville-Conflans,2018,AUVERGNE-RHONE-ALPES,ALBERTVILLE,3326,2289,5615,
Musée Alésia - Centre d'Interprétation,2018,BOURGOGNE-FRANCHE-COMTE,ALISE-SAINTE-REINE,13713,56209,69922,
Musée des Beaux-Arts,2018,BOURGOGNE-FRANCHE-COMTE,BEAUNE,919,4310,5229,
Musée François Rude,2018,BOURGOGNE-FRANCHE-COMTE,DIJON,0,88968,88968,
Musée Magnin,2018,BOURGOGNE-FRANCHE-COMTE,DIJON,7155,10737,17892,
Musée Municipal François Pompon,2018,BOURGOGNE-FRANCHE-COMTE,SAULIEU,3308,6420,9728,
Musée Municipal,2018,BOURGOGNE-FRANCHE-COMTE,SEMUR-EN-AUXOIS,1853,532,2385,
Musée du Château des Ducs de Wurtemberg,2018,BOURGOGNE-FRANCHE-COMTE,MONTBELIARD,4382,9685,14067,
Musée Georges Garret,2018,BOURGOGNE-FRANCHE-COMTE,VESOUL,0,4345,4345,
Musée de la Vigne et du Vin,2018,BOURGOGNE-FRANCHE-COMTE,ARBOIS,3953,2881,6834,
Musée des Beaux-Arts,2018,BOURGOGNE-FRANCHE-COMTE,DOLE,0,23507,23507,
Musée des Salines,2018,BOURGOGNE-FRANCHE-COMTE,SALINS-LES-BAINS,56650,5407,62057,
Musée du Costume,2018,BOURGOGNE-FRANCHE-COMTE,CHATEAU-CHINON,2684,894,3578,
Musée de la Loire,2018,BOURGOGNE-FRANCHE-COMTE,COSNE-SUR-LOIRE,778,4234,5012,
Musée Rolin,2018,BOURGOGNE-FRANCHE-COMTE,AUTUN,10818,8914,19732,
Musée René Davoine,2018,BOURGOGNE-FRANCHE-COMTE,CHAROLLES,0,100,100,
Musée des Ursulines,2018,BOURGOGNE-FRANCHE-COMTE,MACON,2978,8399,11377,
Musée de la Tour du Moulin,2018,BOURGOGNE-FRANCHE-COMTE,MARCIGNY,1314,777,2091,
Musée Eucharistique du Hiéron,2018,BOURGOGNE-FRANCHE-COMTE,PARAY-LE-MONIAL,4443,5891,10334,
Ecomusée de la Bresse Bourguignonne,2018,BOURGOGNE-FRANCHE-COMTE,PIERRE-DE-BRESSE,22620,18476,41096,
Forge-Musée,2018,BOURGOGNE-FRANCHE-COMTE,ETUEFFONT,346,681,1027,
Musée de l'Aventure du Son,2018,BOURGOGNE-FRANCHE-COMTE,SAINT-FARGEAU,2765,0,2765,
Musée Colette,2018,BOURGOGNE-FRANCHE-COMTE,SAINT-SAUVEUR-EN-PUISAYE,5777,1306,7083,
Musée de l'Ecole Rurale en Bretagne,2018,BRETAGNE,TREGARVAN,8478,1936,10414,
Ecomusée du Pays de Rennes,2018,BRETAGNE,RENNES,21212,35965,57177,
Musée des Beaux-Arts,2018,BRETAGNE,RENNES,25811,83308,109119,
Musée International du Long-Cours Cap-Hornier,2018,BRETAGNE,SAINT-MALO,7764,7061,14825,
Musée National de la Marine,2018,BRETAGNE,PORT-LOUIS,39896,31547,71443,
Conservatoire du Machinisme et des Pratiques Agricoles,2018,CENTRE-VAL DE LOIRE,CHARTRES-MAINVILLIERS,8965,25845,34810,
Musée de l'Histoire du Perche,2018,CENTRE-VAL DE LOIRE,NOGENT-LE-ROTROU,5738,7092,12830,
Musée Farcot,2018,CENTRE-VAL DE LOIRE,SAINVILLE,24,54,78,
Musée Archéologique d'Argentomagus,2018,CENTRE-VAL DE LOIRE,SAINT-MARCEL,5930,4409,10339,
Muséum d'Histoire Naturelle,2018,CENTRE-VAL DE LOIRE,TOURS,11487,23096,34583,
Musée Municipal Théâtre Forain et Archéologique,2018,CENTRE-VAL DE LOIRE,ARTENAY,6215,3109,9324,
Musée de la Marine de Loire,2018,CENTRE-VAL DE LOIRE,CHATEAUNEUF-SUR-LOIRE,8245,4967,13212,
"Château-Musée de Gien : chasse, histoire et nature en Val de Loire",2018,CENTRE-VAL DE LOIRE,GIEN,14408,2601,17009,
Musée des Beaux-Arts,2018,CENTRE-VAL DE LOIRE,ORLEANS,33816,15418,49234,
Musée d'Histoire de Bastia,2018,CORSE,BASTIA,17483,14651,32134,
Musée de la Corse,2018,CORSE,CORTE,63250,9726,72976,
Musée Archéologique de Mariana - Prince Rainier III de Monaco,2018,CORSE,LUCCIANA,0,7000,7000,
Musée de l'Ardenne,2018,GRAND EST,CHARLEVILLE-MEZIERES,5617,39879,45496,
Musée des Beaux-Arts (Musée Pic Saint-Loup),2018,GRAND EST,TROYES,5764,20780,26544,
Musée d'Art Moderne,2018,GRAND EST,TROYES,8359,687,9046,
Musée de la Folie Marco,2018,GRAND EST,BARR,1249,2341,3590,
Musée de la Poterie,2018,GRAND EST,BETSCHDORF,1875,962,2837,
Maison de l'Archéologie des Vosges du Nord,2018,GRAND EST,NIEDERBRONN-LES-BAINS,1469,380,1849,
Musée des Arts Décoratifs,2018,GRAND EST,STRASBOURG,38197,41400,79597,
Cabinet des Estampes et des Dessins,2018,GRAND EST,STRASBOURG,0,164,164,
Musée des Beaux-Arts et d'Archéologie,2018,GRAND EST,CHAUMONT,2148,2162,4310,
Musée Municipal,2018,GRAND EST,SAINT-DIZIER,0,4527,4527,
Musée Bartholdi,2018,GRAND EST,COLMAR,17045,8218,25263,
Musée du Vignoble et des Vins d'Alsace,2018,GRAND EST,KAYSERSBERG VIGNOBLE,2880,0,2880,
Cité du Train,2018,GRAND EST,MULHOUSE,64954,35363,100317,
Maison du Sundgau - Musée Paysan,2018,GRAND EST,OLTINGUE,720,112,832,
Musée du Cloître de Notre-Dame-en-Vaux,2018,GRAND EST,CHALONS-EN-CHAMPAGNE,818,1604,2422,
Musée Saint-Rémi,2018,GRAND EST,REIMS,8309,15432,23741,
Musée de l'Ancien Collège des Jésuites/Planétarium,2018,GRAND EST,REIMS,23286,15524,38810,
Musée Jeanne d'Arc,2018,GRAND EST,VAUCOULEURS,848,33,881,
Ecomusée de Marie-Galante,2018,GUADELOUPE,GRAND-BOURG de MARIE-GALANTE,0,39194,39194,
Ecomusée Municipal d'Approuague-Kaw,2018,GUYANE,REGINA,1102,4010,5112,
Musée d'Art et d'Archéologie,2018,HAUTS-DE-FRANCE,LAON,1430,4420,5850,
Musée de la Résistance et de la Déportation,2018,HAUTS-DE-FRANCE,TERGNIER,3378,700,4078,
Musée de La Thiérache,2018,HAUTS-DE-FRANCE,VERVINS,0,5127,5127,
"Centre Historique Minier, Musée de la Mine, Centre d'Archives, Centre de Culture Scientifique de l'Energie",2018,HAUTS-DE-FRANCE,LEWARDE,137059,10281,147340,
Musée d'Histoire Naturelle et de Géologie,2018,HAUTS-DE-FRANCE,LILLE,46156,73915,120071,
La Piscine - Musée d'Art et d'Industrie André Diligent de Roubaix,2018,HAUTS-DE-FRANCE,ROUBAIX,84807,58196,143003,
MUDO - Musée de l'Oise,2018,HAUTS-DE-FRANCE,BEAUVAIS,0,48609,48609,
Musée Gallé-Juillet,2018,HAUTS-DE-FRANCE,CREIL,1868,6540,8408,
Musée Communautaire Opale-Sud,2018,HAUTS-DE-FRANCE,BERCK-SUR-MER,3491,5661,9152,
Musée Régional d'Ethnologie,2018,HAUTS-DE-FRANCE,BETHUNE,0,4766,4766,
Musée de la Céramique,2018,HAUTS-DE-FRANCE,DESVRES,6981,1583,8564,
Musée Quentovic,2018,HAUTS-DE-FRANCE,ETAPLES-SUR-MER,0,90,90,
Musée d'Histoire et d'Archéologie,2018,HAUTS-DE-FRANCE,HARNES,0,345,345,
Musée d'Art et d'Histoire Roger Rodière,2018,HAUTS-DE-FRANCE,MONTREUIL-SUR-MER,13741,11411,25152,
Musée de l'Hôtel Sandelin,2018,HAUTS-DE-FRANCE,SAINT-OMER,6490,8771,15261,
Musée Boucher-de-Perthes,2018,HAUTS-DE-FRANCE,ABBEVILLE,1730,8263,9993,
Musée de Picardie,2018,HAUTS-DE-FRANCE,AMIENS,0,1776,1776,
Musée Lombart,2018,HAUTS-DE-FRANCE,DOULLENS,190,4173,4363,
Musée Intercommunal d'Etampes,2018,ILE-DE-FRANCE,ETAMPES,643,9482,10125,
Musée d'Art et d'Histoire,2018,ILE-DE-FRANCE,MEUDON,3381,10795,14176,
Musée - Atelier Rodin (Annexe du musée de Paris),2018,ILE-DE-FRANCE,MEUDON,0,20485,20485,
Musée du Moyen Age-Thermes et Hôtel de Cluny,2018,ILE-DE-FRANCE,PARIS,76040,82647,158687,
Etablissement public du musée d'Orsay et de l'Orangerie - Musée de l'Orangerie,2018,ILE-DE-FRANCE,PARIS,636405,367882,1004287,
Musée de la Musique,2018,ILE-DE-FRANCE,PARIS,166776,91506,258282,
Palais Galliera - Musée de la Mode de la ville de Paris,2018,ILE-DE-FRANCE,PARIS,59211,30583,89794,
Musée du Maréchal Leclerc de Hauteclocque et de la Libération de Paris - musée Jean Moulin,2018,ILE-DE-FRANCE,PARIS,0,7210,7210,
Musée des Plans et Reliefs,2018,ILE-DE-FRANCE,PARIS,168491,4621,173112,
Musée National d'Art Moderne (Centre National d'Art et de Culture Georges Pompidou),2018,ILE-DE-FRANCE,PARIS,2620481,1070337,3690818,
"Musée des Transports Urbains, Interurbains et Ruraux",2018,ILE-DE-FRANCE,CHELLES,5000,0,5000,
Musée de Provins et du Provinois,2018,ILE-DE-FRANCE,PROVINS,13417,6127,19544,
Musée de l'Air et de l'Espace,2018,ILE-DE-FRANCE,LE BOURGET,105561,88833,194394,
Musée de Saint-Maur - Villa Médicis,2018,ILE-DE-FRANCE,LA VARENNE-SAINT-HILAIRE,1620,3686,5306,
Musée jean-Jacques Rousseau,2018,ILE-DE-FRANCE,MONTMORENCY,1327,1550,2877,
Musée Camille Pissarro,2018,ILE-DE-FRANCE,PONTOISE,4203,1917,6120,
Musée de la Toile de Jouy,2018,ILE-DE-FRANCE,JOUY-EN-JOSAS,7047,2458,9505,
Musée Victor Aubert,2018,ILE-DE-FRANCE,MAULE,0,510,510,
Musée de la Ville,2018,ILE-DE-FRANCE,MONTIGNY LE BRETONNEUX,2816,5858,8674,
Musée des Arts Décoratifs de l’Océan indien (MADOI),2018,LA REUNION,SAINT-LOUIS,8408,2404,10812,
Musée d'Ethnographie et d'Arts Populaires et Musée de la Marine,2018,NORMANDIE,HONFLEUR,12360,10908,23268,
Musée de la Mine,2018,NORMANDIE,LE MOLAY-LITTRY,1907,799,2706,
Musée de la Meunerie - Moulin de Marcy,2018,NORMANDIE,LE MOLAY-LITTRY,2048,726,2774,
Musée Municipal,2018,NORMANDIE,BERNAY,1059,6526,7585,
Musée des Beaux-Arts,2018,NORMANDIE,SAINT-LO,1754,8338,10092,
Musée Maritime de l'Ile de Tatihou,2018,NORMANDIE,SAINT-VAAST-LA-HOUGUE,68351,3213,71564,
Museoseine,2018,NORMANDIE,CAUDEBEC-EN-CAUX,17886,0,17886,
Château-Musée de Dieppe,2018,NORMANDIE,DIEPPE,15358,12088,27446,
Musée des Traditions et Arts Normands,2018,NORMANDIE,MARTAINVILLE-EPREVILLE,12376,11557,23933,
Musée Mathon-Durand,2018,NORMANDIE,NEUFCHATEL-EN-BRAY,934,881,1815,
Musée des Beaux-Arts,2018,NORMANDIE,ROUEN,27874,108030,135904,
Musée Municipal des Ivoires,2018,NORMANDIE,YVETOT,615,264,879,
Musée de la Mémoire et des Industries Tullistes,2018,NOUVELLE-AQUITAINE,TULLE,0,2353,2353,
Musée d'Art et d'Archéologie,2018,NOUVELLE-AQUITAINE,GUERET,353,1834,2187,
Musée Henri Barré,2018,NOUVELLE-AQUITAINE,THOUARS,401,1887,2288,
Musée des Arts et Traditions Populaires du Périgord,2018,NOUVELLE-AQUITAINE,MUSSIDAN,1246,1552,2798,
Musée de la Voiture à Cheval. Au temps des calèches,2018,NOUVELLE-AQUITAINE,BOURG-SUR-GIRONDE,3847,1657,5504,
Cité de la céramique - Sèvres & Limoges - Musée National Adrien Dubouché,2018,NOUVELLE-AQUITAINE,LIMOGES,14169,17069,31238,
Musée Despiau-Wlérick,2018,NOUVELLE-AQUITAINE,MONT-DE-MARSAN,0,10607,10607,
Musée du Liège et du Bouchon,2018,NOUVELLE-AQUITAINE,MEZIN,3521,1052,4573,
Musée Municipal (Moulin de Gajac),2018,NOUVELLE-AQUITAINE,VILLENEUVE-SUR-LOT,5224,1700,6924,
Musée Gallo-Romain de Claracq,2018,NOUVELLE-AQUITAINE,CLARACQ,1110,2294,3404,
"Musée de la Moto, de l'Automobile et du Vélo",2018,NOUVELLE-AQUITAINE,CHATELLERAULT,5186,6380,11566,
Musée des Traditions Populaires et d'Archéologie,2018,NOUVELLE-AQUITAINE,CHAUVIGNY,5962,1942,7904,
Musée Municipal de Civray,2018,NOUVELLE-AQUITAINE,CIVRAY,0,88,88,
Musée du baptistère Saint-Jean,2018,NOUVELLE-AQUITAINE,POITIERS,10539,1918,12457,
Musée Départemental de l'Ariège,2018,OCCITANIE,FOIX,82654,8301,90955,
Musée de la Forge,2018,OCCITANIE,MONTGAILHARD,32870,0,32870,
Eburomagus Musée Archéologique,2018,OCCITANIE,BRAM,630,1083,1713,
Musée Municipal de Millau,2018,OCCITANIE,MILLAU,10480,8836,19316,
Musée des Cultures Taurines (Annexe musée du Vieux Nîmes),2018,OCCITANIE,NIMES,3433,7826,11259,
Musée d'Histoire Naturelle et de Préhistoire,2018,OCCITANIE,NIMES,0,28360,28360,
Musée-Forum de l'Aurignacien,2018,OCCITANIE,AURIGNAC,8846,4050,12896,
Musée de la Cloche et de la Sonnaille,2018,OCCITANIE,HEREPIAN,2271,1106,3377,
Musée de l'Hôtel d'Espeyran (Annexe musée Fabre),2018,OCCITANIE,MONTPELLIER,15798,440,16238,
Musée de Vulliod Saint-Germain,2018,OCCITANIE,PEZENAS,3953,1256,5209,
Musée Départemental de Cuzals,2018,OCCITANIE,SAULIAC-SUR-CELE,6185,2778,8963,
Musée Municipal,2018,OCCITANIE,VAYRAC,102,0,102,
Musée départemental d'Art Moderne,2018,OCCITANIE,CERET,55206,5814,61020,
Musée Hyacinthe Rigaud,2018,OCCITANIE,PERPIGNAN,35224,26063,61287,
Musée de Cerdagne,2018,OCCITANIE,SAINTE-LEOCADIE,2896,947,3843,
Musée du Vieil Auvillar,2018,OCCITANIE,AUVILLAR,3545,846,4391,
Musée d'Art de Nantes,2018,PAYS DE LA LOIRE,NANTES,122653,203643,326296,
Musée Jean Lurcat et de la Tapisserie Contemporaine,2018,PAYS DE LA LOIRE,ANGERS,13756,41206,54962,
Musée d'Art et d'Histoire,2018,PAYS DE LA LOIRE,BAUGE,0,7000,7000,
Musée du Textile,2018,PAYS DE LA LOIRE,CHOLET,5406,8373,13779,
Musée de l'Ardoise,2018,PAYS DE LA LOIRE,TRELAZE,8710,0,8710,
Musée Archéologique Départemental de Jublains,2018,PAYS DE LA LOIRE,JUBLAINS,11267,10177,21444,
Musée du Vieux Château,2018,PAYS DE LA LOIRE,LAVAL,7843,33416,41259,
Musée de l'Ardoise et de la Géologie,2018,PAYS DE LA LOIRE,RENAZE,2012,0,2012,
Musée de Fontenay-le-Comte,2018,PAYS DE LA LOIRE,FONTENAY-LE-COMTE,1081,2733,3814,
Ecomusée du Marais Breton Vendéen,2018,PAYS DE LA LOIRE,LA BARRE-DE-MONTS,5418,20378,25796,
Historial de la Vendée,2018,PAYS DE LA LOIRE,LES LUCS-SUR-BOULOGNE,22612,36378,58990,
Musée de l'Abbaye de Sainte-Croix,2018,PAYS DE LA LOIRE,LES SABLES D'OLONNE,6314,18172,24486,
Musée du Château,2018,PAYS DE LA LOIRE,NOIRMOUTIER-EN-L'ILE,37826,6055,43881,
Musée de la Faïence,2018,PROVENCE-ALPES-CÔTE D'AZUR,MOUSTIERS-SAINTE-MARIE,7006,1862,8868,
Musée de la Castre,2018,PROVENCE-ALPES-CÔTE D'AZUR,CANNES,23514,15000,38514,
Villa-Musée Jean-Honoré Fragonard,2018,PROVENCE-ALPES-CÔTE D'AZUR,GRASSE,0,2332,2332,
Musée Archéologique - Site de  Cimiez,2018,PROVENCE-ALPES-CÔTE D'AZUR,NICE,22055,16351,38406,
Musée Départemental des Merveilles,2018,PROVENCE-ALPES-CÔTE D'AZUR,TENDE,0,23012,23012,
Musée de la Légion Etrangère,2018,PROVENCE-ALPES-CÔTE D'AZUR,AUBAGNE/PUYLOUBIER,0,26003,26003,
Musée d'Archéologie Méditerranéenne,2018,PROVENCE-ALPES-CÔTE D'AZUR,MARSEILLE,78748,170699,249447,
Musée Cantini,2018,PROVENCE-ALPES-CÔTE D'AZUR,MARSEILLE,29431,32996,62427,
Muséum d'Histoire Naturelle,2018,PROVENCE-ALPES-CÔTE D'AZUR,MARSEILLE,14689,60017,74706,
Musée Départemental des Hautes-Alpes,2018,PROVENCE-ALPES-CÔTE D'AZUR,GAP,0,19440,19440,
Musée des Arts et d’Histoire,2018,PROVENCE-ALPES-CÔTE D'AZUR,BORMES-LES-MIMOSAS,3019,6119,9138,
Musée du Pays Brignolais,2018,PROVENCE-ALPES-CÔTE D'AZUR,BRIGNOLES,1911,1197,3108,
Musée Archéologique Gallo-Romaine du Var,2018,PROVENCE-ALPES-CÔTE D'AZUR,FREJUS,6318,2626,8944,
Musée Archéologique,2018,PROVENCE-ALPES-CÔTE D'AZUR,SAINT-RAPHAËL,0,21000,21000,
Muséum d'Histoire Naturelle de Toulon et du Var,2018,PROVENCE-ALPES-CÔTE D'AZUR,TOULON,0,39299,39299,
Musée d'Art de Toulon - M.A.T.,2018,PROVENCE-ALPES-CÔTE D'AZUR,TOULON,0,16901,16901,
Musée Municipal,2018,PROVENCE-ALPES-CÔTE D'AZUR,SAULT,0,425,425,
Musée de la Résistance et de la Déportation de l'Ain,2019,AUVERGNE-RHONE-ALPES,NANTUA,8921,4301,13222,M0968
Musée du Vieux Pérouges,2019,AUVERGNE-RHONE-ALPES,PEROUGES,9400,63,9463,M0970
Musée Louis Jourdan,2019,AUVERGNE-RHONE-ALPES,SAINT-PAUL-DE-VARAX,174,54,228,M0973
Musée Municipal de Gannat,2019,AUVERGNE-RHONE-ALPES,GANNAT,512,810,1322,M0103
Musée Gallo-Romain,2019,AUVERGNE-RHONE-ALPES,NERIS-LES-BAINS,359,642,1001,M0107
Musée Municipal de Souvigny - Musée Saint-Marc,2019,AUVERGNE-RHONE-ALPES,SOUVIGNY,8527,2767,11294,M0108
Musée et Site Archéologiques,2019,AUVERGNE-RHONE-ALPES,SOYONS,13400,1982,15382,M0980
Musée International de la Chaussure,2019,AUVERGNE-RHONE-ALPES,ROMANS-SUR-ISERE,6890,4226,11116,M0986
Musée Léon Marès,2019,AUVERGNE-RHONE-ALPES,LOVAGNY,33392,2000,35392,M1054
Musée des Vallées de Thônes,2019,AUVERGNE-RHONE-ALPES,THONES,744,1046,1790,M1056
Musée du Chablais,2019,AUVERGNE-RHONE-ALPES,THONON-LES-BAINS,4260,2208,6468,M1057
Musée Jadis Allevard,2019,AUVERGNE-RHONE-ALPES,ALLEVARD-LES-BAINS,1672,79,1751,M1123
Musée Géo-Charles,2019,AUVERGNE-RHONE-ALPES,ECHIROLLES,0,0,0,M0992
Musée Archéologique Grenoble Saint-Laurent,2019,AUVERGNE-RHONE-ALPES,GRENOBLE,0,42723,42723,M0997
Musée Stendhal,2019,AUVERGNE-RHONE-ALPES,GRENOBLE,650,1273,1923,M0995
Musée Dauphinois,2019,AUVERGNE-RHONE-ALPES,GRENOBLE,0,71540,71540,M0996
Musée Hector Berlioz,2019,AUVERGNE-RHONE-ALPES,LA CÔTE-SAINT-ANDRE,0,16834,16834,M1001
Musée Départemental de la Révolution Française,2019,AUVERGNE-RHONE-ALPES,VIZILLE,0,68794,68794,M1008
Musée Lucien Mainssieux,2019,AUVERGNE-RHONE-ALPES,VOIRON,0,4662,4662,M1137
Musée de la Mine / Site Couriot,2019,AUVERGNE-RHONE-ALPES,SAINT-ETIENNE,28313,30485,58798,M1025
Muséum d'Histoire Naturelle Henri-Lecoq,2019,AUVERGNE-RHONE-ALPES,CLERMONT-FERRAND,3914,24358,28272,M7032
Musée Départemental de la Céramique Gallo-Romaine,2019,AUVERGNE-RHONE-ALPES,LEZOUX,5390,4388,9778,M0123
Musée des Peintres de l'Ecole de Murols,2019,AUVERGNE-RHONE-ALPES,MUROL,3993,240,4233,M0126
Musée Francisque Mandet,2019,AUVERGNE-RHONE-ALPES,RIOM,9508,1694,11202,M0127
Musée Municipal de la Coutellerie,2019,AUVERGNE-RHONE-ALPES,THIERS,21150,3554,24704,M0129
Musée de l'Imprimerie et de la Communication Graphique,2019,AUVERGNE-RHONE-ALPES,LYON,26199,0,26199,M1127
Musée Paul Dini,2019,AUVERGNE-RHONE-ALPES,VILLEFRANCHE-SUR-SAONE,5368,13378,18746,M1041
Musée Alésia - Centre d'Interprétation,2019,BOURGOGNE-FRANCHE-COMTE,ALISE-SAINTE-REINE,57682,22503,80185,M0131
Musée Noisot,2019,BOURGOGNE-FRANCHE-COMTE,FIXIN,422,62,484,M0141
Musée des Beaux-Arts,2019,BOURGOGNE-FRANCHE-COMTE,MONTBARD,0,130,130,M0142
Musée Beurnier-Rossel,2019,BOURGOGNE-FRANCHE-COMTE,MONTBELIARD,412,2685,3097,M0336
Musée de Pontarlier,2019,BOURGOGNE-FRANCHE-COMTE,PONTARLIER,626,5280,5906,M0340
Musée Baron Martin,2019,BOURGOGNE-FRANCHE-COMTE,GRAY,4533,4054,8587,M0357
Musée de l'Artisanat Jurassien,2019,BOURGOGNE-FRANCHE-COMTE,VOITEUR,0,16407,16407,M0343
Musée de la Loire,2019,BOURGOGNE-FRANCHE-COMTE,COSNE-COURS-SUR-LOIRE,1474,6158,7632,M0151
Musée de la Mine,2019,BOURGOGNE-FRANCHE-COMTE,LA MACHINE,6605,781,7386,M0153
Museum d'Histoire Naturelle Jacques de La Comble,2019,BOURGOGNE-FRANCHE-COMTE,AUTUN,829,3270,4099,M7019
Musée Vivant Denon,2019,BOURGOGNE-FRANCHE-COMTE,CHALON-SUR-SAONE,0,16606,16606,M0165
"L'Atelier d'un Journal"" de Louhans - Musée Municipal",2019,BOURGOGNE-FRANCHE-COMTE,LOUHANS,2346,0,2346,M0171
Musée de la Tour du Moulin,2019,BOURGOGNE-FRANCHE-COMTE,MARCIGNY,1444,733,2177,M0174
Musée Eucharistique du Hiéron,2019,BOURGOGNE-FRANCHE-COMTE,PARAY-LE-MONIAL,10526,0,10526,M0176
Maison du Blé et du Pain,2019,BOURGOGNE-FRANCHE-COMTE,VERDUN-SUR-LE-DOUBS,3169,306,3475,M0183
Musée des Arts Naïfs et Populaires de Noyers sur Serein,2019,BOURGOGNE-FRANCHE-COMTE,NOYERS-SUR-SEREIN,1938,856,2794,M0187
Ecomusée d'Ouessant - Vivre sur une Ile,2019,BRETAGNE,OUESSANT,7046,714,7760,M0203
Musée des Phares et Balises,2019,BRETAGNE,OUESSANT,17313,1830,19143,M0204
Musée de Pont-Aven,2019,BRETAGNE,PONT-AVEN,70376,24357,94733,M0205
Musée Bigouden,2019,BRETAGNE,PONT-L'ABBE,9716,3438,13154,M0206
Ecomusée de la Bintinais,2019,BRETAGNE,RENNES,13084,46132,59216,M0213
Musée du Long-Cours Cap-Hornier,2019,BRETAGNE,SAINT-MALO,8303,9357,17660,M0215
Musée de la Carte Postale,2019,BRETAGNE,BAUD,2588,1827,4415,M1195
Musée de Préhistoire J. Miln- Z. Le-Rouzic,2019,BRETAGNE,CARNAC,30579,6109,36688,M0221
Musée d'Histoire et d'Archéologie de Vannes,2019,BRETAGNE,VANNES,4472,4139,8611,M0227
Musée Emile Chénon,2019,CENTRE-VAL DE LOIRE,CHÂTEAUMEILLANT,927,706,1633,M0233
Musée George Sand et de la Vallée Noire,2019,CENTRE-VAL DE LOIRE,LA CHATRE,1524,1857,3381,M0250
Musée Hôtel Morin,2019,CENTRE-VAL DE LOIRE,AMBOISE,0,12773,12773,M0253
"""Maison Musée"" René Descartes",2019,CENTRE-VAL DE LOIRE,DESCARTES,1034,658,1692,M0257
Musée de Préhistoire du Grand Pressigny,2019,CENTRE-VAL DE LOIRE,LE GRAND-PRESSIGNY,11797,3042,14839,M0259
Muséum d'Histoire Naturelle,2019,CENTRE-VAL DE LOIRE,TOURS,9542,18237,27779,M7062
Muséum d'Histoire Naturelle,2019,CENTRE-VAL DE LOIRE,BLOIS,6425,8644,15069,M7024
Château Musées de Blois,2019,CENTRE-VAL DE LOIRE,BLOIS,308813,44708,353521,M0271
Musée de Vendôme,2019,CENTRE-VAL DE LOIRE,VENDOME,0,13968,13968,M0277
Musée Archéologique de Mariana - Prince Rainier III de Monaco,2019,CORSE,LUCCIANA,0,6670,6670,M1184
Musée Départemental Pascal Paoli,2019,CORSE,MOROSAGLIA,4038,978,5016,M0331
Maison des Ailleurs - Arthur Rimbaud (Annexe musée Arthur Rimbaud),2019,GRAND EST,CHARLEVILLE-MEZIERES,4200,4966,9166,M0291
Musée Camille Claudel,2019,GRAND EST,NOGENT-SUR-SEINE,16331,8876,25207,M0301
Musée Vauluisant - Musée de la Bonneterie,2019,GRAND EST,TROYES,3270,7786,11056,M0304
Musée Alsacien,2019,GRAND EST,HAGUENAU,975,464,1439,M0004
Musée de l'Œuvre Notre-Dame,2019,GRAND EST,STRASBOURG,22279,29595,51874,M0017
Musée Tomi Ungerer,2019,GRAND EST,STRASBOURG,29522,30001,59523,M1098
Musée des Beaux-Arts,2019,GRAND EST,STRASBOURG,33932,38764,72696,M0019
Musée Lalique,2019,GRAND EST,WINGEN-SUR-MODER,38546,13089,51635,M1162
Musée Westercamp,2019,GRAND EST,WISSEMBOURG,493,648,1141,M0022
Musée de la Coutellerie,2019,GRAND EST,NOGENT,3790,1527,5317,M0322
Musée Electropolis,2019,GRAND EST,MULHOUSE,34134,9226,43360,M0039
Musée du Dolder,2019,GRAND EST,RIQUEWIHR,5650,1474,7124,M0043
Musée du Château de Montaigu,2019,GRAND EST,LANEUVEVILLE-DEVANT-NANCY,220,772,992,M0508
Muséum- Aquarium de Nancy,2019,GRAND EST,NANCY,18448,28559,47007,M7048
Musée d'Art Sacré de la Meuse,2019,GRAND EST,SAINT-MIHIEL,1393,314,1707,M0520
Musée Charles Friry,2019,GRAND EST,REMIREMONT,151,182,333,M0541
Musée Précolombien Edgar Clerc,2019,GUADELOUPE,LE MOULE,0,10246,10246,M1060
Musée Franco-Américain du Château de Blérancourt,2019,HAUTS-DE-France,BLERANCOURT,4427,4880,9307,M5008
Musée des Beaux-Arts Antoine Lecuyer,2019,HAUTS-DE-France,SAINT-QUENTIN,3730,7877,11607,M0793
Musée Benoît de Puydt,2019,HAUTS-DE-France,BAILLEUL,0,8073,8073,M0611
Forum Antique de Bavay,2019,HAUTS-DE-France,BAVAY,24368,15700,40068,M0612
Lieu d'Art et Action Contemporaine de Dunkerque - LAAC,2019,HAUTS-DE-France,DUNKERQUE,4054,40899,44953,M0620
Musée d'Histoire Locale de Marchiennes,2019,HAUTS-DE-France,MARCHIENNES,58,211,269,M0632
MusVerre,2019,HAUTS-DE-France,SARS-POTERIES,11978,15467,27445,M0636
"LAM - Lille Métropole Musée d'Art Moderne, d'Art Contemporain et d'Art Brut",2019,HAUTS-DE-France,VILLENEUVE-D'ASCQ,163404,30396,193800,M0639
Musée Pillon,2019,HAUTS-DE-France,CHAUMONT-EN-VEXIN,0,954,954,M0801
Musée Antoine Vivenel,2019,HAUTS-DE-France,COMPIEGNE,1356,13624,14980,M0803
Musée de l'Archerie et de l'Art Sacré,2019,HAUTS-DE-France,CREPY-EN-VALOIS,3634,2512,6146,M0806
Musée de la Nacre et de la Tabletterie,2019,HAUTS-DE-France,MERU,13650,3898,17548,M1117
Musée Jean Calvin,2019,HAUTS-DE-France,NOYON,1840,867,2707,M0808
Musée Archéologique de l'Oise,2019,HAUTS-DE-France,VENDEUIL-CAPLY,8705,1320,10025,M0800
Musée Quentovic,2019,HAUTS-DE-France,ETAPLES-SUR-MER,0,40,40,M0646
Musée Lombart,2019,HAUTS-DE-France,DOULLENS,301,4122,4423,M0814
Musée Français de la Photographie,2019,ILE-DE-France,BIEVRES,1551,3445,4996,M0401
Musée - Atelier Rodin (Annexe du musée de Paris),2019,ILE-DE-France,MEUDON,0,20011,20011,M5044
Musée National des Châteaux de Malmaison et de Bois-Préau,2019,ILE-DE-France,RUEIL-MALMAISON,49649,32224,81873,M5016
Musée du Domaine Départemental de Sceaux,2019,ILE-DE-France,SCEAUX,16677,7704,24381,M0417
Galerie de Botanique (Muséum National National d'Histoire Naturelle),2019,ILE-DE-France,PARIS,8114,2396,10510,M7009
Musée d'Ennery,2019,ILE-DE-France,PARIS,0,710,710,M5040
"Musée Cognacq-Jay, Musée du XVIIIe siècle de la ville de Paris",2019,ILE-DE-France,PARIS,18000,48307,66307,M1107
Musée National Picasso,2019,ILE-DE-France,PARIS,411575,217737,629312,M5043
Établissement Public de la Porte Dorée - (MNHI - Aquarium - Palais),2019,ILE-DE-France,PARIS,224318,301276,525594,M5084
Musée des Plans-Reliefs,2019,ILE-DE-France,PARIS,172901,2800,175701,M5071
Musée de l'Assistance Publique - Hôpitaux de Paris,2019,ILE-DE-France,PARIS,612,288,900,M1076
Musée d'Art et d'Histoire de l'Hôpital Sainte-Anne,2019,ILE-DE-France,PARIS,0,9660,9660,M1202
Etablissement public du musée d'Orsay et de l'Orangerie - Musée de l'Orangerie,2019,ILE-DE-France,PARIS,654134,375791,1029925,M5030
Musée des Monuments Français - CAPA,2019,ILE-DE-France,PARIS,99019,124902,223921,M5042
Musée National Gustave Moreau,2019,ILE-DE-France,PARIS,20375,22762,43137,M5041
Musée de la Chasse et de la Nature,2019,ILE-DE-France,PARIS,21331,32373,53704,M0363
Musée d'Art et d'Histoire du Judaïsme,2019,ILE-DE-France,PARIS,74587,50273,124860,M0364
Musée National d'Art Moderne (Centre National d'Art et de Culture Georges Pompidou),2019,ILE-DE-France,PARIS,2411346,984916,3396262,M5050
Musée Municipal des Capucins,2019,ILE-DE-France,COULOMMIERS,2726,1308,4034,M0372
Musée de la Gendarmerie Nationale,2019,ILE-DE-France,MELUN,13741,10751,24492,M9013
Musée d'Art et d'Histoire de Melun,2019,ILE-DE-France,MELUN,8060,0,8060,M0379
Musée Départemental de Préhistoire d'Île de France,2019,ILE-DE-France,NEMOURS,5472,25838,31310,M0382
Musée des Pays de Seine-et-Marne,2019,ILE-DE-France,SAINT-CYR-SUR-MORIN,5000,15000,20000,M0384
Musée du Vieil Argenteuil,2019,ILE-DE-France,ARGENTEUIL,0,3331,3331,M0432
ARCHEA - Archéologie en Pays de France,2019,ILE-DE-France,LOUVRES,7363,5790,13153,M0436
Musée de la Toile de Jouy,2019,ILE-DE-France,JOUY-EN-JOSAS,7962,3120,11082,M0388
Musée de la Ville,2019,ILE-DE-France,MONTIGNY-LE-BRETONNEUX,3182,7841,11023,M0398
Musée Rambolitrain,2019,ILE-DE-France,RAMBOUILLET,16340,2276,18616,M0395
Musée Municipal - Collections Paul et André Véra,2019,ILE-DE-France,SAINT-GERMAIN-EN-LAYE,2062,1182,3244,M0397
Musée d'Archéologie Nationale (des origines à l'an mille) - Château de st-Germain-en-Laye,2019,ILE-DE-France,SAINT-GERMAIN-EN-LAYE,30280,79881,110161,M5001
Muséum Agricole et Industriel Stella Matutina,2019,LA REUNION,PITON-SAINT-LEU,84974,12235,97209,M1068
Musée Départemental de la Réunion - Musée Léon Dierx,2019,LA REUNION,SAINT-DENIS,5204,14880,20084,M1069
Muséum d'Histoire Naturelle,2019,LA REUNION,SAINT-DENIS,0,38520,38520,M7014
Musée Historique de Villèle,2019,LA REUNION,SAINT-GILLES-LES-HAUTS - SAINT PAUL,20553,21290,41843,M1070
Musée Régional d'Histoire et d'Ethnologie,2019,MARTINIQUE,FORT-DE-FRANCE - MARTINIQUE-,2584,1596,4180,M1066
Musée de La Canne,2019,MARTINIQUE,LES TROIS ILETS,7459,1826,9285,M1067
Musée d'Initiation à la Nature,2019,NORMANDIE,CAEN,0,5650,5650,M7072
Musée Eugène Boudin,2019,NORMANDIE,HONFLEUR,32270,5725,37995,M0661
Musée de la Bataille de Tilly-Sur-Seulles 1944,2019,NORMANDIE,TILLY-SUR-SEULLES,1430,1578,3008,M0670
Musée et Sites archéologiques de Vieux-la-Romaine,2019,NORMANDIE,VIEUX,7716,13717,21433,M1077
Musée du Verre et de la Pierre,2019,NORMANDIE,CONCHES-EN-OUCHE,2471,2323,4794,M0702
Musée du Granit,2019,NORMANDIE,SAINT-MICHEL-DE-MONTJOIE,0,2573,2573,M0687
Musée Maritime de l'Ile de Tatihou,2019,NORMANDIE,SAINT-VAAST-LA-HOUGUE,64004,6713,70717,M0689
Musée de la Poêlerie,2019,NORMANDIE,VILLEDIEU-LES-POÊLES-ROUFFIGNY,2378,3026,5404,M0693
Musée du Château de Flers,2019,NORMANDIE,FLERS,1645,5566,7211,M0695
Musée d'Elbeuf,2019,NORMANDIE,ELBEUF,2042,20294,22336,M1099
Abbaye de Graville - Musée du Prieuré de Graville,2019,NORMANDIE,LE HAVRE,6463,2730,9193,M0719
"Juliobona, Musée Gallo-Romain de Lillebonne",2019,NORMANDIE,LILLEBONNE,5208,1879,7087,M0724
Musée Départemental Pierre Corneille,2019,NORMANDIE,PETIT-COURONNE,0,3623,3623,M0722
Musée Victor Hugo,2019,NORMANDIE,RIVES-EN-SEINE,6439,7800,14239,M0736
Musée Flaubert et d'Histoire de la Médecine,2019,NORMANDIE,ROUEN,2887,4921,7808,M0734
Association de l'Horlogerie Aliermontaise,2019,NORMANDIE,SAINT-NICOLAS-D'ALIERMONT,4183,1354,5537,M0735
Musée Municipal des Ivoires,2019,NORMANDIE,YVETOT,853,324,1177,M0737
Musée du Nouveau Monde,2019,NOUVELLE-AQUITAINE,LA ROCHELLE,8643,15272,23915,M0827
Musée National de la Marine,2019,NOUVELLE-AQUITAINE,ROCHEFORT,9892,36252,46144,M5026
Musée de l'Echevinage,2019,NOUVELLE-AQUITAINE,SAINTES,8645,4804,13449,M0837
Musée du Cloître de Tulle André Mazeyrie,2019,NOUVELLE-AQUITAINE,TULLE,0,6768,6768,M0500
Musée des Tumulus de Bougon,2019,NOUVELLE-AQUITAINE,BOUGON,19905,5306,25211,M0839
Musée de Bressuire,2019,NOUVELLE-AQUITAINE,BRESSUIRE,0,3622,3622,M0840
Musée du Tabac,2019,NOUVELLE-AQUITAINE,BERGERAC,3834,2589,6423,M0049
Musée des Arts et Traditions Populaires du Périgord,2019,NOUVELLE-AQUITAINE,MUSSIDAN,1029,1337,2366,M0054
CAPC Musée d'Art Contemporain de Bordeaux,2019,NOUVELLE-AQUITAINE,BORDEAUX,44561,74250,118811,M0067
Musée des Beaux-Arts,2019,NOUVELLE-AQUITAINE,BORDEAUX,45549,64395,109944,M0065
Musée Municipal des Beaux-Arts de Limoges - Palais de l'Evêché,2019,NOUVELLE-AQUITAINE,LIMOGES,8960,22165,31125,M0505
Musée de la Chalosse,2019,NOUVELLE-AQUITAINE,MONTFORT-EN-CHALOSSE,5273,2388,7661,M0082
Musée Bernadotte,2019,NOUVELLE-AQUITAINE,PAU,2193,2892,5085,M0099
"Le Grand Atelier : Musée d'Art et d'Industrie ex Musée de la Moto, de l'Automobile et du Vélo",2019,NOUVELLE-AQUITAINE,CHATELLERAULT,635,5519,6154,M0847
Musée de Préhistoire Raymond Touchard,2019,NOUVELLE-AQUITAINE,LUSSAC-LES-CHATEAUX,3096,3858,6954,M1097
Eburomagus Musée Archéologique,2019,OCCITANIE,BRAM,1443,2470,3913,M1176
Musée des Beaux-Arts,2019,OCCITANIE,CARCASSONNE,0,28209,28209,M0440
Musée Petiet,2019,OCCITANIE,LIMOUX Cedex,746,2768,3514,M0443
Musée des Arts et Métiers Traditionnels,2019,OCCITANIE,SALLES-LA-SOURCE,4286,2673,6959,M0553
Carré d'Art Musée d'Art Contemporain de Nîmes,2019,OCCITANIE,NÎMES,18048,15174,33222,M0459
Musée de la Maison Romane,2019,OCCITANIE,SAINT-GILLES-DU-GARD,0,139,139,M0462
Musée Pierre de Luxembourg,2019,OCCITANIE,VILLENEUVE-LES-AVIGNON,4223,2652,6875,M0464
Musée Joseph Abeilhé,2019,OCCITANIE,MARCIAC,177,48,225,M7043
Musée-Forum de l'Aurignacien,2019,OCCITANIE,AURIGNAC,8133,4217,12350,M0556
Musée du Pays de Luchon,2019,OCCITANIE,BAGNERES-DE-LUCHON,480,239,719,M0557
Muséum d'Histoire Naturelle,2019,OCCITANIE,TOULOUSE,194280,127121,321401,M7013
Musée Saint-Raymond,2019,OCCITANIE,TOULOUSE,18496,44867,63363,M0563
Musée de la Cloche et de la Sonnaille,2019,OCCITANIE,HEREPIAN,2360,1624,3984,M0471
Musée Archéologique,2019,OCCITANIE,MINERVE,2500,50,2550,M0475
Musée Fabre,2019,OCCITANIE,MONTPELLIER,116651,96242,212893,M0476
Musée Murat,2019,OCCITANIE,CŒUR DE CAUSSE,627,37,664,M0579
Muséum d'Histoire Naturelle,2019,OCCITANIE,PERPIGNAN,0,16196,16196,M7055
Musée du Castillet Casa Pairal,2019,OCCITANIE,PERPIGNAN Cedex,12479,18718,31197,M0494
Musée de Cerdagne,2019,OCCITANIE,SAINTE-LEOCADIE,2806,655,3461,M0497
Musée des Beaux-Arts,2019,OCCITANIE,GAILLAC,1152,736,1888,M0599
Musée Départemental du Textile,2019,OCCITANIE,LA-BASTIDE-ROUAIROUX,2205,3804,6009,M0600
Musée Théodore Calbet,2019,OCCITANIE,GRISOLLES,0,2928,2928,M0605
"Musée de la Fève, Crèches et Traditions Populaires",2019,PAYS DE LA LOIRE,BLAIN,0,2419,2419,M0738
Musée du Vignoble Nantais,2019,PAYS DE LA LOIRE,LE PALLET,3479,2594,6073,M0742
Musées du Parc Naturel Régional de Brière,2019,PAYS DE LA LOIRE,SAINT-JOACHIM,270,0,270,M0746
Musée Jean Lurcat et de la Tapisserie Contemporaine,2019,PAYS DE LA LOIRE,ANGERS,15812,26245,42057,M0751
Musée Jules-Desbois,2019,PAYS DE LA LOIRE,PARCAY-LES-PINS,2498,1177,3675,M1092
Château-Musée de Saumur,2019,PAYS DE LA LOIRE,SAUMUR,87850,18556,106406,M0759
Musée d'Art et d'Archéologie Hôtel Fouquet,2019,PAYS DE LA LOIRE,CHATEAU-GONTIER,243,1085,1328,M0762
Musée Communal Robert Tatin,2019,PAYS DE LA LOIRE,COSSE-LE-VIVIEN,27639,10504,38143,M0762
Musée du Château de Mayenne,2019,PAYS DE LA LOIRE,MAYENNE,10316,10496,20812,M0767
Bibliothèque-musée,2019,PAYS DE LA LOIRE,SAINT-CALAIS,346,974,1320,M1131
Musée de Fontenay-le-Comte,2019,PAYS DE LA LOIRE,FONTENAY-LE-COMTE,2453,2768,5221,M0773
Ecomusée du Marais Breton Vendéen,2019,PAYS DE LA LOIRE,LA BARRE-DE-MONTS,6864,21616,28480,M0774
Historial de la Vendée,2019,PAYS DE LA LOIRE,LES LUCS-SUR-BOULOGNE,20407,39067,59474,M1121
Musée archéologique,2019,PROVENCE-ALPES-CÔTE D'AZUR,VACHERES,231,83,314,M0864
Musée Picasso,2019,PROVENCE-ALPES-CÔTE D'AZUR,ANTIBES,82834,48649,131483,M0867
Musée d'Histoire et d'Archéologie,2019,PROVENCE-ALPES-CÔTE D'AZUR,ANTIBES,5872,4929,10801,M0868
Musée Fernand Léger,2019,PROVENCE-ALPES-CÔTE D'AZUR,BIOT,13391,17039,30430,M5028
Musée des Beaux-Arts Jules Chéret,2019,PROVENCE-ALPES-CÔTE D'AZUR,NICE,13874,13280,27154,M0880
Musée Archéologique - Site de Terra Amata,2019,PROVENCE-ALPES-CÔTE D'AZUR,NICE,2369,17316,19685,M0885
Musée National du Sport,2019,PROVENCE-ALPES-CÔTE D'AZUR,NICE,28310,41045,69355,M5027
Musée du Pavillon de Vendôme,2019,PROVENCE-ALPES-CÔTE D'AZUR,AIX-EN-PROVENCE,12736,16077,28813,M0896
Musée des Civilisations de l'Europe et de la Méditerranée - MuCem,2019,PROVENCE-ALPES-CÔTE D'AZUR,MARSEILLE,241812,228674,470486,M5002
Musée Ziem,2019,PROVENCE-ALPES-CÔTE D'AZUR,MARTIGUES,0,13063,13063,M0923
Musée Estrine - Présence Van Gogh,2019,PROVENCE-ALPES-CÔTE D'AZUR,SAINT-REMY-DE-PROVENCE,7124,3899,11023,M1168
Musée des Troupes de Marine,2019,PROVENCE-ALPES-CÔTE D'AZUR,FREJUS,0,20290,20290,M9008
Musée Jean Aicard,2019,PROVENCE-ALPES-CÔTE D'AZUR,LE POUVEREL LA GARDE,0,3260,3260,M0938
Muséum d'Histoire Naturelle de Toulon et du Var,2019,PROVENCE-ALPES-CÔTE D'AZUR,TOULON,0,49405,49405,M7061
Musée National de la Marine de Toulon,2019,PROVENCE-ALPES-CÔTE D'AZUR,TOULON,32153,33837,65990,M5026
Musée d'Apt,2019,PROVENCE-ALPES-CÔTE D'AZUR,APT,2454,3981,6435,M0945
Synagogue Musée Juif Comtadin,2019,PROVENCE-ALPES-CÔTE D'AZUR,CAVAILLON,3523,1614,5137,M0954
Musée Archéologique Théo Desplans,2019,PROVENCE-ALPES-CÔTE D'AZUR,VAISON-LA-ROMAINE,55967,8248,64215,M0961
Musée Louis Jourdan,2020,AUVERGNE-RHONE-ALPES,SAINT-PAUL-DE-VARAX,195,73,268,M0973
Musée Départemental du Revermont,2020,AUVERGNE-RHONE-ALPES,VAL-REVERMONT,1030,867,1897,M0975
Musée des Musiques Populaires - MuPop,2020,AUVERGNE-RHONE-ALPES,MONTLUCON,11490,1796,13286,M0104
Centre National du Costume de Scène et de la Scénographie,2020,AUVERGNE-RHONE-ALPES,MOULINS,38170,13978,52148,M5083
MuséAL - Musée Archéologique d'Alba,2020,AUVERGNE-RHONE-ALPES,ALBA-LA-ROMAINE,7246,624,7870,M1174
Musée des Sciences,2020,AUVERGNE-RHONE-ALPES,AURILLAC,911,5082,5993,M7018
Ecomusée de Margeride-Haute-Auvergne,2020,AUVERGNE-RHONE-ALPES,RUYNES-EN-MARGERIDE,1790,1066,2856,M0112
Musée Crozatier,2020,AUVERGNE-RHONE-ALPES,LE PUY-EN-VELAY,14680,8428,23108,M0116
Musée Léon Marès,2020,AUVERGNE-RHONE-ALPES,LOVAGNY,16235,4724,20959,M1054
"Notre histoire, Musée de Rumilly",2020,AUVERGNE-RHONE-ALPES,RUMILLY,452,496,948,M1055
Musée du Chablais,2020,AUVERGNE-RHONE-ALPES,THONON-LES-BAINS,27,3372,3399,M1057
Musée Gallo-Romain,2020,AUVERGNE-RHONE-ALPES,AOSTE,1062,0,1062,M0990
Musée de la Résistance de la Déportation de l'Isère,2020,AUVERGNE-RHONE-ALPES,GRENOBLE,0,15883,15883,M0998
Musée de Grenoble,2020,AUVERGNE-RHONE-ALPES,GRENOBLE,0,65170,65170,M0994
Musée du Pays Matheysin,2020,AUVERGNE-RHONE-ALPES,LA MURE,1520,0,1520,M1002
Conservatoire - Musée des Industries Hydroélectriques,2020,AUVERGNE-RHONE-ALPES,VAUJANY,0,4250,4250,M0993
Musée Lucien Mainssieux,2020,AUVERGNE-RHONE-ALPES,VOIRON,0,2856,2856,M1137
Atelier - Musée du Chapeau,2020,AUVERGNE-RHONE-ALPES,CHAZELLES-SUR-LYON,4854,1193,6047,M1012
Musée de Feurs,2020,AUVERGNE-RHONE-ALPES,FEURS,1394,3114,4508,M1014
Musée des Beaux-Arts et d'Archéologie J. Dechelette,2020,AUVERGNE-RHONE-ALPES,ROANNE,2580,4084,6664,M1020
Musée d'Art Moderne et Contemporain de Saint-Etienne Métropole,2020,AUVERGNE-RHONE-ALPES,SAINT-PRIEST-EN-JAREZ,12273,16087,28360,M1024
Musée Régional d'Auvergne,2020,AUVERGNE-RHONE-ALPES,RIOM,0,2389,2389,M0128
Musée Barthélemy-Thimonnier,2020,AUVERGNE-RHONE-ALPES,AMPLEPUIS,539,313,852,M1140
Musée de l'Imprimerie et de la Communication Graphique,2020,AUVERGNE-RHONE-ALPES,LYON,3932,13684,17616,M1127
Musée des Beaux-Arts,2020,AUVERGNE-RHONE-ALPES,LYON,86482,69846,156328,M1031
Musée des Confluences,2020,AUVERGNE-RHONE-ALPES,LYON,142469,134061,276530,M7042
Ecomusée du Haut Beaujolais,2020,AUVERGNE-RHONE-ALPES,THIZY-LES-BOURGS,0,260,260,M1185
Musée des Beaux-Arts,2020,AUVERGNE-RHONE-ALPES,CHAMBERY,0,7384,7384,M1048
Musée de l'Académie de La Val d'Isère,2020,AUVERGNE-RHONE-ALPES,MOÛTIERS,27,58,85,M1051
"Musée de la Vie Bourguignonne, Perrin de Puycousin",2020,BOURGOGNE-FRANCHE-COMTE,DIJON,0,16400,16400,M0139
Musée du Château des Ducs de Wurtemberg,2020,BOURGOGNE-FRANCHE-COMTE,MONTBELIARD Cedex,1340,7425,8765,M0337
Ecomusée du Pays de la Cerise,2020,BOURGOGNE-FRANCHE-COMTE,FOUGEROLLES-SAINT-VALBERT,3445,1656,5101,M0356
Musée Municipal d'Archéologie,2020,BOURGOGNE-FRANCHE-COMTE,CHAMPAGNOLE,74,240,314,M0344
Musée de l'Abbaye/Donations Guy Bardone - René Genis,2020,BOURGOGNE-FRANCHE-COMTE,SAINT-CLAUDE,3615,1406,5021,M1169
Musée de la Loire,2020,BOURGOGNE-FRANCHE-COMTE,COSNE-COURS-SUR-LOIRE,1738,0,1738,M0151
Musée du Grès de Puisaye,2020,BOURGOGNE-FRANCHE-COMTE,SAINT-AMAND-EN-PUISAYE,1916,0,1916,M0158
Musée Lapidaire Saint-Nicolas,2020,BOURGOGNE-FRANCHE-COMTE,AUTUN,0,600,600,M0160
Musée du Prieuré de Charolles,2020,BOURGOGNE-FRANCHE-COMTE,CHAROLLES,0,1070,1070,M0168
Musée des Ursulines,2020,BOURGOGNE-FRANCHE-COMTE,MACON,2333,3820,6153,M0172
Musée Eucharistique du Hiéron,2020,BOURGOGNE-FRANCHE-COMTE,PARAY-LE-MONIAL,7410,0,7410,M0176
Musée Départemental du Compagnonnage,2020,BOURGOGNE-FRANCHE-COMTE,ROMANECHE-THORINS,3070,0,3070,M0178
Musée de Bibracte,2020,BOURGOGNE-FRANCHE-COMTE,SAINT-LEGER-SOUS-BEUVRAY,24204,5903,30107,M1199
Musée Colette,2020,BOURGOGNE-FRANCHE-COMTE,SAINT-SAUVEUR-EN-PUISAYE,3615,415,4030,M0188
Musée Muncipal,2020,BOURGOGNE-FRANCHE-COMTE,SENS,1758,22597,24355,M0189
Ecomusée des Monts d'Arrée - Moulins de Kerouat,2020,BRETAGNE,COMMANA,6289,5581,11870,M0198-1
Musée Bigouden,2020,BRETAGNE,PONT-L'ABBE,3961,1093,5054,M0206
Musée des Beaux-Arts,2020,BRETAGNE,QUIMPER,27501,12212,39713,M0207
Musée de l'Ecole Rurale en Bretagne,2020,BRETAGNE,TREGARVAN,3961,1127,5088,M0209
Musée de la Carte Postale,2020,BRETAGNE,BAUD,681,969,1650,M1195
Ecomusée Industriel des Forges,2020,BRETAGNE,INZINZAC-LOCHRIST,1121,496,1617,M0223
Musée Estève,2020,CENTRE-VAL DE LOIRE,BOURGES,511,3870,4381,M0231
Musée du Berry,2020,CENTRE-VAL DE LOIRE,BOURGES,1340,3971,5311,M0230
Musée des Meilleurs Ouvriers de France,2020,CENTRE-VAL DE LOIRE,BOURGES,1178,3736,4914,M0232
Musée Emile Chénon,2020,CENTRE-VAL DE LOIRE,CHÂTEAUMEILLANT,348,168,516,M0233
Musée Saint-Vic,2020,CENTRE-VAL DE LOIRE,SAINT-AMAND-MONTROND,0,1655,1655,M0235
Musée Farcot,2020,CENTRE-VAL DE LOIRE,SAINVILLE,0,100,100,M0244
Musée Archéologique d'Argentomagus,2020,CENTRE-VAL DE LOIRE,SAINT-MARCEL,5396,2324,7720,M0252
Musée Hôtel Morin,2020,CENTRE-VAL DE LOIRE,AMBOISE,0,9086,9086,M0253
Musée de Préhistoire du Grand Pressigny,2020,CENTRE-VAL DE LOIRE,LE GRAND-PRESSIGNY,7565,2150,9715,M0259
Musée du Compagnonnage,2020,CENTRE-VAL DE LOIRE,TOURS,16797,0,16797,M0266
Musée de la Corbillière,2020,CENTRE-VAL DE LOIRE,MER,0,450,450,M0273
Musée Archéologique,2020,CENTRE-VAL DE LOIRE,THESEE,92,0,92,M0276
Musée Gaston Couté,2020,CENTRE-VAL DE LOIRE,MEUNG-SUR-LOIRE,0,813,813,M0283
Musée National de la Maison Bonaparte,2020,CORSE,AJACCIO,10059,7362,17421,M5046
Musée Arthur Rimbaud,2020,GRAND EST,CHARLEVILLE-MEZIERES,3705,3946,7651,M0291
Musée du Feutre,2020,GRAND EST,MOUZON,1542,519,2061,M0294
Musée de la Folie Marco,2020,GRAND EST,BARR,783,205,988,M0001
Musée de la Poterie,2020,GRAND EST,BETSCHDORF,1238,360,1598,M0002
Musée du Pays de Hanau - Histoire et Vies d’un Territoire,2020,GRAND EST,BOUXWILLER,1657,1084,2741,M0003
Musée de l'Image Populaire de Pfaffenhoffen,2020,GRAND EST,PFAFFENHOFFEN,388,459,847,M0010
Cabinet des Estampes et des Dessins,2020,GRAND EST,STRASBOURG,0,20,20,M0013
Musée Alsacien,2020,GRAND EST,STRASBOURG,11625,12560,24185,M0014
Musée Historique,2020,GRAND EST,STRASBOURG,11061,10452,21513,M0020
Musée Lalique,2020,GRAND EST,WINGEN-SUR-MODER,18305,5285,23590,M1162
Musée Westercamp,2020,GRAND EST,WISSEMBOURG,177,714,891,M0022
Musée Municipal,2020,GRAND EST,BOURBONNE-LES-BAINS,0,725,725,M0317
Musée des Beaux-Arts et d'Archéologie,2020,GRAND EST,CHAUMONT,1328,1143,2471,M0319
Musée d'Art et d'Histoire,2020,GRAND EST,LANGRES,2883,3391,6274,M0321
Musée des Beaux-Arts,2020,GRAND EST,MULHOUSE,0,8988,8988,M0033
Musée Historique,2020,GRAND EST,MULHOUSE,0,9871,9871,M0034
Musée des Amis de Thann,2020,GRAND EST,THANN,252,256,508,M0047
Musée Saint-Rémi,2020,GRAND EST,REIMS,2104,10809,12913,M0312
Musée des Beaux-Arts de Saint-Denis,2020,GRAND EST,REIMS,820,5069,5889,M0311
Musée Municipal des Emaux et Faïences,2020,GRAND EST,LONGWY,674,224,898,M0510
Musée de l'Ecole de Nancy,2020,GRAND EST,NANCY,9064,10804,19868,M0513
Muséum- Aquarium de Nancy,2020,GRAND EST,NANCY,29177,41577,70754,M7048
Musée Jeanne d'Arc,2020,GRAND EST,VAUCOULEURS,179,52,231,M0524
Musée Départemental de la Guerre de 70,2020,GRAND EST,GRAVELOTTE,1163,10924,12087,M0526
Musées de la Cour d'Or,2020,GRAND EST,METZ,0,6181,6181,M0529
Musée de la Mine - Carreau Wendel,2020,GRAND EST,PETITE-ROSSELLE,11450,1203,12653,M1089
Musée Militaire et Erckmann-Chatrian,2020,GRAND EST,PHALSBOURG,232,0,232,M0531
Musée Territorial Alexandre Franconie,2020,GUYANE,CAYENNE,6212,0,6212,M1063
Forum Antique de Bavay,2020,HAUTS-DE-France,BAVAY,8390,4112,12502,M0612
Lieu d'Art et Action Contemporaine de Dunkerque - LAAC,2020,HAUTS-DE-France,DUNKERQUE,2239,11650,13889,M0620
Palais des Beaux-Arts de Lille,2020,HAUTS-DE-France,LILLE,106005,0,106005,M0629
Musée de la Tour Abbatiale,2020,HAUTS-DE-France,SAINT-AMAND-LES-EAUX,0,3388,3388,M0635
MUba - Musée des Beaux-Arts Eugène Leroy de Tourcoing,2020,HAUTS-DE-France,TOURCOING,4198,9263,13461,M0637
"LAM - Lille Métropole Musée d'Art Moderne, d'Art Contemporain et d'Art Brut",2020,HAUTS-DE-France,VILLENEUVE-D'ASCQ,47798,19317,67115,M0639
Musée Pillon,2020,HAUTS-DE-France,CHAUMONT-EN-VEXIN,0,170,170,M0801
Musée National du Château de Compiègne,2020,HAUTS-DE-France,COMPIEGNE,24587,30371,54958,M5009
Musée d'Art et d'Archéologie,2020,HAUTS-DE-France,SENLIS,1851,2807,4658,M0809
Musée Régional d'Ethnologie,2020,HAUTS-DE-France,BETHUNE,0,3453,3453,M0642
"Albert-Kahn, Musée et Jardin Départementaux",2020,ILE-DE-France,BOULOGNE-BILLANCOURT,31304,30976,62280,M0407
Musée Belmondo et de la Sculpture Figurative du XXè siècle,2020,ILE-DE-France,BOULOGNE-BILLANCOURT,1139,1813,2952,M1170
Musée Roybet Fould,2020,ILE-DE-France,COURBEVOIE,362,5358,5720,M0410
Sèvres - Cité de la Céramique,2020,ILE-DE-France,SEVRES,10302,6221,16523,M5019
Muséum National d'Histoire Naturelle,2020,ILE-DE-France,PARIS,60139,86541,146680,M7003
Musée de l'Homme (Muséum National d'Histoire Naturelle),2020,ILE-DE-France,PARIS,57797,34353,92150,M7008
Musée National Jean-Jacques Henner,2020,ILE-DE-France,PARIS,2173,2237,4410,M5039
Musées des Arts Décoratifs - MAD,2020,ILE-DE-France,PARIS,82878,125991,208869,M5021
Musée National Auguste Rodin,2020,ILE-DE-France,PARIS,78952,73856,152808,M5044
Musée National Picasso,2020,ILE-DE-France,PARIS,62709,52699,115408,M5043
Les Catacombes,2020,ILE-DE-France,PARIS,171689,30776,202465,M1104
Musée de l'Ecole Nationale Supérieure des Beaux-Arts,2020,ILE-DE-France,PARIS,4996,3664,8660,M5051
Musée de la Musique,2020,ILE-DE-France,PARIS,84463,30056,114519,M5057
Maison de Balzac,2020,ILE-DE-France,PARIS,9311,11882,21193,M1102
"Musée Cognacq-Jay, Musée du XVIIIe siècle de la ville de Paris",2020,ILE-DE-France,PARIS,0,21365,21365,M1107
Musée du Service de Santé des Armées du Val-de-Grâce,2020,ILE-DE-France,PARIS,2964,2252,5216,M9024
Institut du Monde Arabe,2020,ILE-DE-France,PARIS,78858,0,78858,M0365
Musée Yves Saint Laurent,2020,ILE-DE-France,PARIS,12569,1854,14423,M1204
Musée de l'Ecole de Barbizon - Auberge Ganne,2020,ILE-DE-France,BARBIZON,6702,3461,10163,M0370
Musée Municipal des Capucins,2020,ILE-DE-France,COULOMMIERS cedex,379,753,1132,M0372
Musée d'Art et d'Histoire de Melun,2020,ILE-DE-France,MELUN Cedex,0,4483,4483,M0379
Musée Municipal,2020,ILE-DE-France,MORET-SUR-LOING-ET-ORVANNE,0,1005,1005,M0380
Musée Adrien Mentienne,2020,ILE-DE-France,BRY-SUR-MARNE,0,1163,1163,M0424
Musée de Saint-Maur - Villa Médicis,2020,ILE-DE-France,LA VARENNE-SAINT-HILAIRE,0,7067,7067,M0429
Musée de l'Hôtel-Dieu,2020,ILE-DE-France,MANTES-LA-JOLIE,3220,0,3220,M0389
Musée d'Archéologie Nationale (des origines à l'an mille) - Château de st-Germain-en-Laye,2020,ILE-DE-France,SAINT-GERMAIN-EN-LAYE,10831,29938,40769,M5001
Collections de la Fondation de Coubertin,2020,ILE-DE-France,SAINT-REMY-LES-CHEVREUSE,35,865,900,M0399
Muséum Agricole et Industriel Stella Matutina,2020,LA REUNION,PITON-SAINT-LEU,35675,2571,38246,M1068
Musée des Arts Décoratifs de l’Océan indien (MADOI),2020,LA REUNION,SAINT-LOUIS,683,5739,6422,M1078
Musée Volcanologique Frank Arnold Perret,2020,MARTINIQUE,SAINT-PIERRE,20881,1843,22724,M7059
Musée d'Ethnographie et d'Arts Populaires et Musée de la Marine,2020,NORMANDIE,HONFLEUR,8983,2692,11675,M0662
Musée Eugène Boudin,2020,NORMANDIE,HONFLEUR,15234,3346,18580,M0661
Musée Municipal,2020,NORMANDIE,VIRE NORMANDIE Cedex,0,268,268,M0672
Musée Municipal,2020,NORMANDIE,LOUVIERS Cedex,0,6547,6547,M0706
Musée de la Guerre et de la Libération,2020,NORMANDIE,CHERBOURG-EN-COTENTIN,2014,3599,5613,M0679
Musée des Beaux-Arts,2020,NORMANDIE,SAINT-LÔ,1879,2887,4766,M0685
Musée du Granit,2020,NORMANDIE,SAINT-MICHEL-DE-MONTJOIE,0,1725,1725,M0687
Musée du Château,2020,NORMANDIE,TORIGNY-LES-VILLES,60,40,100,M0690
Musée de la Poêlerie,2020,NORMANDIE,VILLEDIEU-LES-POÊLES-ROUFFIGNY,1822,910,2732,M0693
Musée d'Elbeuf,2020,NORMANDIE,ELBEUF,611,6437,7048,M1099
Abbaye de Graville - Musée du Prieuré de Graville,2020,NORMANDIE,LE HAVRE,1675,1740,3415,M0719
La Maison de l'Armateur,2020,NORMANDIE,LE HAVRE,2070,2294,4364,M0721
Muséum d'Histoire Naturelle,2020,NORMANDIE,LE HAVRE,4444,11055,15499,M7015
Musée des Sapeurs-Pompiers de France,2020,NORMANDIE,MONTVILLE,3632,1563,5195,M0726
"Ethnothèque, Musée des Boucles de la Seine Normande",2020,NORMANDIE,NOTRE-DAME-DE-BLIQUETUIT,0,200,200,M0723
MUNAE - Musée National de l'Education,2020,NORMANDIE,ROUEN,1050,3688,4738,M5067
Musée Le Secq des Tournelles,2020,NORMANDIE,ROUEN,0,9922,9922,M0732
Musée des Beaux-Arts,2020,NORMANDIE,ROUEN,60047,46295,106342,M0729
Musée des Beaux-Arts,2020,NOUVELLE-AQUITAINE,ANGOULEME,6941,17706,24647,M0818
Musée Dupuy-Mestreau,2020,NOUVELLE-AQUITAINE,SAINTES,512,1162,1674,M0838
Musée Henri Barré,2020,NOUVELLE-AQUITAINE,THOUARS,221,320,541,M0845
Musée d'Aquitaine,2020,NOUVELLE-AQUITAINE,BORDEAUX,27469,34244,61713,M0064
CAPC Musée d'Art Contemporain de Bordeaux,2020,NOUVELLE-AQUITAINE,BORDEAUX,10544,38668,49212,M0067
Musée Historique de l'Hydravion,2020,NOUVELLE-AQUITAINE,BISCARROSSE,8455,921,9376,M0076
Musée de Borda,2020,NOUVELLE-AQUITAINE,DAX Cedex,1358,2580,3938,M0077
Musée Départemental d'Histoire et d'Archéologie,2020,NOUVELLE-AQUITAINE,HASTINGUES,3536,1869,5405,M0078
Musée Départemental de la Faïence et des Arts de la table,2020,NOUVELLE-AQUITAINE,SAMADET,1469,991,2460,M0086
Musée Municipal,2020,NOUVELLE-AQUITAINE,ARUDY,504,281,785,M0092
Musée Gallo-Romain de Claracq,2020,NOUVELLE-AQUITAINE,CLARACQ,470,404,874,M1198
Musée des Beaux-Arts,2020,OCCITANIE,CARCASSONNE,0,12320,12320,M0440
Musée Municipal de Millau,2020,OCCITANIE,MILLAU,931,7082,8013,M0549
Musée-Bibliothèque Pierre-André Benoît,2020,OCCITANIE,ALES,0,4009,4009,M0448
Musée Cévenol,2020,OCCITANIE,LE VIGAN,1010,1103,2113,M0452
Musée de la Romanité,2020,OCCITANIE,NÎMES,50496,17917,68413,M0455
Muséum d'Histoire Naturelle et de Préhistoire,2020,OCCITANIE,NÎMES,5855,1550,7405,M7051
Musée Pyrénéen,2020,OCCITANIE,LOURDES,30614,4518,35132,M0588
Musée de la Cloche et de la Sonnaille,2020,OCCITANIE,HEREPIAN,787,189,976,M0471
Musée de Lodève - Hôtel du cardinal de Fleury,2020,OCCITANIE,LODEVE,19879,7043,26922,M0474
Musée Archéologique Paul Soyris,2020,OCCITANIE,MURVIEL-LES-MONTPELLIER,154,82,236,M0481
Musée Gallo-Romain d'Uxellodunum,2020,OCCITANIE,MARTEL,287,300,587,M0581
Musée Toulouse Lautrec,2020,OCCITANIE,ALBI Cedex,58972,13810,72782,M0592
Musée d'histoire naturelle Philadelphe Thomas,2020,OCCITANIE,GAILLAC,680,1744,2424,M7037
Musée Raymond Lafage,2020,OCCITANIE,LISLE-SUR-TARN,0,892,892,M0602
Musée d'Histoire Naturelle Victor Brun,2020,OCCITANIE,MONTAUBAN,2013,5578,7591,M7046
Musée Ingres-Bourdelles,2020,OCCITANIE,MONTAUBAN,28264,22416,50680,M0607
"Musée de la Fève, Crèches et Traditions Populaires",2020,PAYS DE LA LOIRE,BLAIN,0,1123,1123,M0738
Musée d'Art de Nantes,2020,PAYS DE LA LOIRE,NANTES,47171,86406,133577,M0743
Muséum des Sciences Naturelles,2020,PAYS DE LA LOIRE,ANGERS,3552,10344,13896,M7017
Musée d'Art et d'Histoire,2020,PAYS DE LA LOIRE,CHOLET,490,6520,7010,M0754
Musée de l'Ardoise,2020,PAYS DE LA LOIRE,TRELAZE,3017,499,3516,M0760
Musée du Château de Mayenne,2020,PAYS DE LA LOIRE,MAYENNE,3270,2445,5715,M0767
Musée de Tessé,2020,PAYS DE LA LOIRE,LE MANS,10510,7903,18413,M0770
Bibliothèque-musée,2020,PAYS DE LA LOIRE,SAINT-CALAIS,0,318,318,M1131
Musée Municipal,2020,PAYS DE LA LOIRE,LA ROCHE-SUR-YON,0,5754,5754,M0776
Musée Milcendeau Jean-Yole,2020,PAYS DE LA LOIRE,SOULLANS,1165,109,1274,M0783
Musée de la vallée,2020,PROVENCE-ALPES-CÔTE D'AZUR,BARCELONNETTE,4380,1246,5626,M0856
Musée départemental de préhistoire,2020,PROVENCE-ALPES-CÔTE D'AZUR,QUINSON,40187,4433,44620,M0861
Musée d'Histoire et d'Archéologie,2020,PROVENCE-ALPES-CÔTE D'AZUR,ANTIBES,2035,2027,4062,M0868
Musée-Château de Cagnes,2020,PROVENCE-ALPES-CÔTE D'AZUR,CAGNES-SUR-MER,5836,5329,11165,M0870
Musée Bonnard,2020,PROVENCE-ALPES-CÔTE D'AZUR,LE CANNET,15451,0,15451,M1135
Musée de Préhistoire Régionale,2020,PROVENCE-ALPES-CÔTE D'AZUR,MENTON,951,1167,2118,M0874
Muséum d'Histoire Naturelle,2020,PROVENCE-ALPES-CÔTE D'AZUR,NICE,961,2764,3725,M7050
Musée Matisse,2020,PROVENCE-ALPES-CÔTE D'AZUR,NICE,21799,25716,47515,M0884
Musée National du Sport,2020,PROVENCE-ALPES-CÔTE D'AZUR,NICE,17875,0,17875,M5027
Muséum d'Histoire Naturelle,2020,PROVENCE-ALPES-CÔTE D'AZUR,AIX-EN-PROVENCE,60,3184,3244,M7064
Musée Réattu,2020,PROVENCE-ALPES-CÔTE D'AZUR,ARLES,4735,13741,18476,M0900
Musée Frédéric Mistral,2020,PROVENCE-ALPES-CÔTE D'AZUR,MAILLANE,577,119,696,M0911
Musée d'Art Contemporain - Galeries Contemporaines,2020,PROVENCE-ALPES-CÔTE D'AZUR,MARSEILLE,0,2971,2971,M1094
Musée des Civilisations de l'Europe et de la Méditerranée - MuCem,2020,PROVENCE-ALPES-CÔTE D'AZUR,MARSEILLE,88608,101592,190200,M5002
Musée Ziem,2020,PROVENCE-ALPES-CÔTE D'AZUR,MARTIGUES,0,5706,5706,M0923
Musée Estrine - Présence Van Gogh,2020,PROVENCE-ALPES-CÔTE D'AZUR,SAINT-REMY-DE-PROVENCE,4749,2054,6803,M1168
Musée National de la Marine de Toulon,2020,PROVENCE-ALPES-CÔTE D'AZUR,TOULON,9156,12370,21526,M5026
Musée Sobirats,2020,PROVENCE-ALPES-CÔTE D'AZUR,CARPENTRAS,0,68,68,M0951
Musée de l'Arche,2020,ST PIERRE ET MIQUELON,SAINT-PIERRE,277,220,497,M1071
Musée Théodore Calbet,2009,MIDI-PYRENEES,GRISOLLES,0,2257,2257,
"Forum Antique de Bavay, Musée Archéologique du Département du Nord",2009,NORD-PAS-DE-CALAIS,BAVAY,9365,23459,32824,
Musée du Mont-de-Piété,2009,NORD-PAS-DE-CALAIS,BERGUES,1409,925,2334,
Lieu d'Art et Action Contemporaine de Dunkerque - LAAC,2009,NORD-PAS-DE-CALAIS,DUNKERQUE,23253,0,23253,
Musée Municipal d'Escaudain,2009,NORD-PAS-DE-CALAIS,ESCAUDAIN,0,614,614,
"Musée de la Mine, Centre Historique Minier",2009,NORD-PAS-DE-CALAIS,LEWARDE,137845,13915,151760,
Musée des Beaux-Arts,2009,NORD-PAS-DE-CALAIS,ROUBAIX,98583,109036,207619,
Musée d'Art Moderne de Lille Métropole,2009,NORD-PAS-DE-CALAIS,VILLENEUVE-D'ASCQ,29961,9254,39215,
Musée des Beaux-Arts et de la Dentelle,2009,NORD-PAS-DE-CALAIS,CALAIS,1911,12462,14373,
Musée de la Céramique,2009,NORD-PAS-DE-CALAIS,DESVRES,8248,535,8783,
Musée d'Histoire et d'Archéologie,2009,NORD-PAS-DE-CALAIS,HARNES,0,1002,1002,
Musée de l'Hôtel Sandelin,2009,NORD-PAS-DE-CALAIS,SAINT-OMER,3919,8069,11988,
Musée Langlois,2009,BASSE-NORMANDIE,BEAUMONT-EN-AUGE,785,0,785,
Musée Eugène Boudin,2009,BASSE-NORMANDIE,HONFLEUR,30489,0,30489,
Musée de la Mine,2009,BASSE-NORMANDIE,LE MOLAY-LITTRY,4710,795,5505,
Musée d'Art et d'Histoire de Lisieux,2009,BASSE-NORMANDIE,LISIEUX,511,1478,1989,
Musée du Château,2009,BASSE-NORMANDIE,PONTECOULANT,3750,1519,5269,
Musée de Trouville - Villa Montebello,2009,BASSE-NORMANDIE,TROUVILLE-SUR-MER,3467,10429,13896,
Musée et Sites archéologiques de Vieux-la-Romaine,2009,BASSE-NORMANDIE,VIEUX,3851,14539,18390,
Musée Municipal,2009,BASSE-NORMANDIE,VIRE NORMANDIE,1294,3665,4959,
Musée de la Pomme et de la Poire,2009,BASSE-NORMANDIE,BARENTON,633,3360,3993,
Musée du Vieux Château,2009,BASSE-NORMANDIE,BRICQUEBEC-EN-COTENTIN,530,0,530,
Musée Thomas Henry,2009,BASSE-NORMANDIE,CHERBOURG-EN-COTENTIN,0,30554,30554,
Musée Christian Dior,2009,BASSE-NORMANDIE,GRANVILLE,23609,4529,28138,
Musée Barbey d'Aurevilly,2009,BASSE-NORMANDIE,SAINT-SAUVEUR-LE-VICOMTE,1129,223,1352,
Musée du Château de Flers,2009,BASSE-NORMANDIE,FLERS,2032,3262,5294,
Musée Municipal,2009,HAUTE-NORMANDIE,LOUVIERS,262,5824,6086,
Museoseine,2009,HAUTE-NORMANDIE,CAUDEBEC-EN-CAUX,2836,1310,4146,
"Juliobona, Musée Gallo-Romain de Lillebonne",2009,HAUTE-NORMANDIE,LILLEBONNE,391,1626,2017,
Musée des Antiquités de la Seine-Maritime,2009,HAUTE-NORMANDIE,ROUEN,2191,23819,26010,
Musée-Maison Natale Pierre Corneille,2009,HAUTE-NORMANDIE,ROUEN,0,2216,2216,
Musée Le Secq des Tournelles,2009,HAUTE-NORMANDIE,ROUEN,4790,7508,12298,
Musée Flaubert et d'Histoire de la Médecine,2009,HAUTE-NORMANDIE,ROUEN,2755,3429,6184,
Galerie David d'Angers,2009,PAYS DE LA LOIRE,ANGERS,7228,14260,21488,
Château-Musée,2009,PAYS DE LA LOIRE,SAUMUR,49350,9884,59234,
Musée du Vieux Château,2009,PAYS DE LA LOIRE,LAVAL,10082,14889,24971,
Musée de la Reine Bérengère,2009,PAYS DE LA LOIRE,LE MANS,2542,4543,7085,
Musée Municipal,2009,PAYS DE LA LOIRE,LA ROCHE-SUR-YON,0,10469,10469,
Musée de l'Abbaye de Sainte-Croix,2009,PAYS DE LA LOIRE,LES SABLES D'OLONNE,6466,12648,19114,
Musée du Nord de la Vendée,2009,PAYS DE LA LOIRE,MONTAIGU,0,619,619,
Musée du Château,2009,PAYS DE LA LOIRE,NOIRMOUTIER-EN-L'ILE,36996,5109,42105,
Musée - Centre de Documentation Alfred Desmasures,2009,PICARDIE,HIRSON,0,951,951,
Musée d'Art et d'Archéologie,2009,PICARDIE,LAON,1240,4215,5455,
Musée Alexandre Dumas,2009,PICARDIE,VILLERS COTTERETS,1229,610,1839,
Musée du Château de Compiègne,2009,PICARDIE,COMPIEGNE,46338,55217,101555,
Musée Jean Calvin,2009,PICARDIE,NOYON,4741,4717,9458,
Musée Départemental de l'Abbaye de Saint-Riquier,2009,PICARDIE,ABBEVILLE,0,28309,28309,
Musée Régional de Fouras,2009,POITOU-CHARENTES,FOURAS,6155,11654,17809,
Musée des Beaux-Arts,2009,POITOU-CHARENTES,LA ROCHELLE,1749,7564,9313,
Musée du Présidial,2009,POITOU-CHARENTES,SAINTES,801,2151,2952,
Musée du baptistère Saint-Jean,2009,POITOU-CHARENTES,POITIERS,12419,1159,13578,
Musée de Salagon,2009,PROVENCE-ALPES-CÔTE D'AZUR,MANE,27019,5968,32987,
Musée de la Castre,2009,PROVENCE-ALPES-CÔTE D'AZUR,CANNES,11536,15313,26849,
Musée des Beaux-Arts,2009,PROVENCE-ALPES-CÔTE D'AZUR,MENTON,0,13342,13342,
Musée Jean Cocteau Collection Séverin Wunderman,2009,PROVENCE-ALPES-CÔTE D'AZUR,MENTON,10227,5238,15465,
Musée de Préhistoire Régionale,2009,PROVENCE-ALPES-CÔTE D'AZUR,MENTON,0,12742,12742,
Muséum d'Histoire Naturelle,2009,PROVENCE-ALPES-CÔTE D'AZUR,NICE,0,114479,114479,
Musée National Marc Chagall,2009,PROVENCE-ALPES-CÔTE D'AZUR,NICE,95803,46900,142703,
Muséum d'Histoire Naturelle,2009,PROVENCE-ALPES-CÔTE D'AZUR,AIX-EN-PROVENCE,11507,27193,38700,
Musée des Tapisseries,2009,PROVENCE-ALPES-CÔTE D'AZUR,AIX-EN-PROVENCE,5140,15127,20267,
Musée Réattu,2009,PROVENCE-ALPES-CÔTE D'AZUR,ARLES,14604,6109,20713,
Musée Alphonse Daudet,2009,PROVENCE-ALPES-CÔTE D'AZUR,FONTVIEILLE,27095,0,27095,
Musée Archéologique d'Istres René Beaucaire,2009,PROVENCE-ALPES-CÔTE D'AZUR,ISTRES,0,4830,4830,
Musée d'Histoire de Marseille,2009,PROVENCE-ALPES-CÔTE D'AZUR,MARSEILLE,10782,35570,46352,
Musée d'Art Contemporain - Galeries Contemporaines,2009,PROVENCE-ALPES-CÔTE D'AZUR,MARSEILLE,5015,14832,19847,
Musée Cantini,2009,PROVENCE-ALPES-CÔTE D'AZUR,MARSEILLE,33914,42384,76298,
Musée de l'Empéri de Salon et de la Crau,2009,PROVENCE-ALPES-CÔTE D'AZUR,SALON-DE-PROVENCE,7408,14265,21673,
Musée Départemental des Hautes-Alpes,2009,PROVENCE-ALPES-CÔTE D'AZUR,GAP,0,15438,15438,
Musée des Arts et d’Histoire,2009,PROVENCE-ALPES-CÔTE D'AZUR,BORMES-LES-MIMOSAS,0,7974,7974,
Musée des Troupes de Marine,2009,PROVENCE-ALPES-CÔTE D'AZUR,FREJUS,0,14271,14271,
Musée Jean Aicard,2009,PROVENCE-ALPES-CÔTE D'AZUR,LE POUVEREL LA GARDE,0,1687,1687,
Musée Sobirats,2009,PROVENCE-ALPES-CÔTE D'AZUR,CARPENTRAS,237,803,1040,
Synagogue Musée Juif Comtadin,2009,PROVENCE-ALPES-CÔTE D'AZUR,CAVAILLON,5632,3512,9144,
Musée Municipal,2009,PROVENCE-ALPES-CÔTE D'AZUR,ORANGE,59963,0,59963,
Musée Départemental du Cartonnage et de l'Imprimerie,2009,PROVENCE-ALPES-CÔTE D'AZUR,VALREAS,2539,1556,4095,
Musée de la Société d'Histoire et d'Archéologie,2009,RHONE-ALPES,BRIORD,108,53,161,
Cité de Préhistoire,2009,RHONE-ALPES,ORGNAC-L'AVEN,110153,6204,116357,
Musée d'Histoire et d'Archéologie,2009,RHONE-ALPES,DIE,580,2136,2716,
Musée du site Préhistorique,2009,RHONE-ALPES,VASSIEUX-EN-VERCORS,15824,0,15824,
Musée Géo-Charles,2009,RHONE-ALPES,ECHIROLLES,0,5384,5384,
Musée Hector Berlioz,2009,RHONE-ALPES,LA-COTE-SAINT-ANDRE,0,22567,22567,
Musée des Beaux-Arts et d'Archéologie,2009,RHONE-ALPES,VIENNE,1342,3477,4819,
Musée Départemental de la Révolution Française,2009,RHONE-ALPES,VIZILLE,11267,47533,58800,
Musée Folklorique du Vieux Saint-Etienne,2009,RHONE-ALPES,SAINT-ETIENNE,561,1327,1888,
Château de la Bastie d'Urfé,2009,RHONE-ALPES,SAINT-ETIENNE-LE-MOLARD,16289,11087,27376,
Musée de l'Imprimerie et de la Communication Graphique,2009,RHONE-ALPES,LYON,13129,8581,21710,
Musée Savoisien,2009,RHONE-ALPES,CHAMBERY,4074,11749,15823,
Maison de l'Archéologie des Vosges du Nord,2010,ALSACE,NIEDERBRONN-LES-BAINS,2876,3797,6673,
Musée du Fer,2010,ALSACE,REICHSHOFFEN,733,579,1312,
Musée Historique,2010,ALSACE,STRASBOURG,10879,27764,38643,
Musée des Arts Décoratifs,2010,ALSACE,STRASBOURG,8783,36528,45311,
Musée Gallo-Romain,2010,ALSACE,BIESHEIM,758,1964,2722,
Musée d'Unterlinden,2010,ALSACE,COLMAR,154400,28600,183000,
Musée d'Histoire Local,2010,ALSACE,KAYSERSBERG,347,780,1127,
Maison du Sundgau - Musée Paysan,2010,ALSACE,OLTINGUE,1608,241,1849,
Musée d'Art et Traditions Populaires,2010,AQUITAINE,VILLEFRANCHE-DE-LONCHAT,0,1100,1100,
Musée des Arts Décoratifs,2010,AQUITAINE,BORDEAUX,2733,34499,37232,
Musée des Beaux-Arts et d'Archéologie,2010,AQUITAINE,LIBOURNE,0,5058,5058,
Atelier-Musée  (Ecomusée de la Grande Landes),2010,AQUITAINE,LUXEY,926,0,926,
Musée de la Chalosse,2010,AQUITAINE,MONTFORT-EN-CHALOSSE,8541,2344,10885,
Musée Basque et de l'Histoire de Bayonne,2010,AQUITAINE,BAYONNE,19902,12615,32517,
Musée Charles-Louis Philippe,2010,AUVERGNE,CERILLY,235,85,320,
Musée de la Dentelle,2010,AUVERGNE,ARLANC,1145,31,1176,
Musée d'Art Roger-Quillot,2010,AUVERGNE,CLERMONT-FERRAND,6480,23296,29776,
Musée Départemental de la Céramique Gallo-Romaine,2010,AUVERGNE,LEZOUX,9051,4949,14000,
Musée des Pénitents Blancs,2010,AUVERGNE,MARSAC-EN-LIVRADOIS,304,13,317,
Musée Paléontologique,2010,AUVERGNE,MENAT,588,86,674,
Musée Régional d'Auvergne,2010,AUVERGNE,RIOM,771,2142,2913,
"Musée de la Vie Bourguignonne, Perrin de Puycousin",2010,BOURGOGNE,DIJON,0,36278,36278,
Musée Buffon,2010,BOURGOGNE,MONTBARD,0,11809,11809,
Musée du Septennat,2010,BOURGOGNE,CHATEAU-CHINON,11939,3459,15398,
Musée de la Mine,2010,BOURGOGNE,LA MACHINE,5947,1044,6991,
Musée Saint-Nazaire,2010,BOURGOGNE,BOURBON-LANCY,146,2409,2555,
Musée des Ursulines,2010,BOURGOGNE,MACON,2118,17701,19819,
Musée Lamartine,2010,BOURGOGNE,MACON,1393,3660,5053,
Musée de la Tour du Moulin,2010,BOURGOGNE,MARCIGNY,1600,606,2206,
Maison du Blé et du Pain,2010,BOURGOGNE,VERDUN-SUR-LE-DOUBS,3841,1883,5724,
Musée Colette,2010,BOURGOGNE,SAINT-SAUVEUR-EN-PUISAYE,8180,1373,9553,
Musée Villeneuvien,2010,BOURGOGNE,VILLENEUVE-SUR-YONNE,0,2005,2005,
Musée Mathurin Meheut,2010,BRETAGNE,LAMBALLE,5132,1208,6340,
Musée des Beaux-Arts de Brest,2010,BRETAGNE,BREST,3615,18767,22382,
Ecomusée des Monts d'Arrée - Moulins de Kerouat,2010,BRETAGNE,COMMANA,9395,2199,11594,
Le Port-Musée,2010,BRETAGNE,DOUARNENEZ,29505,39364,68869,
Musée des Beaux-Arts,2010,BRETAGNE,QUIMPER,28718,28456,57174,
Ecomusée du Pays de Montfort,2010,BRETAGNE,MONTFORT-SUR-MEU,3551,1451,5002,
Musée des Beaux-Arts,2010,BRETAGNE,RENNES,22031,45479,67510,
Musée d'Histoire de la Ville de Saint-Malo,2010,BRETAGNE,SAINT-MALO,18992,8287,27279,
Musée Saint-Nicolas,2010,BRETAGNE,VITRE,183,1621,1804,
Musée du Château de Vitré,2010,BRETAGNE,VITRE,14014,6978,20992,
Muséum des Sciences Naturelles et de Préhistoire,2010,CENTRE,CHARTRES,3030,16404,19434,
Musée d'Art et d'Histoire de Dreux,2010,CENTRE,DREUX,2913,4413,7326,
Musées de Châteauroux - Hôtel Bertrand,2010,CENTRE,CHATEAUROUX,0,20853,20853,
Musée de l'Hôtel des Communes,2010,CENTRE,AMBOISE,0,6220,6220,
Musée Balzac,2010,CENTRE,SACHE,15645,8511,24156,
Musée du Compagnonnage,2010,CENTRE,TOURS,29667,16002,45669,
Château Musées de Blois,2010,CENTRE,BLOIS,230823,31478,262301,
Musée de Sologne,2010,CENTRE,ROMORANTIN-LANTHENAY,7561,9250,16811,
Musée d'Art et d'Archéologie,2010,CENTRE,CHATILLON-COLIGNY,306,144,450,
Musée Girodet,2010,CENTRE,MONTARGIS,1508,2210,3718,
Musée de l'Ardenne,2010,CHAMPAGNE-ARDENNES,CHARLEVILLE-MEZIERES,5308,28317,33625,
Musée Municipal,2010,CHAMPAGNE-ARDENNES,BOURBONNE-LES-BAINS,0,2129,2129,
Musée des Beaux-Arts et d'Archéologie,2010,CHAMPAGNE-ARDENNES,CHAUMONT,1291,1431,2722,
Musée Municipal,2010,CHAMPAGNE-ARDENNES,CHALONS-EN-CHAMPAGNE,2047,19498,21545,
Musée de l'Ancien Collège des Jésuites/Planétarium,2010,CHAMPAGNE-ARDENNES,REIMS,2874,29098,31972,
Musée Départemental Pascal Paoli,2010,CORSE,MOROSAGLIA,4990,510,5500,
Musée de la résistance et de la Déportation,2010,FRANCHE-COMTE,BESANCON,55574,0,55574,
Musée du Temps,2010,FRANCHE-COMTE,BESANCON,5742,26872,32614,
Musée Beurnier-Rossel,2010,FRANCHE-COMTE,MONTBELIARD,557,2671,3228,
Musée du Château des Ducs de Wurtemberg,2010,FRANCHE-COMTE,MONTBELIARD,5369,13931,19300,
Musée de Pontarlier,2010,FRANCHE-COMTE,PONTARLIER,1446,8171,9617,
Musée Départemental de la Montagne Albert Demard,2010,FRANCHE-COMTE,LE HAUT-DU-THEM,3748,2879,6627,
Musée de la Tour des Echevins,2010,FRANCHE-COMTE,LUXEUIL-LES-BAINS,2193,5200,7393,
Musée de la Vigne et du Vin,2010,FRANCHE-COMTE,ARBOIS,3969,1578,5547,
Musée des Beaux-Arts,2010,FRANCHE-COMTE,DOLE,0,16255,16255,
Musée des Beaux-Arts,2010,FRANCHE-COMTE,LONS-LE-SAUNIER,879,5149,6028,
Musée de l'Abbaye/Donations Guy Bardone - René Genis,2010,FRANCHE-COMTE,SAINT-CLAUDE,4927,6312,11239,
Musée Frédéric Japy,2010,FRANCHE-COMTE,BEAUCOURT,1731,1352,3083,
Musée d'Art et d'Histoire,2010,FRANCHE-COMTE,BELFORT,18615,0,18615,
Ecomusée Municipal d'Approuague-Kaw,2010,GUYANE,REGINA,2414,3380,5794,
Musée des Années Trente,2010,ILE-DE-FRANCE,BOULOGNE-BILLANCOURT,41396,20558,61954,
Musée Belmondo et de la Sculpture Figurative du XXè siècle,2010,ILE-DE-FRANCE,BOULOGNE-BILLANCOURT,6263,2668,8931,
Musée de l'Armée,2010,ILE-DE-FRANCE,PARIS,916877,510548,1427425,
Musée Bourdelle,2010,ILE-DE-FRANCE,PARIS,31888,30323,62211,
Etablissement Public du Musée des Arts Asiatiques Guimet,2010,ILE-DE-FRANCE,PARIS,111999,112179,224178,
Musée Municipal des Capucins,2010,ILE-DE-FRANCE,COULOMMIERS,1448,1672,3120,
Musée Bossuet,2010,ILE-DE-FRANCE,MEAUX,8023,5219,13242,
Musée Départemental de Préhistoire d'Île de France,2010,ILE-DE-FRANCE,NEMOURS,2887,19575,22462,
Musée de Saint-Maur - Villa Médicis,2010,ILE-DE-FRANCE,LA VARENNE-SAINT-HILAIRE,47,9589,9636,
Musée Fragonard,2010,ILE-DE-FRANCE,MAISONS-ALFORT,3904,4979,8883,
"MAC VAL, Musée d'Art Contemporain du Val-de-Marne",2010,ILE-DE-FRANCE,VITRY SUR SEINE,19082,56411,75493,
Musée Intercommunal d'Histoire et d'Archéologie de Louvres,2010,ILE-DE-FRANCE,ROISSY-EN-FRANCE,1329,2615,3944,
Musée de l'Hôtel-Dieu,2010,ILE-DE-FRANCE,MANTES-LA-JOLIE,5766,2181,7947,
Musée Rambolitrain,2010,ILE-DE-FRANCE,RAMBOUILLET,14596,2016,16612,
Musée Lambinet,2010,ILE-DE-FRANCE,VERSAILLES,6452,15397,21849,
Musée des Beaux-Arts,2010,LANGUEDOC-ROUSSILLON,CARCASSONNE,0,50760,50760,
Musée-Bibliothèque Pierre-André Benoît,2010,LANGUEDOC-ROUSSILLON,ALES,0,10783,10783,
Musée du Colombier,2010,LANGUEDOC-ROUSSILLON,ALES,0,12935,12935,
Musée Archéologique,2010,LANGUEDOC-ROUSSILLON,NIMES,0,61816,61816,
Musée Départemental d'Art Sacré du Gard,2010,LANGUEDOC-ROUSSILLON,PONT-SAINT-ESPRIT,612,9600,10212,
Musée de la Maison Romane,2010,LANGUEDOC-ROUSSILLON,SAINT-GILLES-DU-GARD,0,5818,5818,
Musée des Vallées Cévenoles,2010,LANGUEDOC-ROUSSILLON,SAINT-JEAN DU GARD,8243,6467,14710,
Musée Pierre de Luxembourg,2010,LANGUEDOC-ROUSSILLON,VILLENEUVE-LES-AVIGNON,3103,3550,6653,
Musée de Préhistoire Régionale et du Mégalithisme,2010,LANGUEDOC-ROUSSILLON,SAINT-PONS-DE-THOMIERES,1772,806,2578,
Ecomusée du Mont Lozère,2010,LANGUEDOC-ROUSSILLON,LE PONT DE MONTVERT,2488,2342,4830,
Musée René Baubérot,2010,LIMOUSIN,CHATEAUPONSAC,2959,520,3479,
Musée National Adrien Dubouché,2010,LIMOUSIN,LIMOGES,10923,8345,19268,
Musée de l'Histoire du Fer,2010,LORRAINE,JARVILLE-LA-MALGRANGE,1784,3533,5317,
Musée Départemental Raymond Poincaré,2010,LORRAINE,SAMPIGNY,285,639,924,
Musée Militaire et Erckmann-Chatrian,2010,LORRAINE,PHALSBOURG,685,9,694,
Musée Charles de Bruyères,2010,LORRAINE,REMIREMONT,692,3069,3761,
Musée de La Canne,2010,MARTINIQUE,LES TROIS ILETS,8193,2313,10506,
"Musée des Mœurs et Coutumes, Musée du Rouergue",2010,MIDI-PYRENEES,ESPALION,1582,0,1582,
Musée des jacobins,2010,MIDI-PYRENEES,AUCH,3084,8255,11339,
Musée des Transports et des Communications,2010,MIDI-PYRENEES,TOULOUSE,0,684,684,
Musée Georges Labit,2010,MIDI-PYRENEES,TOULOUSE,7057,14863,21920,
Musée Municipal - Musée Trésor,2010,MIDI-PYRENEES,LUZ-SAINT-SAUVEUR,0,4500,4500,
Musée Henri Martin,2010,MIDI-PYRENEES,CAHORS,2231,7815,10046,
Musée du Vieux Figeac,2010,MIDI-PYRENEES,FIGEAC,721,131,852,
"Musée Archéologique ""Armand-Viré""",2010,MIDI-PYRENEES,LUZECH,400,627,1027,
Musée de l'Automate,2010,MIDI-PYRENEES,SOUILLAC,18684,3856,22540,
Muséum d'histoire naturelle Philadelphe Thomas,2010,MIDI-PYRENEES,GAILLAC,730,2842,3572,
Musée de l'Abbaye Saint-Michel,2010,MIDI-PYRENEES,GAILLAC,2056,1286,3342,
Musée Municipal de Cambrai,2010,NORD-PAS-DE-CALAIS,CAMBRAI,4106,13257,17363,
"Musée de la Mine, Centre Historique Minier",2010,NORD-PAS-DE-CALAIS,LEWARDE,135152,13030,148182,
Musée d'Histoire Locale de Marchiennes,2010,NORD-PAS-DE-CALAIS,MARCHIENNES,285,599,884,
Musée des Beaux-Arts,2010,NORD-PAS-DE-CALAIS,ARRAS,10304,22169,32473,
Musée des Beaux-Arts et de la Dentelle,2010,NORD-PAS-DE-CALAIS,CALAIS,4882,6542,11424,
Musée d'Art et d'Histoire Roger Rodière,2010,NORD-PAS-DE-CALAIS,MONTREUIL-SUR-MER,3161,4443,7604,
Musée Municipal Bruno Danvin,2010,NORD-PAS-DE-CALAIS,SAINT-POL-SUR-TERNOISE,0,3659,3659,
Musée du Débarquement,2010,BASSE-NORMANDIE,ARROMANCHES,318297,11260,329557,
Musée d'Art et d'Histoire de Lisieux,2010,BASSE-NORMANDIE,LISIEUX,2332,1802,4134,
Musée Paléontologique,2010,BASSE-NORMANDIE,VILLERS-SUR-MER,0,36289,36289,
Musée de l'Abbaye,2010,BASSE-NORMANDIE,CERISY-LA-FORET,6213,0,6213,
Musée du Vieux Granville,2010,BASSE-NORMANDIE,GRANVILLE,5455,8381,13836,
Musée Barbey d'Aurevilly,2010,BASSE-NORMANDIE,SAINT-SAUVEUR-LE-VICOMTE,1017,287,1304,
Musée du Château de Flers,2010,BASSE-NORMANDIE,FLERS,0,8763,8763,
Musée Municipal Nicolas Poussin,2010,HAUTE-NORMANDIE,LES ANDELYS,923,1815,2738,
Musée Municipal,2010,HAUTE-NORMANDIE,LOUVIERS,209,9536,9745,
Château-Musée de Dieppe,2010,HAUTE-NORMANDIE,DIEPPE,57825,3318,61143,
La Maison de l'Armateur,2010,HAUTE-NORMANDIE,LE HAVRE,6629,6686,13315,
"Juliobona, Musée Gallo-Romain de Lillebonne",2010,HAUTE-NORMANDIE,LILLEBONNE,480,1242,1722,
Ecomusée de la Basse-Seine,2010,HAUTE-NORMANDIE,NOTRE-DAME-DE-BLIQUETUIT,21727,4849,26576,
Musée des Antiquités de la Seine-Maritime,2010,HAUTE-NORMANDIE,ROUEN,2553,25013,27566,
Musée de la Céramique,2010,HAUTE-NORMANDIE,ROUEN,12516,10122,22638,
Musée des Beaux-Arts,2010,HAUTE-NORMANDIE,ROUEN,167913,130121,298034,
Musée du Pays de Retz,2010,PAYS DE LA LOIRE,BOURGNEUF-EN-RETZ,5088,698,5786,
Musée du Pays de Guérande et de la Porte Saint Michel,2010,PAYS DE LA LOIRE,GUERANDE,14219,6324,20543,
Musée  Départemental Dobrée,2010,PAYS DE LA LOIRE,NANTES,3272,22779,26051,
Ecomusée de Saint-Nazaire,2010,PAYS DE LA LOIRE,SAINT-NAZAIRE,7901,16780,24681,
Musée des Tisserands Mayennais,2010,PAYS DE LA LOIRE,AMBRIERES-LES-VALLEES,650,150,800,
Musée de Tessé,2010,PAYS DE LA LOIRE,LE MANS,16528,11958,28486,
Bibliothèque-musée,2010,PAYS DE LA LOIRE,SAINT-CALAIS,0,953,953,
Musée des Traditions de l'Île,2010,PAYS DE LA LOIRE,LA GUERINIERE,4803,636,5439,
Musée ornithologique Charles-Payraudeau,2010,PAYS DE LA LOIRE,LA-CHAIZE-LE-VICOMTE,0,1088,1088,
Musée de l'Abbaye de Sainte-Croix,2010,PAYS DE LA LOIRE,LES SABLES D'OLONNE,3208,11910,15118,
Musée La Bourrine du Bois-Juquaud,2010,PAYS DE LA LOIRE,SAINT-HILAIRE-DE-RIEZ,11794,7672,19466,
Musée Milcendeau Jean-Yole,2010,PAYS DE LA LOIRE,SOULLANS,1632,2377,4009,
Musée d'Art et d'Archéologie,2010,PICARDIE,LAON,1123,6504,7627,
Musée de La Thiérache,2010,PICARDIE,VERVINS,0,1856,1856,
Musée Alexandre Dumas,2010,PICARDIE,VILLERS COTTERETS,1256,1007,2263,
Musée Jean Calvin,2010,PICARDIE,NOYON,2832,893,3725,
Musée du Noyonnais,2010,PICARDIE,NOYON,1324,1295,2619,
Cité International de la Bande Dessinée et de l'Image - Musée de la Bande Dessinée,2010,POITOU-CHARENTES,ANGOULEME,12341,38803,51144,
Musée Municipal de Cognac,2010,POITOU-CHARENTES,COGNAC,1803,9697,11500,
Musée de la Mytiliculture,2010,POITOU-CHARENTES,ESNANDES,3316,371,3687,
Musée du Nouveau Monde,2010,POITOU-CHARENTES,LA ROCHELLE,4329,9435,13764,
Musée des Beaux-Arts,2010,POITOU-CHARENTES,LA ROCHELLE,2025,7439,9464,
Hôtel Hèbre de Saint-Clément - Musée d'Art et d'Histoire,2010,POITOU-CHARENTES,ROCHEFORT,3352,18743,22095,
Musée des Tumulus de Bougon,2010,POITOU-CHARENTES,BOUGON,15538,6022,21560,
Musée de la vallée,2010,PROVENCE-ALPES-CÔTE D'AZUR,BARCELONNETTE,11646,2404,14050,
Musée du Vieux Sisteron,2010,PROVENCE-ALPES-CÔTE D'AZUR,SISTERON,0,440,440,
Musée d'Histoire et d'Archéologie,2010,PROVENCE-ALPES-CÔTE D'AZUR,ANTIBES,2683,3149,5832,
Musée de la Castre,2010,PROVENCE-ALPES-CÔTE D'AZUR,CANNES,14785,17994,32779,
Musée International de la Parfumerie,2010,PROVENCE-ALPES-CÔTE D'AZUR,GRASSE,52710,27281,79991,
Musée des Beaux-Arts,2010,PROVENCE-ALPES-CÔTE D'AZUR,MENTON,0,12806,12806,
Musée Jean Cocteau Collection Séverin Wunderman,2010,PROVENCE-ALPES-CÔTE D'AZUR,MENTON,10226,5400,15626,
Musée de Préhistoire Régionale,2010,PROVENCE-ALPES-CÔTE D'AZUR,MENTON,0,7967,7967,
Muséum d'Histoire Naturelle,2010,PROVENCE-ALPES-CÔTE D'AZUR,NICE,0,35966,35966,
Musée d'Art Naïf Anatole Jakovsky,2010,PROVENCE-ALPES-CÔTE D'AZUR,NICE,0,21327,21327,
Musée du Vieux-Logis de Nice,2010,PROVENCE-ALPES-CÔTE D'AZUR,NICE,0,265,265,
Musée du Palais Lascaris,2010,PROVENCE-ALPES-CÔTE D'AZUR,NICE,368,85759,86127,
Musée Picasso la guerre et la paix à Vallauris,2010,PROVENCE-ALPES-CÔTE D'AZUR,VALLAURIS,14597,8565,23162,
Musée Granet,2010,PROVENCE-ALPES-CÔTE D'AZUR,AIX-EN-PROVENCE,75975,58025,134000,
Musée Archéologique d'Istres René Beaucaire,2010,PROVENCE-ALPES-CÔTE D'AZUR,ISTRES,0,5592,5592,
Musée Folklorique du Vieux Lambesc,2010,PROVENCE-ALPES-CÔTE D'AZUR,LAMBESC,0,3332,3332,
Musée d'Histoire et d'Archéologie des Baux-de-Provence,2010,PROVENCE-ALPES-CÔTE D'AZUR,LES BAUX DE PROVENCE,213233,28225,241458,
Muséum d'Histoire Naturelle,2010,PROVENCE-ALPES-CÔTE D'AZUR,MARSEILLE,13959,48934,62893,
Musée Grobet-Labadié,2010,PROVENCE-ALPES-CÔTE D'AZUR,MARSEILLE,2059,5965,8024,
Musée Estrine - Présence Van Gogh,2010,PROVENCE-ALPES-CÔTE D'AZUR,SAINT-REMY-DE-PROVENCE,9399,5851,15250,
Musée du Pays Brignolais,2010,PROVENCE-ALPES-CÔTE D'AZUR,BRIGNOLES,1892,2042,3934,
Musée des A.T.P. de Moyenne Provence,2010,PROVENCE-ALPES-CÔTE D'AZUR,DRAGUIGNAN,3094,7986,11080,
Musée Municipal,2010,PROVENCE-ALPES-CÔTE D'AZUR,HYERES,0,44968,44968,
Musée Archéologique,2010,PROVENCE-ALPES-CÔTE D'AZUR,SAINT-RAPHAËL,0,17854,17854,
Musée Municipal,2010,PROVENCE-ALPES-CÔTE D'AZUR,SAULT,0,1678,1678,
Musée Départemental du Cartonnage et de l'Imprimerie,2010,PROVENCE-ALPES-CÔTE D'AZUR,VALREAS,2671,2034,4705,
Musée de la Société d'Histoire et d'Archéologie,2010,RHONE-ALPES,BRIORD,44,264,308,
Musée Départemental du Revermont,2010,RHONE-ALPES,VAL-REVERMONT,3792,6873,10665,
Musée du site Préhistorique,2010,RHONE-ALPES,VASSIEUX-EN-VERCORS,13939,0,13939,
Musée-château d'Annecy,2010,RHONE-ALPES,ANNECY,50443,44262,94705,
Musée Léon Marès,2010,RHONE-ALPES,LOVAGNY,17540,2680,20220,
Musée des Vallées de Thônes,2010,RHONE-ALPES,THONES,834,938,1772,
Musée Jadis Allevard,2010,RHONE-ALPES,ALLEVARD-LES-BAINS,834,4492,5326,
Musée de Bourgoin-Jallieu,2010,RHONE-ALPES,BOURGOIN-JALLIEU,2609,8297,10906,
Muséum d'Histoire Naturelle de Grenoble,2010,RHONE-ALPES,GRENOBLE,19720,67717,87437,
Conservatoire - Musée des Industries Hydroélectriques,2010,RHONE-ALPES,VAUJANY,85,9409,9494,
Musée Lapidaire Saint-Pierre,2010,RHONE-ALPES,VIENNE,2701,4091,6792,
Musée des Beaux-Arts et d'Archéologie,2010,RHONE-ALPES,VIENNE,1113,3212,4325,
Musée Départemental de la Révolution Française,2010,RHONE-ALPES,VIZILLE,5000,49584,54584,
Musée Rural,2010,RHONE-ALPES,USSON-EN-FOREZ,5260,939,6199,
Lugdunum - Musée et Théâtres Romains,2010,RHONE-ALPES,LYON,24087,65210,89297,
Muséum d'Histoire Naturelle,2010,RHONE-ALPES,LYON,0,93070,93070,
Musée archéologique et minéralogique Pierre Borrione,2010,RHONE-ALPES,AIME-EN-TARENTAISE,684,438,1122,
Musée du docteur Faure,2010,RHONE-ALPES,AIX-LES-BAINS,5931,5878,11809,
Musée des Charmettes,2010,RHONE-ALPES,CHAMBERY,0,14037,14037,
Musée de l'Académie de La Val d'Isère,2010,RHONE-ALPES,MOÛTIERS,300,352,652,
Musée d'Art Moderne et Contemporain de Strasbourg,2011,ALSACE,STRASBOURG,31746,94035,125781,
Musée des Beaux-Arts,2011,ALSACE,STRASBOURG,11719,39433,51152,
Cabinet des Estampes et des Dessins,2011,ALSACE,STRASBOURG,0,9851,9851,
Musée Tomi Ungerer,2011,ALSACE,STRASBOURG,18460,33403,51863,
Musée Sundgauvien d'Altkirch,2011,ALSACE,ALTKIRCH,1964,976,2940,
Musée Historique,2011,ALSACE,MULHOUSE,0,33705,33705,
Musée National de l'Automobile - Collection Schlumpf,2011,ALSACE,MULHOUSE,150491,22045,172536,
Musée de l'Impression sur Etoffes,2011,ALSACE,MULHOUSE,17800,12254,30054,
Musée du Dolder,2011,ALSACE,RIQUEWIHR,2129,346,2475,
Musée du Tabac,2011,AQUITAINE,BERGERAC,1703,1683,3386,
Château de Bourdeilles,2011,AQUITAINE,BOURDEILLES,24044,0,24044,
Musée Paul Reclus,2011,AQUITAINE,DOMME,198,13241,13439,
Centre National Jean Moulin,2011,AQUITAINE,BORDEAUX,0,23378,23378,
Musée Municipal Albert Marzelles,2011,AQUITAINE,MARMANDE,0,4771,4771,
Musée Bonnat-Helleu - Musée des Beaux-Arts de Bayonne,2011,AQUITAINE,BAYONNE,1766,2066,3832,
Musée des Arts et Traditions Populaires de Haute Loire,2011,AUVERGNE,LAVAUDIEU,9831,663,10494,
Musée Municipal de la Coutellerie,2011,AUVERGNE,THIERS,21736,5146,26882,
"Musée de la Vie Bourguignonne, Perrin de Puycousin",2011,BOURGOGNE,DIJON,0,41744,41744,
Musée du Grès de Puisaye,2011,BOURGOGNE,SAINT-AMAND-EN-PUISAYE,2604,298,2902,
Musée Auguste Grasset,2011,BOURGOGNE,VARZY,1915,1373,3288,
Musée Rolin,2011,BOURGOGNE,AUTUN,13743,7867,21610,
Musée Départemental du Compagnonnage,2011,BOURGOGNE,ROMANECHE-THORINS,2025,1519,3544,
Musée Leblanc-Duvernois,2011,BOURGOGNE,AUXERRE,0,1068,1068,
Musée de l'Avallonnais Jean Després,2011,BOURGOGNE,AVALLON,0,4439,4439,
Musée des Beaux-Arts de Brest,2011,BRETAGNE,BREST,3770,15409,19179,
Musée de la Pêche,2011,BRETAGNE,CONCARNEAU,25125,4058,29183,
Musée de Morlaix,2011,BRETAGNE,MORLAIX,9470,9271,18741,
Musée des Phares et Balises,2011,BRETAGNE,OUESSANT,13142,2254,15396,
Musée de l'Ecole Rurale en Bretagne,2011,BRETAGNE,TREGARVAN,9676,2138,11814,
Musée des Beaux-Arts,2011,BRETAGNE,RENNES,16531,48750,65281,
Musée de Bretagne,2011,BRETAGNE,RENNES,27834,17005,44839,
Musée des Rochers-Sévigné,2011,BRETAGNE,VITRE,3524,4681,8205,
Musée Saint-Nicolas,2011,BRETAGNE,VITRE,140,1423,1563,
Musée de Préhistoire J. Miln- Z. Le-Rouzic,2011,BRETAGNE,CARNAC,27488,6279,33767,
"La Cohue, Musée des Beaux-Arts de vannes",2011,BRETAGNE,VANNES,7615,9272,16887,
Musée des Arts Décoratifs,2011,CENTRE,BOURGES,0,22307,22307,
Musée des Meilleurs Ouvriers de France,2011,CENTRE,BOURGES,0,22583,22583,
Musée Saint-Vic,2011,CENTRE,SAINT-AMAND-MONTROND,0,4050,4050,
Musée des Beaux-Arts,2011,CENTRE,CHARTRES,4071,7199,11270,
Conservatoire du Machinisme et des Pratiques Agricoles,2011,CENTRE,CHARTRES-MAINVILLIERS,5155,44118,49273,
Musée de la Chemiserie et de l'Elégance Masculine,2011,CENTRE,ARGENTON-SUR-CREUSE,3769,4275,8044,
Musées de Châteauroux - Hôtel Bertrand,2011,CENTRE,CHATEAUROUX,0,16935,16935,
Musée de l'Hôtel des Communes,2011,CENTRE,AMBOISE,0,6786,6786,
Musée du Savignéen,2011,CENTRE,SAVIGNE-SUR-LATHAN,1458,196,1654,
Musée de la Marine de Loire,2011,CENTRE,CHATEAUNEUF-SUR-LOIRE,9495,4737,14232,
Musée Girodet,2011,CENTRE,MONTARGIS,1880,2628,4508,
Musée Historique et Archéologique,2011,CENTRE,ORLEANS,1764,4141,5905,
Musée des Beaux-Arts,2011,CENTRE,ORLEANS,8108,39526,47634,
Musée Arthur Rimbaud,2011,CHAMPAGNE-ARDENNES,CHARLEVILLE-MEZIERES,12297,13117,25414,
Musée Napoléon Ier,2011,CHAMPAGNE-ARDENNES,BRIENNE-LE-CHATEAU,3335,1385,4720,
Pharmacie Musée de l'Hôtel-Dieu,2011,CHAMPAGNE-ARDENNES,TROYES,2980,2831,5811,
Musée Garinet,2011,CHAMPAGNE-ARDENNES,CHALONS-EN-CHAMPAGNE,85,464,549,
Muséum de Besançon,2011,FRANCHE-COMTE,BESANCON,193112,59025,252137,
Musée de la résistance et de la Déportation,2011,FRANCHE-COMTE,BESANCON,55492,0,55492,
Musée de Plein Air des Maisons Comtoises,2011,FRANCHE-COMTE,NANCRAY,31472,11647,43119,
Ecomusée du Pays de la Cerise,2011,FRANCHE-COMTE,FOUGEROLLES,6530,1257,7787,
Musée de la Tour des Echevins,2011,FRANCHE-COMTE,LUXEUIL-LES-BAINS,1873,5343,7216,
Musée Sarret de Grozon,2011,FRANCHE-COMTE,ARBOIS,755,1039,1794,
Musée des Beaux-Arts,2011,FRANCHE-COMTE,LONS-LE-SAUNIER,1750,5056,6806,
Musée Territorial Alexandre Franconie,2011,GUYANE,CAYENNE,1677,8348,10025,
Musée Intercommunal d'Etampes,2011,ILE-DE-FRANCE,ETAMPES,2282,16163,18445,
Musée Belmondo et de la Sculpture Figurative du XXè siècle,2011,ILE-DE-FRANCE,BOULOGNE-BILLANCOURT,12017,10021,22038,
Musée - Atelier Rodin (Annexe du musée de Paris),2011,ILE-DE-FRANCE,MEUDON,3758,4795,8553,
Musée de l'Île-de-France,2011,ILE-DE-FRANCE,SCEAUX,12147,20813,32960,
Maison de Victor Hugo,2011,ILE-DE-FRANCE,PARIS,25605,149545,175150,
Crypte Archéologique du Parvis Notre-Dame,2011,ILE-DE-FRANCE,PARIS,58838,125334,184172,
Musée de l'Armée,2011,ILE-DE-FRANCE,PARIS,842748,591102,1433850,
Musée du Moyen Age-Thermes et Hôtel de Cluny,2011,ILE-DE-FRANCE,PARIS,154334,163734,318068,
Etablissement public du musée d'Orsay et de l'Orangerie - Musée de l'Orangerie,2011,ILE-DE-FRANCE,PARIS,470133,226975,697108,
Musée National de la Légion d'Honneur et des Ordres de Chevalerie,2011,ILE-DE-FRANCE,PARIS,0,57856,57856,
"Petit Palais, Musée des Beaux-Arts de la ville de Paris",2011,ILE-DE-FRANCE,PARIS,116869,444484,561353,
Musée de Montmartre,2011,ILE-DE-FRANCE,PARIS,40492,3715,44207,
Mémorial du Maréchal Leclerc de Hauteclocque et de la Libération de Paris-musée Jean Moulin,2011,ILE-DE-FRANCE,PARIS,2584,15368,17952,
Institut du Monde Arabe,2011,ILE-DE-FRANCE,PARIS,134383,162491,296874,
Musée des Monnaies et des Médailles,2011,ILE-DE-FRANCE,PARIS,21437,26563,48000,
Musée Départemental de l'Ecole de Barbizon - Auberge Ganne,2011,ILE-DE-FRANCE,BARBIZON,17827,6301,24128,
Musée Municipal de Chelles Alfred Bonno,2011,ILE-DE-FRANCE,CHELLES,0,3187,3187,
Musée d'Art et d'Histoire de Melun,2011,ILE-DE-FRANCE,MELUN,612,4892,5504,
Musée Emile Jean,2011,ILE-DE-FRANCE,VILLIERS-SUR-MARNE,0,1500,1500,
Musée de la Renaissance - Château d'Ecouen,2011,ILE-DE-FRANCE,ECOUEN,15720,45180,60900,
Musée de la Ville,2011,ILE-DE-FRANCE,MONTIGNY LE BRETONNEUX,3318,11424,14742,
Muséum d'Histoire Naturelle,2011,LA REUNION,SAINT-DENIS DE LA REUNION,50152,0,50152,
Musée-Bibliothèque Pierre-André Benoît,2011,LANGUEDOC-ROUSSILLON,ALES,0,9663,9663,
Musée Léon Alègre,2011,LANGUEDOC-ROUSSILLON,BAGNOLS-SUR-CEZE,44,1401,1445,
Musée Municipal de la Vignasse,2011,LANGUEDOC-ROUSSILLON,BEAUCAIRE,1685,1653,3338,
Musée des Cultures Taurines (Annexe du Vieux Nîmes),2011,LANGUEDOC-ROUSSILLON,NIMES,891,8527,9418,
Musée Départemental d'Art Sacré du Gard,2011,LANGUEDOC-ROUSSILLON,PONT-SAINT-ESPRIT,333,9098,9431,
Musée de la Maison Romane,2011,LANGUEDOC-ROUSSILLON,SAINT-GILLES-DU-GARD,0,5603,5603,
Musée Pierre de Luxembourg,2011,LANGUEDOC-ROUSSILLON,VILLENEUVE-LES-AVIGNON,3333,2268,5601,
Musée Fleury,2011,LANGUEDOC-ROUSSILLON,LODEVE,32166,9948,42114,
Musée Paul Valéry,2011,LANGUEDOC-ROUSSILLON,SETE,45962,9563,55525,
Ecomusée du Mont Lozère,2011,LANGUEDOC-ROUSSILLON,LE PONT DE MONTVERT,2593,1971,4564,
Musée départemental d'Art Moderne,2011,LANGUEDOC-ROUSSILLON,CERET,42406,31168,73574,
Musée de Tautavel,2011,LANGUEDOC-ROUSSILLON,TAUTAVEL,59496,13653,73149,
Musée du Président Jacques Chirac,2011,LIMOUSIN,SARRAN,33723,7257,40980,
Musée Départemental d'Art Contemporain,2011,LIMOUSIN,ROCHECHOUART,7172,6044,13216,
"Musée ""au Fil du Papier""",2011,LORRAINE,PONT-A-MOUSSON,4054,1924,5978,
Musée Barrois,2011,LORRAINE,BAR-LE-DUC,2111,7666,9777,
Maison du Verre et du Cristal,2011,LORRAINE,MEISENTHAL,17948,3782,21730,
Moulin de la Blies - Musée des Techniques Faïencières,2011,LORRAINE,SARREGUEMINES,10850,15512,26362,
Musée de l'Image,2011,LORRAINE,EPINAL,21041,2402,23443,
Musée Louis Français,2011,LORRAINE,PLOMBIERES-LES-BAINS,225,225,450,
Musée Pierre Noël - Musée de la Vie dans les Hautes-Vosges,2011,LORRAINE,SAINT-DIE-DES-VOSGES,4214,10929,15143,
Musée Volcanologique Franck Arnold Perret,2011,MARTINIQUE,SAINT-PIERRE,20834,0,20834,
Musée Fenaille,2011,MIDI-PYRENEES,RODEZ,8042,10866,18908,
Musée Soulages,2011,MIDI-PYRENEES,RODEZ,0,1290,1290,
Musée des Arts et Métiers Traditionnels,2011,MIDI-PYRENEES,SALLES-LA-SOURCE,5282,1573,6855,
Musée des Jacobins,2011,MIDI-PYRENEES,AUCH,3862,6805,10667,
Musée Joseph Abeilhé,2011,MIDI-PYRENEES,MARCIAC,75,50,125,
Musée du Pays de Luchon,2011,MIDI-PYRENEES,BAGNERES-DE-LUCHON,2575,697,3272,
Musée Municipal - Musée Trésor,2011,MIDI-PYRENEES,LUZ-SAINT-SAUVEUR,0,5560,5560,
Musée Henri Martin,2011,MIDI-PYRENEES,CAHORS,3111,5962,9073,
Musée Champollion - Les Ecriture du Monde,2011,MIDI-PYRENEES,FIGEAC,37100,11713,48813,
Musée Départemental de Cuzals,2011,MIDI-PYRENEES,SAULIAC-SUR-CELE,7785,4004,11789,
Musée Municipal,2011,MIDI-PYRENEES,VAYRAC,188,0,188,
Musée Jean Jaurès,2011,MIDI-PYRENEES,CASTRES,2988,11453,14441,
Musée Goya,2011,MIDI-PYRENEES,CASTRES,13265,14687,27952,
Musée de l'Abbaye Saint-Michel,2011,MIDI-PYRENEES,GAILLAC,1962,1089,3051,
Musée Départemental du Textile,2011,MIDI-PYRENEES,LA-BASTIDE-ROUAIROUX,3536,3382,6918,
Musée du Vieil Auvillar,2011,MIDI-PYRENEES,AUVILLAR,2592,1170,3762,
Musée Ingres,2011,MIDI-PYRENEES,MONTAUBAN,16481,23786,40267,
Musée de Préhistoire,2011,MIDI-PYRENEES,SAINT-ANTONIN-NOBLE-VAL,451,0,451,
Musée de l'Ostrevant,2011,NORD-PAS-DE-CALAIS,BOUCHAIN,132,462,594,
Musée de la Chartreuse,2011,NORD-PAS-DE-CALAIS,DOUAI,6601,38011,44612,
Lieu d'Art et Action Contemporaine de Dunkerque - LAAC,2011,NORD-PAS-DE-CALAIS,DUNKERQUE,19872,0,19872,
Musée des Beaux-Arts,2011,NORD-PAS-DE-CALAIS,DUNKERQUE,8876,0,8876,
Musée du Verre,2011,NORD-PAS-DE-CALAIS,SARS-POTERIES,9754,5381,15135,
Musée des Beaux-Arts,2011,NORD-PAS-DE-CALAIS,ARRAS,11084,15392,26476,
Musée d'Histoire et d'Archéologie,2011,NORD-PAS-DE-CALAIS,HARNES,0,1277,1277,
Musée de l'Hôtel Sandelin,2011,NORD-PAS-DE-CALAIS,SAINT-OMER,3451,7500,10951,
Musée de la Bataille de Tilly-Sur-Seulles 1944,2011,BASSE-NORMANDIE,TILLY-SUR-SEULLES,628,655,1283,
Musée des Beaux-Arts,2011,BASSE-NORMANDIE,SAINT-LO,1451,5230,6681,
Musée Municipal,2011,HAUTE-NORMANDIE,BERNAY,1882,13048,14930,
Musée Municipal,2011,HAUTE-NORMANDIE,LOUVIERS Cedex,248,6600,6848,
Musée des Antiquités de la Seine-Maritime,2011,HAUTE-NORMANDIE,ROUEN,2769,25501,28270,
Musée Municipal des Ivoires,2011,HAUTE-NORMANDIE,YVETOT,1011,378,1389,
Musée du Pays de Retz,2011,PAYS DE LA LOIRE,BOURGNEUF-EN-RETZ,4250,630,4880,
Musée du Pays de Guérande et de la Porte Saint Michel,2011,PAYS DE LA LOIRE,GUERANDE,20395,7221,27616,
Muséum d'Histoire Naturelle de Nantes,2011,PAYS DE LA LOIRE,NANTES,31940,67665,99605,
Musée Joseph Denais,2011,PAYS DE LA LOIRE,BEAUFORT-EN-VALLEE,4761,5421,10182,
Musée de l'Ardoise,2011,PAYS DE LA LOIRE,TRELAZE,9854,3500,13354,
Musée des Sciences - CCSTI,2011,PAYS DE LA LOIRE,LAVAL,5012,60027,65039,
Ecomusée du Marais Breton Vendéen,2011,PAYS DE LA LOIRE,LA BARRE-DE-MONTS,18010,4713,22723,
Historial de la Vendée,2011,PAYS DE LA LOIRE,LES LUCS-SUR-BOULOGNE,32030,23739,55769,
Musée du Château,2011,PAYS DE LA LOIRE,NOIRMOUTIER-EN-L'ILE,41123,4368,45491,
Musée Municipal de Soissons,2011,PICARDIE,SOISSONS,0,27662,27662,
Musée Antoine Vivenel,2011,PICARDIE,COMPIEGNE,2017,14839,16856,
Musée Gallé-Juillet,2011,PICARDIE,CREIL,2837,5604,8441,
Musée de la Nacre et de la Tabletterie,2011,PICARDIE,MERU,14919,6896,21815,
Musée Lombart,2011,PICARDIE,DOULLENS,357,4160,4517,
Musée des Beaux-Arts,2011,POITOU-CHARENTES,ANGOULEME,4359,39575,43934,
Musée Henri Barré,2011,POITOU-CHARENTES,THOUARS,321,1325,1646,
"Musée de la Moto, de l'Automobile et du Vélo",2011,POITOU-CHARENTES,CHATELLERAULT,5168,9145,14313,
Collection d'Histoire Naturelle,2011,POITOU-CHARENTES,POITIERS,21700,31300,53000,
Musée départemental de préhistoire,2011,PROVENCE-ALPES-CÔTE D'AZUR,QUINSON,68489,8957,77446,
Musée du Vieux Sisteron,2011,PROVENCE-ALPES-CÔTE D'AZUR,SISTERON,0,571,571,
Musée archéologique,2011,PROVENCE-ALPES-CÔTE D'AZUR,VACHERES,522,404,926,
Musée de la Castre,2011,PROVENCE-ALPES-CÔTE D'AZUR,CANNES,14033,15715,29748,
Musée de la Mer,2011,PROVENCE-ALPES-CÔTE D'AZUR,CANNES,47064,35752,82816,
Musée des Beaux-Arts,2011,PROVENCE-ALPES-CÔTE D'AZUR,MENTON,0,20081,20081,
Muséum d'Histoire Naturelle,2011,PROVENCE-ALPES-CÔTE D'AZUR,NICE,0,31321,31321,
Musée Matisse,2011,PROVENCE-ALPES-CÔTE D'AZUR,NICE,0,137399,137399,
Musée d'Art et d'Histoire,2011,PROVENCE-ALPES-CÔTE D'AZUR,NICE,234,53863,54097,
Musée Picasso la guerre et la paix à Vallauris,2011,PROVENCE-ALPES-CÔTE D'AZUR,VALLAURIS,16609,10124,26733,
Musées de la Citadelle,2011,PROVENCE-ALPES-CÔTE D'AZUR,VILLEFRANCHE-SUR-MER,0,47976,47976,
Muséon Arlaten,2011,PROVENCE-ALPES-CÔTE D'AZUR,ARLES,0,5076,5076,
Musée Archéologique d'Istres René Beaucaire,2011,PROVENCE-ALPES-CÔTE D'AZUR,ISTRES,0,4251,4251,
Musée d'Archéologie Méditerranéenne,2011,PROVENCE-ALPES-CÔTE D'AZUR,MARSEILLE,26631,0,26631,
Musée de la Faïence,2011,PROVENCE-ALPES-CÔTE D'AZUR,MARSEILLE,2590,4558,7148,
Muséum d'Histoire Naturelle,2011,PROVENCE-ALPES-CÔTE D'AZUR,MARSEILLE,13007,40407,53414,
Musée Suffren et du Vieux Saint-Cannat,2011,PROVENCE-ALPES-CÔTE D'AZUR,SAINT-CANNAT,0,2631,2631,
Musée Municipal,2011,PROVENCE-ALPES-CÔTE D'AZUR,DRAGUIGNAN,0,6469,6469,
Musée des Troupes de Marine,2011,PROVENCE-ALPES-CÔTE D'AZUR,FREJUS,0,15927,15927,
Musée National de la Marine de Toulon,2011,PROVENCE-ALPES-CÔTE D'AZUR,TOULON,18549,32841,51390,
Musée d'Apt,2011,PROVENCE-ALPES-CÔTE D'AZUR,APT,2359,4444,6803,
Musée Départemental du Cartonnage et de l'Imprimerie,2011,PROVENCE-ALPES-CÔTE D'AZUR,VALREAS,3052,2140,5192,
Musée Vivarois César Filhol,2011,RHONE-ALPES,ANNONAY,874,1997,2871,
Musée des Vans,2011,RHONE-ALPES,LES VANS,466,815,1281,
Musée de Bourgoin-Jallieu,2011,RHONE-ALPES,BOURGOIN-JALLIEU,3325,8928,12253,
Musée Archéologique Grenoble Saint-Laurent,2011,RHONE-ALPES,GRENOBLE,0,34168,34168,
Conservatoire - Musée des Industries Hydroélectriques,2011,RHONE-ALPES,VAUJANY,0,8166,8166,
Musée Départemental de la Révolution Française,2011,RHONE-ALPES,VIZILLE,5154,51923,57077,
Musée Hospitalier,2011,RHONE-ALPES,CHARLIEU,3274,1734,5008,
Atelier - Musée du Chapeau,2011,RHONE-ALPES,CHAZELLES-SUR-LYON,10286,4371,14657,
Musée Folklorique du Vieux Saint-Etienne,2011,RHONE-ALPES,SAINT-ETIENNE,1288,1197,2485,
Musée de la Mine / Site Couriot,2011,RHONE-ALPES,SAINT-ETIENNE,31793,28136,59929,
Musée d'Art et d'Industrie,2011,RHONE-ALPES,SAINT-ETIENNE,30483,20055,50538,
Château de la Bastie d'Urfé,2011,RHONE-ALPES,SAINT-ETIENNE-LE-MOLARD,25737,0,25737,
Musée des Sapeurs-Pompiers de Lyon,2011,RHONE-ALPES,LYON,2909,854,3763,
Musée des Charmettes,2011,RHONE-ALPES,CHAMBERY,366,14555,14921,
Musée Municipal,2011,ST PIERRE ET MIQUELON,SAINT-PIERRE ET MIQUELON,2521,1259,3780,
Musée de la Chartreuse,2012,ALSACE,MOLSHEIM,3358,754,4112,
Musée du Fer,2012,ALSACE,REICHSHOFFEN,640,576,1216,
Musée du Château des Rohan,2012,ALSACE,SAVERNE,3737,3773,7510,
Musée d'Art Moderne et Contemporain de Strasbourg,2012,ALSACE,STRASBOURG,33072,98649,131721,
Musée de l'Œuvre Notre-Dame,2012,ALSACE,STRASBOURG,14570,29383,43953,
Musée Gallo-Romain,2012,ALSACE,BIESHEIM,422,1579,2001,
Cité du Train,2012,ALSACE,MULHOUSE,79159,7420,86579,
Musée EDF Electropolis,2012,ALSACE,MULHOUSE,27335,12816,40151,
Musée de l'Impression sur Etoffes,2012,ALSACE,MULHOUSE,17277,14987,32264,
Musée du Dolder,2012,ALSACE,RIQUEWIHR,1547,386,1933,
Musée du Papier Peint,2012,ALSACE,RIXHEIM,6573,4851,11424,
Ecomusée d'Alsace,2012,ALSACE,UNGERSHEIM,164302,10733,175035,
Musée Fernand Desmoulin,2012,AQUITAINE,BRANTOME,20544,3496,24040,
Musée Paul Reclus,2012,AQUITAINE,DOMME,139,13839,13978,
Musée de Sarlat et du Périgord Noir,2012,AQUITAINE,SARLAT-LA-CANEDA,0,12500,12500,
Musée des Beaux-Arts,2012,AQUITAINE,BORDEAUX,17483,57535,75018,
Musée de la Voiture à Cheval,2012,AQUITAINE,BOURG-SUR-GIRONDE,2587,1129,3716,
Musée Municipal du Lac,2012,AQUITAINE,SANGUINET,1208,337,1545,
Musée du Château Henri IV,2012,AQUITAINE,NERAC,17436,8425,25861,
Musée Municipal (Moulin de Gajac),2012,AQUITAINE,VILLENEUVE-SUR-LOT,3285,4011,7296,
Musée Edmond Rostand,2012,AQUITAINE,CAMBO-LES-BAINS,62353,10423,72776,
Musée National du Château,2012,AQUITAINE,PAU,65595,51281,116876,
Musée Bernadotte,2012,AQUITAINE,PAU,4736,0,4736,
Centre National du Costume de Scène et de la Scénographie,2012,AUVERGNE,MOULINS,59204,10946,70150,
Musée Rieckotter,2012,AUVERGNE,NERIS-LES-BAINS,511,646,1157,
Musée d'Art et d'Archéologie,2012,AUVERGNE,AURILLAC,1432,17491,18923,
Ecomusée de Margeride-Haute-Auvergne,2012,AUVERGNE,RUYNES-EN-MARGERIDE,9614,539,10153,
Musée de la Haute Auvergne,2012,AUVERGNE,SAINT-FLOUR,2040,2030,4070,
Musée Municipal de la Coutellerie,2012,AUVERGNE,THIERS,22569,5018,27587,
Muséum - Jardin des Sciences,2012,BOURGOGNE,DIJON,3109,75228,78337,
Musée Magnin,2012,BOURGOGNE,DIJON,6358,11592,17950,
Musée Municipal,2012,BOURGOGNE,NUITS-SAINT-GEORGES,449,4025,4474,
Musée Municipal,2012,BOURGOGNE,SEMUR-EN-AUXOIS,1031,4053,5084,
Musée du Costume,2012,BOURGOGNE,CHATEAU-CHINON,4192,2036,6228,
Musée du Grès de Puisaye,2012,BOURGOGNE,SAINT-AMAND-EN-PUISAYE,2630,0,2630,
Museum d'Histoire Naturelle Jacques de La Comble,2012,BOURGOGNE,AUTUN,1679,2073,3752,
"L'Atelier d'un Journal"" de Louhans - Musée Municipal",2012,BOURGOGNE,LOUHANS,1608,3032,4640,
Ecomusée de la Bresse Bourguignonne,2012,BOURGOGNE,PIERRE-DE-BRESSE,24258,12053,36311,
Maison du Blé et du Pain,2012,BOURGOGNE,VERDUN-SUR-LE-DOUBS,2920,1436,4356,
Musée de l'Avallonnais Jean Després,2012,BOURGOGNE,AVALLON,0,4179,4179,
Musée des Arts Naïfs et Populaires de Noyers sur Serein,2012,BOURGOGNE,NOYERS-SUR-SEREIN,2081,1179,3260,
Musée d'Art et d'Histoire du Puisaye,2012,BOURGOGNE,VILLIERS-SAINT-BENOIT,959,1328,2287,
Musée Mathurin Meheut,2012,BRETAGNE,LAMBALLE,5285,747,6032,
Ecomusée des Monts d'Arrée - Maison Cornec,2012,BRETAGNE,RIVOAL,532,5652,6184,
Musée de la Pêche,2012,BRETAGNE,CONCARNEAU,24977,4999,29976,
Musée Départemental Breton,2012,BRETAGNE,QUIMPER,20858,24413,45271,
Musée de l'Ecole Rurale en Bretagne,2012,BRETAGNE,TREGARVAN,8984,1873,10857,
Ecomusée du Pays de Rennes,2012,BRETAGNE,RENNES,18422,36357,54779,
Musée des Beaux-Arts,2012,BRETAGNE,RENNES,19376,44522,63898,
Musée d'Histoire de la Ville de Saint-Malo,2012,BRETAGNE,SAINT-MALO,16040,10760,26800,
Musée International du Long-Cours Cap-Hornier,2012,BRETAGNE,SAINT-MALO,7311,5075,12386,
Musée Saint-Nicolas,2012,BRETAGNE,VITRE,249,451,700,
Musée des Beaux-Arts,2012,CENTRE,CHARTRES,2239,2957,5196,
Muséum des Sciences Naturelles et de Préhistoire,2012,CENTRE,CHARTRES,1623,12369,13992,
Musée Marcel Proust,2012,CENTRE,ILLIERS-COMBRAY,4963,355,5318,
Musée de l'Histoire du Perche,2012,CENTRE,NOGENT-LE-ROTROU,9992,6879,16871,
Musée de la Chemiserie et de l'Elégance Masculine,2012,CENTRE,ARGENTON-SUR-CREUSE,3616,4319,7935,
Château Musée,2012,CENTRE,AZAY-LE-FERRON,12215,2859,15074,
Musée de l'Hôtel de Ville,2012,CENTRE,RICHELIEU,1070,758,1828,
Musée du Savignéen,2012,CENTRE,SAVIGNE-SUR-LATHAN,1800,390,2190,
Muséum d'Histoire Naturelle,2012,CENTRE,TOURS,6433,16541,22974,
Musée des Vins de Touraine,2012,CENTRE,TOURS,684,217,901,
Atelier Musée Louis Leygue,2012,CENTRE,NAVEIL,0,104,104,
Musée Girodet,2012,CENTRE,MONTARGIS,434,1575,2009,
Maison de l'Outil  et de la Pensée Ouvrière,2012,CHAMPAGNE-ARDENNES,TROYES,11032,3395,14427,
Musée du Cloître de Notre-Dame-en-Vaux,2012,CHAMPAGNE-ARDENNES,CHALONS-EN-CHAMPAGNE,1017,1409,2426,
Musée Saint-Rémi,2012,CHAMPAGNE-ARDENNES,REIMS,7059,24013,31072,
Musée Napoléonien,2012,CORSE,AJACCIO,6778,2245,9023,
Musée de la Maison Bonaparte,2012,CORSE,AJACCIO,43023,28444,71467,
Musée des Beaux-Arts et d'Archéologie,2012,FRANCHE-COMTE,BESANCON,3763,37124,40887,
Musée du Château des Ducs de Wurtemberg,2012,FRANCHE-COMTE,MONTBELIARD,5496,12360,17856,
Musée de Pontarlier,2012,FRANCHE-COMTE,PONTARLIER,1026,8486,9512,
Musée Georges Garret,2012,FRANCHE-COMTE,VESOUL,0,3724,3724,
Donation Maurice Jardot,2012,FRANCHE-COMTE,BELFORT,5784,0,5784,
Forge-Musée,2012,FRANCHE-COMTE,ETUEFFONT,995,961,1956,
Ecomusée Municipal d'Approuague-Kaw,2012,GUYANE,REGINA,1880,2114,3994,
Fondation Arp,2012,ILE-DE-FRANCE,CLAMART,1522,307,1829,
Musée Municipal d'Art et d'Histoire,2012,ILE-DE-FRANCE,COLOMBES,0,6995,6995,
Musée Roybet Fould,2012,ILE-DE-FRANCE,COURBEVOIE,0,10893,10893,
Musée d'Histoire Locale - Mémoire de la Ville,2012,ILE-DE-FRANCE,RUEIL-MALMAISON,0,11136,11136,
Musée National des Châteaux de Malmaison et de Bois-Préau,2012,ILE-DE-FRANCE,RUEIL-MALMAISON,42816,28567,71383,
Cité de la céramique - Sèvres & Limoges,2012,ILE-DE-FRANCE,SEVRES,31943,19187,51130,
Musée National Gustave Moreau,2012,ILE-DE-FRANCE,PARIS,20032,20873,40905,
"Petit Palais, Musée des Beaux-Arts de la ville de Paris",2012,ILE-DE-FRANCE,PARIS,61348,300955,362303,
Maison de Balzac,2012,ILE-DE-FRANCE,PARIS,1815,10333,12148,
Musée de la Franc-Maçonnerie,2012,ILE-DE-FRANCE,PARIS,19176,4842,24018,
Etablissement public du musée d'Orsay et de l'Orangerie - Musée de l'Orangerie,2012,ILE-DE-FRANCE,PARIS,590326,259642,849968,
Musée de la Chasse et de la Nature,2012,ILE-DE-FRANCE,PARIS,23325,24997,48322,
Musée Nissim de Camondo (UCAD),2012,ILE-DE-FRANCE,PARIS,38103,13866,51969,
Musée National d'Art Moderne (Centre National d'Art et de Culture Georges Pompidou),2012,ILE-DE-FRANCE,PARIS,2778493,1099560,3878053,
Musée du Château de Fontainebleau,2012,ILE-DE-FRANCE,FONTAINEBLEAU,247429,204546,451975,
Musée Municipal,2012,ILE-DE-FRANCE,MORET-SUR-LOING,0,7379,7379,
Musée de Provins et du Provinois,2012,ILE-DE-FRANCE,PROVINS,16432,5697,22129,
Musée Emile Jean,2012,ILE-DE-FRANCE,VILLIERS-SUR-MARNE,0,1930,1930,
Musée d'Art et d'Histoire Louis Senlecq,2012,ILE-DE-FRANCE,L'ISLE-ADAM,1817,6186,8003,
Musée jean-Jacques Rousseau,2012,ILE-DE-FRANCE,MONTMORENCY,3130,2362,5492,
Musée-Maison Maurice Ravel,2012,ILE-DE-FRANCE,MONTFORT-L'AMAURY,1753,0,1753,
Musée Départemental Maurice Denis,2012,ILE-DE-FRANCE,SAINT-GERMAIN-EN-LAYE,8116,20721,28837,
Musée Lambinet,2012,ILE-DE-FRANCE,VERSAILLES,19593,14865,34458,
Etablissement Public du Musée et du Domaine National de Versailles,2012,ILE-DE-FRANCE,VERSAILLES,5430917,1847828,7278745,
Musée Départemental de la Réunion - Musée Léon Dierx,2012,LA REUNION,SAINT-DENIS,3071,17676,20747,
Muséum d'Histoire Naturelle,2012,LA REUNION,SAINT-DENIS,4128,28475,32603,
Musée Historique de Villèle,2012,LA REUNION,SAINT-GILLES-LES-HAUTS,17795,22642,40437,
Eburomagus Musée Archéologique,2012,LANGUEDOC-ROUSSILLON,BRAM,1334,1170,2504,
Musée-Bibliothèque Pierre-André Benoît,2012,LANGUEDOC-ROUSSILLON,ALES,7650,18137,25787,
Musée Léon Alègre,2012,LANGUEDOC-ROUSSILLON,BAGNOLS-SUR-CEZE,19,1412,1431,
Musée Municipal de la Vignasse,2012,LANGUEDOC-ROUSSILLON,BEAUCAIRE,1560,2253,3813,
Musée Cévenol,2012,LANGUEDOC-ROUSSILLON,LE VIGAN,2397,2004,4401,
Musée des Cultures Taurines (Annexe du Vieux Nîmes),2012,LANGUEDOC-ROUSSILLON,NIMES,6089,7923,14012,
Musée des Beaux-Arts de Béziers,2012,LANGUEDOC-ROUSSILLON,BEZIERS,2326,14132,16458,
Musée du Biterrois,2012,LANGUEDOC-ROUSSILLON,BEZIERS,2423,14239,16662,
Musée du Vieux Montpellier,2012,LANGUEDOC-ROUSSILLON,MONTPELLIER,497,1896,2393,
Musée départemental d'Art Moderne,2012,LANGUEDOC-ROUSSILLON,CERET,47390,22227,69617,
Musée Hyacinthe Rigaud,2012,LANGUEDOC-ROUSSILLON,PERPIGNAN,1960,2544,4504,
Musée du Castillet Casa Pairal,2012,LANGUEDOC-ROUSSILLON,PERPIGNAN,6040,11131,17171,
Musée du Pays d'Ussel,2012,LIMOUSIN,USSEL,0,3184,3184,
Musée René Baubérot,2012,LIMOUSIN,CHATEAUPONSAC,2346,497,2843,
Muséum- Aquarium de Nancy,2012,LORRAINE,NANCY,33368,61912,95280,
Palais des ducs de Lorraine - Musée Historique Lorrain,2012,LORRAINE,NANCY,21879,52041,73920,
Musée Barrois,2012,LORRAINE,BAR-LE-DUC,2207,7355,9562,
Musée d'Art Sacré de la Meuse,2012,LORRAINE,SAINT-MIHIEL,1489,787,2276,
Musée de la Princerie,2012,LORRAINE,VERDUN,2013,2748,4761,
Maison du Verre et du Cristal,2012,LORRAINE,MEISENTHAL,17814,2030,19844,
Musée des Mines de fer de Lorraine,2012,LORRAINE,NEUFCHEF,16721,863,17584,
Musée de la Préhistoire,2012,MIDI-PYRENEES,LE MAS D'AZIL,7349,653,8002,
Musée Municipal Urbain Cabrol,2012,MIDI-PYRENEES,VILLEFRANCHE-DE-ROUERGUE,0,4793,4793,
Musée des Beaux-Arts et des Arts Décoratifs,2012,MIDI-PYRENEES,MIRANDE,513,455,968,
Musée Municipal,2012,MIDI-PYRENEES,MARTRES-TOLOSANE,1184,5306,6490,
Muséum d'Histoire Naturelle,2012,MIDI-PYRENEES,TOULOUSE,114276,93909,208185,
"Les Abattoirs, Musée d'Art Moderne et Contemporain",2012,MIDI-PYRENEES,TOULOUSE,21501,65724,87225,
Musée Georges Labit,2012,MIDI-PYRENEES,TOULOUSE,4846,13034,17880,
Muséum d'Histoire Naturelle,2012,MIDI-PYRENEES,BAGNERES-DE-BIGORRE,1078,350,1428,
Musée-château Gaston Phébus,2012,MIDI-PYRENEES,MAUVEZIN,26813,500,27313,
Musée de Préhistoire Amédée Lémozi,2012,MIDI-PYRENEES,CABRERETS,79900,0,79900,
Musée Municipal,2012,MIDI-PYRENEES,VAYRAC,227,0,227,
Musée Jean Jaurès,2012,MIDI-PYRENEES,CASTRES,2970,10842,13812,
Musée du Protestantisme en Haut-Languedoc,2012,MIDI-PYRENEES,FERRIERES,3083,1316,4399,
Muséum d'histoire naturelle Philadelphe Thomas,2012,MIDI-PYRENEES,GAILLAC,698,3216,3914,
Musée Départemental du Textile,2012,MIDI-PYRENEES,LA-BASTIDE-ROUAIROUX,3075,2929,6004,
Musée Raymond Lafage,2012,MIDI-PYRENEES,LISLE-SUR-TARN,1011,3647,4658,
Musée d'Histoire Naturelle Victor Brun,2012,MIDI-PYRENEES,MONTAUBAN,1336,6045,7381,
Musée Départemental de Flandre,2012,NORD-PAS-DE-CALAIS,CASSEL,49592,13001,62593,
Musée Départemental Matisse,2012,NORD-PAS-DE-CALAIS,LE CATEAU-CAMBRESIS,19500,46029,65529,
Palais des Beaux-Arts de Lille,2012,NORD-PAS-DE-CALAIS,LILLE,316723,0,316723,
Musée d'Histoire et d'Archéologie,2012,NORD-PAS-DE-CALAIS,HARNES,0,1016,1016,
Château de Saint-Germain de Livet,2012,BASSE-NORMANDIE,SAINT-GERMAIN DE LIVET,8829,7907,16736,
Musée de Trouville - Villa Montebello,2012,BASSE-NORMANDIE,TROUVILLE-SUR-MER,13042,0,13042,
Musée de l'Abbaye,2012,BASSE-NORMANDIE,CERISY-LA-FORET,4877,810,5687,
Musée Thomas Henry,2012,BASSE-NORMANDIE,CHERBOURG-EN-COTENTIN,0,4945,4945,
Musée Municipal,2012,BASSE-NORMANDIE,EQUEURDREVILLLE-HAINNEVILLE,0,2250,2250,
Musée des Beaux-Arts,2012,BASSE-NORMANDIE,SAINT-LO,9055,0,9055,
Musée Régional du Cidre et du Calvados,2012,BASSE-NORMANDIE,VALOGNES,4448,1344,5792,
Musée Alfred Canel,2012,HAUTE-NORMANDIE,PONT-AUDEMER,336,4658,4994,
Pavillon Flaubert,2012,HAUTE-NORMANDIE,CANTELEU,0,661,661,
Château-Musée de Dieppe,2012,HAUTE-NORMANDIE,DIEPPE,28404,11743,40147,
Musée d'Elbeuf,2012,HAUTE-NORMANDIE,ELBEUF,1330,21624,22954,
Musée des Terres-Neuvas et de la Pêche,2012,HAUTE-NORMANDIE,FECAMP,13958,28618,42576,
Musée de l'Hôtel Dubocage de Bléville,2012,HAUTE-NORMANDIE,LE HAVRE,0,6049,6049,
Musée Flaubert et d'Histoire de la Médecine,2012,HAUTE-NORMANDIE,ROUEN,3846,4156,8002,
Musée Victor Hugo,2012,HAUTE-NORMANDIE,VILLEQUIER,5714,9131,14845,
"Musée de la Fève, Crèches et Traditions Populaires",2012,PAYS DE LA LOIRE,BLAIN,1065,258,1323,
Musée du Vignoble Nantais,2012,PAYS DE LA LOIRE,LE PALLET,4364,2472,6836,
Musée du Chaume/Kerhinet - PNR Brière,2012,PAYS DE LA LOIRE,SAINT-LYPHARD,2860,104354,107214,
Ecomusée de Saint-Nazaire,2012,PAYS DE LA LOIRE,SAINT-NAZAIRE,8265,20271,28536,
Musée des Tisserands Mayennais,2012,PAYS DE LA LOIRE,AMBRIERES-LES-VALLEES,473,67,540,
Musée du Vieux Château,2012,PAYS DE LA LOIRE,LAVAL,6006,9762,15768,
Musée Vert Véron-de-Forbonnais,2012,PAYS DE LA LOIRE,LE MANS,13401,11283,24684,
Centre Minier de Faymoreau,2012,PAYS DE LA LOIRE,FAYMOREAU,16260,10592,26852,
Ecomusée du Marais Breton Vendéen,2012,PAYS DE LA LOIRE,LA BARRE-DE-MONTS,17419,6048,23467,
Musée Municipal,2012,PAYS DE LA LOIRE,LA ROCHE-SUR-YON,0,9991,9991,
Musée d'Art et d'Archéologie,2012,PICARDIE,LAON,1372,4277,5649,
Musée du Château de Compiègne,2012,PICARDIE,COMPIEGNE,32612,49667,82279,
Musée de la Figurine Historique,2012,PICARDIE,COMPIEGNE,3865,3924,7789,
Musée Gallé-Juillet,2012,PICARDIE,CREIL,2796,5757,8553,
Musée Municipal de Cognac,2012,POITOU-CHARENTES,COGNAC,1812,9429,11241,
Musée des Arts du Cognac (Annexe musée municipal),2012,POITOU-CHARENTES,COGNAC,6752,5534,12286,
Musée Napoléonien et Africain,2012,POITOU-CHARENTES,ILE D'AIX,11932,10534,22466,
Musée du Nouveau Monde,2012,POITOU-CHARENTES,LA ROCHELLE,5236,11536,16772,
Musée Archéologique,2012,POITOU-CHARENTES,SAINTES,251,37677,37928,
Musée Dupuy-Mestreau,2012,POITOU-CHARENTES,SAINTES,274,7409,7683,
Musée Municipal des Cordeliers,2012,POITOU-CHARENTES,SAINT-JEAN-D'ANGELY,271,6066,6337,
Musée d'Art et d'Histoire Georges Turpin,2012,POITOU-CHARENTES,PARTHENAY,0,8072,8072,
"Musée de la Moto, de l'Automobile et du Vélo",2012,POITOU-CHARENTES,CHATELLERAULT,4847,8307,13154,
Musée des Traditions Populaires et d'Archéologie,2012,POITOU-CHARENTES,CHAUVIGNY,7676,2889,10565,
Musée Charbonneau-Lassay,2012,POITOU-CHARENTES,LOUDUN,0,846,846,
Musée du baptistère Saint-Jean,2012,POITOU-CHARENTES,POITIERS,10950,1410,12360,
Musée départemental de préhistoire,2012,PROVENCE-ALPES-CÔTE D'AZUR,QUINSON,70254,8907,79161,
Musée archéologique,2012,PROVENCE-ALPES-CÔTE D'AZUR,VACHERES,777,259,1036,
Musée d'Histoire et d'Archéologie,2012,PROVENCE-ALPES-CÔTE D'AZUR,ANTIBES,3842,5275,9117,
Musée-Château de Cagnes,2012,PROVENCE-ALPES-CÔTE D'AZUR,CAGNES-SUR-MER,23907,7731,31638,
Villa-Musée Jean-Honoré Fragonard,2012,PROVENCE-ALPES-CÔTE D'AZUR,GRASSE,0,6203,6203,
Musée d'Art et d'Histoire de Provence,2012,PROVENCE-ALPES-CÔTE D'AZUR,GRASSE,0,21087,21087,
Musée Jean Cocteau Collection Séverin Wunderman,2012,PROVENCE-ALPES-CÔTE D'AZUR,MENTON,61139,24954,86093,
Ecomusée du Pays de la Roudoule,2012,PROVENCE-ALPES-CÔTE D'AZUR,PUGET-ROSTANG,686,6107,6793,
Musées de la Citadelle,2012,PROVENCE-ALPES-CÔTE D'AZUR,VILLEFRANCHE-SUR-MER,0,77772,77772,
Musée- Atelier de Paul Cézanne,2012,PROVENCE-ALPES-CÔTE D'AZUR,AIX-EN-PROVENCE,67373,0,67373,
Musée Départemental de l'Arles Antique,2012,PROVENCE-ALPES-CÔTE D'AZUR,ARLES,34382,77068,111450,
Musée Ciotaden,2012,PROVENCE-ALPES-CÔTE D'AZUR,LA CIOTAT,3894,3728,7622,
Musée Frédéric Mistral,2012,PROVENCE-ALPES-CÔTE D'AZUR,MAILLANE,1469,2167,3636,
Musée d'Archéologie Méditerranéenne,2012,PROVENCE-ALPES-CÔTE D'AZUR,MARSEILLE,57869,52525,110394,
Musée Suffren et du Vieux Saint-Cannat,2012,PROVENCE-ALPES-CÔTE D'AZUR,SAINT-CANNAT,0,2928,2928,
Musée Municipal Paul Lafran,2012,PROVENCE-ALPES-CÔTE D'AZUR,SAINT-CHAMAS,0,4622,4622,
Musée Départemental des Hautes-Alpes,2012,PROVENCE-ALPES-CÔTE D'AZUR,GAP,0,19108,19108,
Musée du Pays Brignolais,2012,PROVENCE-ALPES-CÔTE D'AZUR,BRIGNOLES,1537,1142,2679,
Musée Municipal,2012,PROVENCE-ALPES-CÔTE D'AZUR,DRAGUIGNAN,0,8804,8804,
Synagogue Musée Juif Comtadin,2012,PROVENCE-ALPES-CÔTE D'AZUR,CAVAILLON,2891,1089,3980,
Musée Municipal,2012,PROVENCE-ALPES-CÔTE D'AZUR,ORANGE,59316,0,59316,
Musée Départemental du Cartonnage et de l'Imprimerie,2012,PROVENCE-ALPES-CÔTE D'AZUR,VALREAS,2416,1721,4137,
Musée Archéologique,2012,RHONE-ALPES,IZERNORE,1400,1486,2886,
Musée Départemental du Revermont,2012,RHONE-ALPES,VAL-REVERMONT,2972,7080,10052,
Musée d'Histoire et d'Archéologie,2012,RHONE-ALPES,DIE,906,1838,2744,
Château de Grignan,2012,RHONE-ALPES,GRIGNAN,92602,68241,160843,
Musée d'Art Sacré,2012,RHONE-ALPES,MOURS SAINT-EUSEBE,293,521,814,
Musée International de la Chaussure,2012,RHONE-ALPES,ROMANS,18999,18660,37659,
Musée de Paléontologie,2012,RHONE-ALPES,CHILHAC,2061,162,2223,
Musée des Arts et Traditions Populaires de Haute Loire,2012,RHONE-ALPES,LAVAUDIEU,8619,645,9264,
Musée Crozatier,2012,RHONE-ALPES,LE PUY-EN-VELAY,4171,0,4171,
Musée Léon Marès,2012,RHONE-ALPES,LOVAGNY,19450,0,19450,
Musée Gallo-Romain,2012,RHONE-ALPES,AOSTE,4645,17492,22137,
Musée de Bourgoin-Jallieu,2012,RHONE-ALPES,BOURGOIN-JALLIEU,1025,8695,9720,
Musée - Parc Archéologique du Lac de Paladru,2012,RHONE-ALPES,CHARAVINES,9406,1102,10508,
Musée Archéologique Grenoble Saint-Laurent,2012,RHONE-ALPES,GRENOBLE,0,34912,34912,
Musée Matheysin,2012,RHONE-ALPES,LA MURE,711,1547,2258,
Musée de la Grande Chartreuse,2012,RHONE-ALPES,SAINT-PIERRE-DE-CHARTREUSE,41394,4319,45713,
Musée-Cloître Saint-André-Le-Bas,2012,RHONE-ALPES,VIENNE,4127,3503,7630,
Musée Départemental de la Révolution Française,2012,RHONE-ALPES,VIZILLE,3917,53331,57248,
Musée de la Soierie,2012,RHONE-ALPES,CHARLIEU,5224,1722,6946,
Musée Folklorique du Vieux Saint-Etienne,2012,RHONE-ALPES,SAINT-ETIENNE,777,1515,2292,
Musée Rural,2012,RHONE-ALPES,USSON-EN-FOREZ,3683,976,4659,
Musée Paul Dini,2012,RHONE-ALPES,VILLEFRANCHE-SUR-SAONE,8375,14981,23356,
Musée Municipal d'Albertville-Conflans,2012,RHONE-ALPES,ALBERTVILLE,2491,2369,4860,
Musée de l'Académie de La Val d'Isère,2012,RHONE-ALPES,MOÛTIERS,199,215,414,
Musée de Bouxwiller et du pays de hanau,2013,ALSACE,BOUXWILLER,5106,0,5106,
Musée de la Chartreuse,2013,ALSACE,MOLSHEIM,4105,862,4967,
Musée de l'Image Populaire de Pfaffenhoffen,2013,ALSACE,PFAFFENHOFFEN,1462,841,2303,
Musée Westercamp,2013,ALSACE,WISSEMBOURG,0,5576,5576,
Musée d'Histoire Local,2013,ALSACE,KAYSERSBERG,343,217,560,
Musée des Beaux-Arts,2013,ALSACE,MULHOUSE,0,18405,18405,
Maison du Sundgau - Musée Paysan,2013,ALSACE,OLTINGUE,895,300,1195,
Musée Paul Reclus,2013,AQUITAINE,DOMME,141,13569,13710,
Musée Gallo-Romain de Vesunna,2013,AQUITAINE,PERIGUEUX,18686,16622,35308,
Muséum d'Histoire Naturelle de Bordeaux,2013,AQUITAINE,BORDEAUX,0,24774,24774,
Musée des Arts Décoratifs,2013,AQUITAINE,BORDEAUX,8373,34716,43089,
Musée de la Voiture à Cheval,2013,AQUITAINE,BOURG-SUR-GIRONDE,1879,770,2649,
Musée Archéologique,2013,AQUITAINE,HASTINGUES,4802,5537,10339,
Musée de la Faïence et des arts de la table,2013,AQUITAINE,SAMADET,3126,2195,5321,
Musée du Liège et du Bouchon,2013,AQUITAINE,MEZIN,3919,939,4858,
Musée Municipal (Moulin de Gajac),2013,AQUITAINE,VILLENEUVE-SUR-LOT,3301,2043,5344,
Musée des Musiques Populaires - MuPop,2013,AUVERGNE,MONTLUCON,9791,7387,17178,
Musée Anne de Beaujeu,2013,AUVERGNE,MOULINS,20143,3153,23296,
Musée d'art et d'histoire Alfred Douët,2013,AUVERGNE,SAINT-FLOUR,1126,1407,2533,
Musée d'Art Sacré,2013,BOURGOGNE,DIJON,0,11383,11383,
Muséum - Jardin des Sciences,2013,BOURGOGNE,DIJON,6574,104315,110889,
Musée des Beaux-Arts,2013,BOURGOGNE,DIJON,4859,166378,171237,
Musée Municipal,2013,BOURGOGNE,NUITS-SAINT-GEORGES,406,2421,2827,
Musée de la Loire,2013,BOURGOGNE,COSNE-SUR-LOIRE,1182,3185,4367,
Museum d'Histoire Naturelle Jacques de La Comble,2013,BOURGOGNE,AUTUN,1008,1929,2937,
Musée Nicéphore Niepce,2013,BOURGOGNE,CHALON-SUR-SAONE,0,26183,26183,
Musée d'Art et d'Archéologie,2013,BOURGOGNE,CLUNY,8865,5288,14153,
Musée des Ursulines,2013,BOURGOGNE,MACON,1974,20177,22151,
Musée Eucharistique du Hiéron,2013,BOURGOGNE,PARAY-LE-MONIAL,3593,3518,7111,
Musée Départemental de Préhistoire de Solutré,2013,BOURGOGNE,SOLUTRE-POUILLY,15548,12771,28319,
Hôtel Dieu - Musée Greuze,2013,BOURGOGNE,TOURNUS,8534,2036,10570,
Musée Colette,2013,BOURGOGNE,SAINT-SAUVEUR-EN-PUISAYE,6121,1057,7178,
Musée Villeneuvien,2013,BOURGOGNE,VILLENEUVE-SUR-YONNE,0,853,853,
Musée des Beaux-Arts de Brest,2013,BRETAGNE,BREST,7847,18498,26345,
Musée National de la Marine,2013,BRETAGNE,BREST,31336,37991,69327,
Musée de Pont-Aven,2013,BRETAGNE,PONT-AVEN,393,5071,5464,
Musée des Beaux-Arts,2013,BRETAGNE,RENNES,15070,60843,75913,
Musée Saint-Nicolas,2013,BRETAGNE,VITRE,780,0,780,
Ecomusée Industriel des Forges,2013,BRETAGNE,INZINZAC-LOCHRIST,1605,1593,3198,
Musée des Meilleurs Ouvriers de France,2013,CENTRE,BOURGES,0,18298,18298,
Musée des Beaux-Arts,2013,CENTRE,CHARTRES,2085,1564,3649,
Musée des Beaux-Arts et d'Histoire Naturelle,2013,CENTRE,CHATEAUDUN,3339,5066,8405,
Musée de l'Hôtel des Communes,2013,CENTRE,AMBOISE,0,7887,7887,
Musée de l'Hôtel de Ville,2013,CENTRE,RICHELIEU,1645,589,2234,
Musée du Compagnonnage,2013,CENTRE,TOURS,26217,17016,43233,
Musée Archéologique,2013,CENTRE,THESEE,738,211,949,
Musée de la Marine de Loire,2013,CENTRE,CHATEAUNEUF-SUR-LOIRE,7403,3769,11172,
Musée Gaston Couté,2013,CENTRE,MEUNG-SUR-LOIRE,0,2264,2264,
Musée du Feutre,2013,CHAMPAGNE-ARDENNES,MOUZON,5196,2502,7698,
Musée du Temps,2013,FRANCHE-COMTE,BESANCON,5026,33934,38960,
Musée des Beaux-Arts et d'Archéologie,2013,FRANCHE-COMTE,BESANCON,12,44878,44890,
Musée de la Vigne et du Vin,2013,FRANCHE-COMTE,ARBOIS,3795,2576,6371,
Musée des Beaux-Arts,2013,FRANCHE-COMTE,LONS-LE-SAUNIER,790,2902,3692,
Musée Territorial Alexandre Franconie,2013,GUYANE,CAYENNE,2963,4813,7776,
Musée de l'Île-de-France,2013,ILE-DE-FRANCE,SCEAUX,16132,17388,33520,
MUS - Musée d'Histoire Urbaine et Sociale,2013,ILE-DE-FRANCE,SURESNES,554,5646,6200,
Musée d'Ennery,2013,ILE-DE-FRANCE,PARIS,0,2040,2040,
Musée National de la Marine,2013,ILE-DE-FRANCE,PARIS,114452,63047,177499,
Musée National Gustave Moreau,2013,ILE-DE-FRANCE,PARIS,10273,12102,22375,
Musée de l'Armée,2013,ILE-DE-FRANCE,PARIS,850889,524135,1375024,
Musée National de la Légion d'Honneur et des Ordres de Chevalerie,2013,ILE-DE-FRANCE,PARIS,0,49531,49531,
Musée de la Vie Romantique,2013,ILE-DE-FRANCE,PARIS,6455,69212,75667,
Musée Zadkine,2013,ILE-DE-FRANCE,PARIS,11928,28396,40324,
Musée des Monuments Français,2013,ILE-DE-FRANCE,PARIS,197884,221522,419406,
Musée du Service de Santé des Armées du Val-de-Grâce,2013,ILE-DE-FRANCE,PARIS,8423,9020,17443,
Musée du Quai Branly - Jacques Chirac,2013,ILE-DE-FRANCE,PARIS,334417,735042,1069459,
Musée Municipal,2013,ILE-DE-FRANCE,MORET-SUR-LOING,3776,7108,10884,
Musée départemental Stéphane Mallarmé,2013,ILE-DE-FRANCE,VULAINES-SUR-SEINE,3978,2131,6109,
Musée de l'Air et de l'Espace,2013,ILE-DE-FRANCE,LE BOURGET,136241,161544,297785,
Musée Adrien Mentienne,2013,ILE-DE-FRANCE,BRY-SUR-MARNE,0,10000,10000,
Musée d'Art et d'Histoire Louis Senlecq,2013,ILE-DE-FRANCE,L'ISLE-ADAM,2540,7177,9717,
Musée-Maison Maurice Ravel,2013,ILE-DE-FRANCE,MONTFORT-L'AMAURY,1913,0,1913,
Musée Départemental Maurice Denis,2013,ILE-DE-FRANCE,SAINT-GERMAIN-EN-LAYE,6228,22127,28355,
Musée d'Archéologie Nationale (des origines à l'an mille) - Château de st-Germain-en-Laye,2013,ILE-DE-FRANCE,SAINT-GERMAIN-EN-LAYE,18479,82743,101222,
Muséum Agricole et Industriel Stella Matutina,2013,LA REUNION,PITON-SAINT-LEU,0,15775,15775,
Musée des Beaux-Arts,2013,LANGUEDOC-ROUSSILLON,CARCASSONNE,0,49366,49366,
Musée Archéologique du Lauragais,2013,LANGUEDOC-ROUSSILLON,CASTELNAUDARY,737,959,1696,
Musée Petiet,2013,LANGUEDOC-ROUSSILLON,LIMOUX,590,2206,2796,
Musée d'Art et d'Histoire - Ensemble monumental de Narbonne,2013,LANGUEDOC-ROUSSILLON,NARBONNE,53424,544047,597471,
Musée du Colombier,2013,LANGUEDOC-ROUSSILLON,ALES,0,11858,11858,
Musée des Cultures Taurines (Annexe du Vieux Nîmes),2013,LANGUEDOC-ROUSSILLON,NIMES,850,11598,12448,
Musée Archéologique,2013,LANGUEDOC-ROUSSILLON,NIMES,0,59567,59567,
Carré d'Art Musée d'Art Contemporain de Nîmes,2013,LANGUEDOC-ROUSSILLON,NIMES,17840,23383,41223,
Musée Agathois,2013,LANGUEDOC-ROUSSILLON,AGDE,2186,1661,3847,
Musée des Beaux-Arts de Béziers,2013,LANGUEDOC-ROUSSILLON,BEZIERS,3068,16642,19710,
Musée Archéologique Paul Soyris,2013,LANGUEDOC-ROUSSILLON,MURVIEL-LES-MONTPELLIER,115,440,555,
Ecomusée du Mont Lozère,2013,LANGUEDOC-ROUSSILLON,LE PONT DE MONTVERT,3633,477,4110,
Musée Hyacinthe Rigaud,2013,LANGUEDOC-ROUSSILLON,PERPIGNAN,6631,7896,14527,
Musée Labenche d'Art et d'Histoire,2013,LIMOUSIN,BRIVE-LA-GAILLARDE,1545,35599,37144,
Musée Départemental de la Tapisserie,2013,LIMOUSIN,AUBUSSON,14247,4967,19214,
Musée d'Art et d'Archéologie,2013,LIMOUSIN,GUERET,5734,5636,11370,
Musée Municipal des Beaux-Arts de Limoges - Palais de l'Evêché,2013,LIMOUSIN,LIMOGES,9259,43875,53134,
Cité de la céramique - Sèvres & Limoges - Musée National Adrien Dubouché,2013,LIMOUSIN,LIMOGES,15658,15141,30799,
Musée Barrois,2013,LORRAINE,BAR-LE-DUC,2250,7942,10192,
Musée de la Céramique et de l'Ivoire,2013,LORRAINE,COMMERCY,1276,394,1670,
Musée Jules Bastien-Lepage - Musée de la Fortification,2013,LORRAINE,MONTMEDY,13906,3055,16961,
Musée de la Bière et du Pays de Stenay,2013,LORRAINE,STENAY,7931,11854,19785,
Musée d'Argonne,2013,LORRAINE,VARENNES-EN-ARGONNE,1587,0,1587,
Musée des Mines de fer de Lorraine,2013,LORRAINE,NEUFCHEF,17406,1336,18742,
Musée de la Lutherie et de l'Archèterie Française,2013,LORRAINE,MIRECOURT,7815,4216,12031,
Musée Louis Français,2013,LORRAINE,PLOMBIERES-LES-BAINS,159,200,359,
Musée Charles Friry,2013,LORRAINE,REMIREMONT,515,1883,2398,
Musée Charles de Bruyères,2013,LORRAINE,REMIREMONT,429,2947,3376,
Musée Départemental de l'Ariège,2013,MIDI-PYRENEES,FOIX,77938,7383,85321,
Musée de la Forge,2013,MIDI-PYRENEES,MONTGAILHARD,31848,0,31848,
"Musée des Mœurs et Coutumes, Musée du Rouergue",2013,MIDI-PYRENEES,ESPALION,1510,454,1964,
Musée des Beaux-Arts Denys Puech,2013,MIDI-PYRENEES,RODEZ,2273,8154,10427,
Musée des Jacobins,2013,MIDI-PYRENEES,AUCH,4463,11770,16233,
Musée du Pays de Luchon,2013,MIDI-PYRENEES,BAGNERES-DE-LUCHON,1477,711,2188,
Musée Paul Dupuy,2013,MIDI-PYRENEES,TOULOUSE,5547,7923,13470,
Musée-château Gaston Phébus,2013,MIDI-PYRENEES,MAUVEZIN,26425,970,27395,
Musée de Préhistoire Amédée Lémozi,2013,MIDI-PYRENEES,CABRERETS,80200,0,80200,
"Musée Archéologique ""Armand-Viré""",2013,MIDI-PYRENEES,LUZECH,386,442,828,
Musée de l'Abbaye Saint-Michel,2013,MIDI-PYRENEES,GAILLAC,1905,936,2841,
Musée Ingres,2013,MIDI-PYRENEES,MONTAUBAN,14651,23111,37762,
Lieu d'Art et Action Contemporaine de Dunkerque - LAAC,2013,NORD-PAS-DE-CALAIS,DUNKERQUE,27061,1999,29060,
Palais des Beaux-Arts de Lille,2013,NORD-PAS-DE-CALAIS,LILLE,225800,0,225800,
Château musée,2013,NORD-PAS-DE-CALAIS,BOULOGNE-SUR-MER,14933,11582,26515,
Musée de Normandie,2013,BASSE-NORMANDIE,CAEN,35234,119038,154272,
Musée d'Initiation à la Nature,2013,BASSE-NORMANDIE,CAEN,0,7297,7297,
Musée d'Ethnographie et d'Arts Populaires et Musée de la Marine,2013,BASSE-NORMANDIE,HONFLEUR,16623,1029,17652,
"Musée du Bocage Normand, ferme du bois Jugan",2013,BASSE-NORMANDIE,SAINT-LO,1566,2430,3996,
Musée Départemental des Arts et Traditions Populaires du Perche,2013,BASSE-NORMANDIE,SAINT-CYR LA ROSIERE,10182,11818,22000,
Musée Départemental d'Art Sacré,2013,BASSE-NORMANDIE,SEES,427,312,739,
Musée Municipal,2013,HAUTE-NORMANDIE,BERNAY,2448,13103,15551,
Musée Alphonse-Georges Poulain,2013,HAUTE-NORMANDIE,VERNON,4216,10033,14249,
Musée d'Elbeuf,2013,HAUTE-NORMANDIE,ELBEUF,2933,29608,32541,
Muséum d'Histoire Naturelle,2013,HAUTE-NORMANDIE,LE HAVRE,0,41945,41945,
Musée Départemental Pierre Corneille,2013,HAUTE-NORMANDIE,LE PETIT-COURONNE,725,3254,3979,
"Juliobona, Musée Gallo-Romain de Lillebonne",2013,HAUTE-NORMANDIE,LILLEBONNE,832,1436,2268,
Musée Le Secq des Tournelles,2013,HAUTE-NORMANDIE,ROUEN,4902,7315,12217,
Association de l'Horlogerie Aliermontaise,2013,HAUTE-NORMANDIE,SAINT-NICOLAS-D'ALIERMONT,5081,2382,7463,
Musée Municipal des Ivoires,2013,HAUTE-NORMANDIE,YVETOT,362,898,1260,
Musée du Pays de Retz,2013,PAYS DE LA LOIRE,BOURGNEUF-EN-RETZ,2709,388,3097,
Musée du Pays de Guérande et de la Porte Saint Michel,2013,PAYS DE LA LOIRE,GUERANDE,19615,8632,28247,
Muséum d'Histoire Naturelle de Nantes,2013,PAYS DE LA LOIRE,NANTES,23070,58485,81555,
Musée du Château des Ducs de Bretagne,2013,PAYS DE LA LOIRE,NANTES,80509,99563,180072,
Muséum des Sciences Naturelles,2013,PAYS DE LA LOIRE,ANGERS,3639,13809,17448,
Musée d'Art et d'Histoire,2013,PAYS DE LA LOIRE,BAUGE,0,6600,6600,
Musée d'Art et d'Histoire,2013,PAYS DE LA LOIRE,CHOLET,2279,15796,18075,
Musée des Tisserands Mayennais,2013,PAYS DE LA LOIRE,AMBRIERES-LES-VALLEES,369,43,412,
Musée Archéologique Départemental de Jublains,2013,PAYS DE LA LOIRE,JUBLAINS,14788,12703,27491,
Musée de l'Ardoise et de la Géologie,2013,PAYS DE LA LOIRE,RENAZE,846,275,1121,
Musée de Tessé,2013,PAYS DE LA LOIRE,LE MANS,14882,10816,25698,
Musée Espace Faïence de Malicorne,2013,PAYS DE LA LOIRE,MALICORNE-SUR-SARTHE,10786,11536,22322,
Musée Jeanne d'Aboville,2013,PICARDIE,LA FERE,218,623,841,
Musée du Château de Compiègne,2013,PICARDIE,COMPIEGNE,34519,45340,79859,
Musée de l'Archerie et de l'Art Sacré,2013,PICARDIE,CREPY-EN-VALOIS,5149,1701,6850,
Musée du Noyonnais,2013,PICARDIE,NOYON,1022,1318,2340,
Musée Boucher-de-Perthes,2013,PICARDIE,ABBEVILLE,6583,0,6583,
Musée-Historial de la Grande Guerre,2013,PICARDIE,PERONNE,58894,16346,75240,
Musée des Beaux-Arts,2013,POITOU-CHARENTES,ANGOULEME,3284,34869,38153,
Atelier - Musée du Papier,2013,POITOU-CHARENTES,ANGOULEME,902,19263,20165,
Musée de la Mytiliculture,2013,POITOU-CHARENTES,ESNANDES,2681,305,2986,
Musée Protestant,2013,POITOU-CHARENTES,LA ROCHELLE,1316,606,1922,
Musée Archéologique,2013,POITOU-CHARENTES,SAINTES,0,41081,41081,
Musée Ernest Cognacq,2013,POITOU-CHARENTES,SAINT-MARTIN-DE-RE,7504,5383,12887,
Musée Bernard d’Agesci,2013,POITOU-CHARENTES,NIORT,3845,7535,11380,
Musée du Vieux Sisteron,2013,PROVENCE-ALPES-CÔTE D'AZUR,SISTERON,0,433,433,
Musée Renoir,2013,PROVENCE-ALPES-CÔTE D'AZUR,CAGNES-SUR-MER,17152,11530,28682,
Musée de la Castre,2013,PROVENCE-ALPES-CÔTE D'AZUR,CANNES,13134,16806,29940,
Musée Bonnard,2013,PROVENCE-ALPES-CÔTE D'AZUR,LE CANNET,30397,13027,43424,
Musée des Beaux-Arts,2013,PROVENCE-ALPES-CÔTE D'AZUR,MENTON,0,22025,22025,
Muséum d'Histoire Naturelle,2013,PROVENCE-ALPES-CÔTE D'AZUR,NICE,0,33271,33271,
Musée National Marc Chagall,2013,PROVENCE-ALPES-CÔTE D'AZUR,NICE,112414,53526,165940,
Muséum d'Histoire Naturelle,2013,PROVENCE-ALPES-CÔTE D'AZUR,AIX-EN-PROVENCE,9203,32138,41341,
Musée des Tapisseries,2013,PROVENCE-ALPES-CÔTE D'AZUR,AIX-EN-PROVENCE,4825,15731,20556,
Musée- Atelier de Paul Cézanne,2013,PROVENCE-ALPES-CÔTE D'AZUR,AIX-EN-PROVENCE,58503,7569,66072,
Musée Cantini,2013,PROVENCE-ALPES-CÔTE D'AZUR,MARSEILLE,40722,59412,100134,
Musée de l'Uniforme - Musée de la Légion Etrangère,2013,PROVENCE-ALPES-CÔTE D'AZUR,PUYLOUBIER,0,8500,8500,
Musée des Alpilles,2013,PROVENCE-ALPES-CÔTE D'AZUR,SAINT-REMY-DE-PROVENCE,2916,7750,10666,
Musée Municipal,2013,PROVENCE-ALPES-CÔTE D'AZUR,DRAGUIGNAN,0,7965,7965,
Musée de l'Artillerie,2013,PROVENCE-ALPES-CÔTE D'AZUR,DRAGUIGNAN,0,6771,6771,
Musée Comtadin-Duplessis,2013,PROVENCE-ALPES-CÔTE D'AZUR,CARPENTRAS,372,2026,2398,
Musée du Brou,2013,RHONE-ALPES,BOURG-EN-BRESSE,44495,31230,75725,
Musée du Bugey-Valmorey,2013,RHONE-ALPES,LOCHIEU,2609,2808,5417,
Musée du Rhône,2013,RHONE-ALPES,TOURNON-SUR-RHÔNE,10606,8987,19593,
Musée International de la Chaussure,2013,RHONE-ALPES,ROMANS,19341,10549,29890,
Musée d'Archéologie Tricastine,2013,RHONE-ALPES,SAINT-PAUL-TROIS-CHATEAUX,2111,3434,5545,
Musée des Beaux-Arts,2013,RHONE-ALPES,VALENCE,1512,14065,15577,
Musée-château d'Annecy,2013,RHONE-ALPES,ANNECY,44430,53541,97971,
Musée Alpin,2013,RHONE-ALPES,CHAMONIX,11014,5983,16997,
Musée de la Résistance de la Déportation de l'Isère,2013,RHONE-ALPES,GRENOBLE,0,28749,28749,
Maison du Patrimoine de Hières-sur-Amby,2013,RHONE-ALPES,HIERES SUR AMBY,7293,1231,8524,
Musée-Cloître Saint-André-Le-Bas,2013,RHONE-ALPES,VIENNE,3905,4103,8008,
Musée Alice Taverne,2013,RHONE-ALPES,AMBIERLE,3375,673,4048,
Musée Folklorique et Traditions Populaires Marius Audin,2013,RHONE-ALPES,BEAUJEU,865,764,1629,
Musées Gadagne,2013,RHONE-ALPES,LYON,46636,58497,105133,
Centre d'Histoire de la Résistance et de la Déportation,2013,RHONE-ALPES,LYON,22034,42084,64118,
Musée d'Art Contemporain de Lyon,2013,RHONE-ALPES,LYON,147030,0,147030,
Musée Henri Malartre,2013,RHONE-ALPES,ROCHETAILLEE-SUR-SAONE,15419,20167,35586,
Musée Municipal d'Albertville-Conflans,2013,RHONE-ALPES,ALBERTVILLE,2317,2275,4592,
Musée des Beaux-Arts,2013,RHONE-ALPES,CHAMBERY,12464,12907,25371,
Musée des Charmettes,2013,RHONE-ALPES,CHAMBERY,0,12907,12907,
Musée de l'Académie de La Val d'Isère,2013,RHONE-ALPES,MOÛTIERS,179,183,362,
Musée Alsacien,2014,ALSACE,HAGUENAU,1136,2920,4056,
Musée de la Chartreuse,2014,ALSACE,MOLSHEIM,4119,1331,5450,
Musée de l'Image Populaire de Pfaffenhoffen,2014,ALSACE,PFAFFENHOFFEN,1304,859,2163,
Musée Zoologique de Strasbourg,2014,ALSACE,STRASBOURG,3705,19376,23081,
Musée de la Bataille du 6 Août 1870,2014,ALSACE,WOERTH,0,50,50,
Musée Gallo-Romain,2014,ALSACE,BIESHEIM,598,1414,2012,
Musée du Papier Peint,2014,ALSACE,RIXHEIM,7042,4816,11858,
Musée des Amis de Thann,2014,ALSACE,THANN,1143,851,1994,
Musée du Tabac,2014,AQUITAINE,BERGERAC,4014,1490,5504,
Musée National de la Préhistoire,2014,AQUITAINE,LES EYZIES-DE-TAYAC,41005,37852,78857,
Musée Militaire - Souvenir du Périgord,2014,AQUITAINE,PERIGUEUX,1860,1368,3228,
Musée d'Aquitaine,2014,AQUITAINE,BORDEAUX,31540,122816,154356,
CAPC Musée d'Art Contemporain de Bordeaux,2014,AQUITAINE,BORDEAUX,44565,82736,127301,
Musée des Beaux-Arts et d'Archéologie,2014,AQUITAINE,LIBOURNE,0,8385,8385,
Musée du Château Henri IV,2014,AQUITAINE,NERAC,15201,7518,22719,
Musée Municipal (Moulin de Gajac),2014,AQUITAINE,VILLENEUVE-SUR-LOT,3668,3688,7356,
Muséum d'Histoire Naturelle,2014,AQUITAINE,BAYONNE,0,23900,23900,
Musée Anne de Beaujeu,2014,AUVERGNE,MOULINS,19111,8923,28034,
Musée des Sciences,2014,AUVERGNE,AURILLAC,4609,4891,9500,
Musée de la Dentelle,2014,AUVERGNE,ARLANC,983,37,1020,
Musée d'Art Roger-Quillot,2014,AUVERGNE,CLERMONT-FERRAND,6492,26818,33310,
Musée Départemental de la Céramique Gallo-Romaine,2014,AUVERGNE,LEZOUX,8485,4839,13324,
Musée des Pénitents Blancs,2014,AUVERGNE,MARSAC-EN-LIVRADOIS,254,27,281,
Musée Alésia - Centre d'Interprétation,2014,BOURGOGNE,ALISE-SAINTE-REINE,69949,19318,89267,
"Musée de la Vie Bourguignonne, Perrin de Puycousin",2014,BOURGOGNE,DIJON,0,33358,33358,
Musée Archéologique,2014,BOURGOGNE,DIJON,0,29833,29833,
Musée Noisot,2014,BOURGOGNE,FIXIN,327,215,542,
Musée Buffon,2014,BOURGOGNE,MONTBARD,0,11256,11256,
Musée Municipal François Pompon,2014,BOURGOGNE,SAULIEU,2788,5523,8311,
Musée Municipal,2014,BOURGOGNE,SEMUR-EN-AUXOIS,1404,5319,6723,
Musée d'Art et d'Histoire Romain Rolland,2014,BOURGOGNE,CLAMECY,2451,2428,4879,
Musée du Grès de Puisaye,2014,BOURGOGNE,SAINT-AMAND-EN-PUISAYE,1863,0,1863,
Musée Auguste Grasset,2014,BOURGOGNE,VARZY,2400,0,2400,
Musée Saint-Nazaire,2014,BOURGOGNE,BOURBON-LANCY,0,1598,1598,
Ecomusée de la Communauté Le Creusot-Monceau-Les-Mines,2014,BOURGOGNE,LE CREUSOT,3863,8201,12064,
Musée Lamartine,2014,BOURGOGNE,MACON,1440,4032,5472,
Musée Leblanc-Duvernois,2014,BOURGOGNE,AUXERRE,0,1049,1049,
Musée de l'Aventure du Son,2014,BOURGOGNE,SAINT-FARGEAU,3628,396,4024,
Ecomusée des Monts d'Arrée - Maison Cornec,2014,BRETAGNE,RIVOAL,1201,3698,4899,
Musée de l'Ecole Rurale en Bretagne,2014,BRETAGNE,TREGARVAN,1536,616,2152,
Ecomusée du Pays de Rennes,2014,BRETAGNE,RENNES,14326,42581,56907,
Musée des Beaux-Arts,2014,BRETAGNE,RENNES,20126,65162,85288,
Musée de Bretagne,2014,BRETAGNE,RENNES,18428,42992,61420,
Ecomusée de l'Île de Groix,2014,BRETAGNE,ILE DE GROIX,3862,933,4795,
Musée d'Histoire Naturelle Gabriel Foucher,2014,CENTRE,BOURGES,15321,19811,35132,
Muséum des Sciences Naturelles et de Préhistoire,2014,CENTRE,CHARTRES,852,15812,16664,
Muséum d'Histoire Naturelle,2014,CENTRE,BLOIS,6737,6664,13401,
Château Musées de Blois,2014,CENTRE,BLOIS,234669,34834,269503,
Musée Municipal Théâtre Forain et Archéologique,2014,CENTRE,ARTENAY,7648,3138,10786,
Maison de l'Outil  et de la Pensée Ouvrière,2014,CHAMPAGNE-ARDENNES,TROYES,9106,5437,14543,
Musée de la Coutellerie,2014,CHAMPAGNE-ARDENNES,NOGENT,3188,1770,4958,
Musée du Cloître de Notre-Dame-en-Vaux,2014,CHAMPAGNE-ARDENNES,CHALONS-EN-CHAMPAGNE,1072,1759,2831,
Musée Saint-Rémi,2014,CHAMPAGNE-ARDENNES,REIMS,4369,29071,33440,
Muséum de Besançon,2014,FRANCHE-COMTE,BESANCON,299168,0,299168,
Musée Départemental Albert-et-Félicie Demard - ATP,2014,FRANCHE-COMTE,CHAMPLITTE,6280,4889,11169,
Ecomusée du Pays de la Cerise,2014,FRANCHE-COMTE,FOUGEROLLES,7471,2179,9650,
Musée Sarret de Grozon,2014,FRANCHE-COMTE,ARBOIS,291,2217,2508,
Musée du Jouet,2014,FRANCHE-COMTE,MOIRANS-EN-MONTAGNE,47105,18976,66081,
Viséum-Musée de la Lunette,2014,FRANCHE-COMTE,MOREZ HAUTS DE BIENNE,10365,4703,15068,
Musée de l'Artisanat Jurassien,2014,FRANCHE-COMTE,VOITEUR,0,17771,17771,
Musée Municipal Saint-John Perse,2014,GUADELOUPE,POINTE-A-PITRE,2240,960,3200,
Musée Français de la Photographie,2014,ILE-DE-FRANCE,BIEVRES,2446,6128,8574,
Musée des Années Trente,2014,ILE-DE-FRANCE,BOULOGNE-BILLANCOURT,12222,12259,24481,
Musée Municipal d'Art et d'Histoire,2014,ILE-DE-FRANCE,COLOMBES,0,7070,7070,
Musée du Domaine Départemental de Sceaux,2014,ILE-DE-FRANCE,SCEAUX,21421,21632,43053,
Galerie de Botanique (Muséum National National d'Histoire Naturelle),2014,ILE-DE-FRANCE,PARIS,8069,9823,17892,
Musée de la Vie Romantique,2014,ILE-DE-FRANCE,PARIS,7359,67834,75193,
Musée de la Musique,2014,ILE-DE-FRANCE,PARIS,125789,44834,170623,
Etablissement public de la Porte Dorée - Aquarium Tropical,2014,ILE-DE-FRANCE,PARIS,181998,81520,263518,
Musée National des Techniques,2014,ILE-DE-FRANCE,PARIS,89424,153455,242879,
Musée National d'Art Moderne (Centre National d'Art et de Culture Georges Pompidou),2014,ILE-DE-FRANCE,PARIS,2517861,1002502,3520363,
Musée Départemental de l'Ecole de Barbizon - Auberge Ganne,2014,ILE-DE-FRANCE,BARBIZON,15618,8336,23954,
Musée d'Art et d'Histoire de Melun,2014,ILE-DE-FRANCE,MELUN,506,5937,6443,
Ecomusée,2014,ILE-DE-FRANCE,SAVIGNY-LE-TEMPLE,466,3258,3724,
Ecomusée du Val de Bièvre,2014,ILE-DE-FRANCE,FRESNES,0,10120,10120,
"MAC VAL, Musée d'Art Contemporain du Val-de-Marne",2014,ILE-DE-FRANCE,VITRY SUR SEINE,8237,58425,66662,
Musée de la Renaissance - Château d'Ecouen,2014,ILE-DE-FRANCE,ECOUEN,16243,39843,56086,
Musée Archéologique du Val d'Oise,2014,ILE-DE-FRANCE,GUIRY-EN-VEXIN,2504,10205,12709,
Musée de la Toile de Jouy,2014,ILE-DE-FRANCE,JOUY-EN-JOSAS,8259,2471,10730,
Musée du Jouet Pierre Pinel,2014,ILE-DE-FRANCE,POISSY,13377,6267,19644,
Musée Municipal - Collections Paul et André Véra,2014,ILE-DE-FRANCE,SAINT-GERMAIN-EN-LAYE,432,2826,3258,
Musée Départemental Maurice Denis,2014,ILE-DE-FRANCE,SAINT-GERMAIN-EN-LAYE,6091,20652,26743,
Musée d'Archéologie Nationale (des origines à l'an mille) - Château de st-Germain-en-Laye,2014,ILE-DE-FRANCE,SAINT-GERMAIN-EN-LAYE,22361,90662,113023,
Collections de la Fondation de Coubertin,2014,ILE-DE-FRANCE,SAINT-REMY-LES-CHEVREUSE,1140,509,1649,
Musée des Arts Décoratifs de l’Océan indien (MADOI),2014,LA REUNION,SAINT-LOUIS,8220,1697,9917,
Eburomagus Musée Archéologique,2014,LANGUEDOC-ROUSSILLON,BRAM,985,1213,2198,
Musée des Beaux-Arts,2014,LANGUEDOC-ROUSSILLON,CARCASSONNE,0,73579,73579,
Musée Petiet,2014,LANGUEDOC-ROUSSILLON,LIMOUX,900,1745,2645,
Musée des Beaux-Arts,2014,LANGUEDOC-ROUSSILLON,NIMES,894,14274,15168,
Musée de la Maison Romane,2014,LANGUEDOC-ROUSSILLON,SAINT-GILLES-DU-GARD,1010,1853,2863,
Musée de l'Ephèbe,2014,LANGUEDOC-ROUSSILLON,LE CAP D'AGDE,9563,6473,16036,
Musée de Vulliod Saint-Germain,2014,LANGUEDOC-ROUSSILLON,PEZENAS,4467,3085,7552,
Musée d'Art Moderne - Fonds Peskè,2014,LANGUEDOC-ROUSSILLON,COLLIOURE,9967,2918,12885,
Muséum d'Histoire Naturelle,2014,LANGUEDOC-ROUSSILLON,PERPIGNAN,0,11716,11716,
Musée de Tautavel,2014,LANGUEDOC-ROUSSILLON,TAUTAVEL,54680,9714,64394,
Cité de la céramique - Sèvres & Limoges - Musée National Adrien Dubouché,2014,LIMOUSIN,LIMOGES,16593,17013,33606,
Musée Départemental d'Art Contemporain,2014,LIMOUSIN,ROCHECHOUART,7958,5918,13876,
Musée du Château de Lunéville,2014,LORRAINE,LUNEVILLE,0,150188,150188,
Musée de l'Ecole de Nancy,2014,LORRAINE,NANCY,24359,30862,55221,
Musée des Beaux-Arts de Nancy,2014,LORRAINE,NANCY,40684,60734,101418,
Musée Départemental de la Guerre de 70,2014,LORRAINE,GRAVELOTTE,18998,11088,30086,
Maison du Verre et du Cristal,2014,LORRAINE,MEISENTHAL,15131,2959,18090,
Musée de la Mine - Carreau Wendel,2014,LORRAINE,PETITE-ROSSELLE,41228,7029,48257,
Moulin de la Blies - Musée des Techniques Faïencières,2014,LORRAINE,SARREGUEMINES,12908,10237,23145,
Musée Charles de Bruyères,2014,LORRAINE,REMIREMONT,609,2991,3600,
Musée de La Canne,2014,MARTINIQUE,LES TROIS ILETS,8615,2472,11087,
Ecomusée de la Martinique,2014,MARTINIQUE,RIVIERE-PILOTE,5555,3335,8890,
Musée de la Préhistoire,2014,MIDI-PYRENEES,LE MAS D'AZIL,13761,911,14672,
Musée Joseph Vaylet,2014,MIDI-PYRENEES,ESPALION,2287,2215,4502,
Musée Municipal de Millau,2014,MIDI-PYRENEES,MILLAU,8927,8052,16979,
Musée Soulages,2014,MIDI-PYRENEES,RODEZ,150089,55101,205190,
Musée Joseph Abeilhé,2014,MIDI-PYRENEES,MARCIAC,25,15,40,
Musée des Beaux-Arts et des Arts Décoratifs,2014,MIDI-PYRENEES,MIRANDE,519,90,609,
Musée Municipal,2014,MIDI-PYRENEES,MARTRES-TOLOSANE,469,5300,5769,
Musée Archéologique Départemental,2014,MIDI-PYRENEES,SAINT-BERTRAND-DE-COMMINGES,0,58249,58249,
Musée des Transports et des Communications,2014,MIDI-PYRENEES,TOULOUSE,0,1748,1748,
Musée Départemental de Cuzals,2014,MIDI-PYRENEES,SAULIAC-SUR-CELE,7096,3353,10449,
Musée Eugénie et Maurice Guérin,2014,MIDI-PYRENEES,ANDILLAC,1852,2485,4337,
Musée du Protestantisme en Haut-Languedoc,2014,MIDI-PYRENEES,FERRIERES,2251,777,3028,
Musée de l'Abbaye Saint-Michel,2014,MIDI-PYRENEES,GAILLAC,1449,1422,2871,
Musée Théodore Calbet,2014,MIDI-PYRENEES,GRISOLLES,0,1645,1645,
Musée d'Archéologie et d'Histoire Locale,2014,NORD-PAS-DE-CALAIS,DENAIN,0,4300,4300,
Lieu d'Art et Action Contemporaine de Dunkerque - LAAC,2014,NORD-PAS-DE-CALAIS,DUNKERQUE,10542,11267,21809,
Musée Portuaire,2014,NORD-PAS-DE-CALAIS,DUNKERQUE,29857,24081,53938,
Ecomusée de la Région,2014,NORD-PAS-DE-CALAIS,FOURMIES,19869,11573,31442,
Musée du Dessin et de l'Estampe Originale,2014,NORD-PAS-DE-CALAIS,GRAVELINES,1669,10425,12094,
Musée de l'Hospice Comtesse,2014,NORD-PAS-DE-CALAIS,LILLE,29556,22200,51756,
Palais des Beaux-Arts de Lille,2014,NORD-PAS-DE-CALAIS,LILLE,129994,134682,264676,
Musée d'Histoire Locale de Marchiennes,2014,NORD-PAS-DE-CALAIS,MARCHIENNES,157,1523,1680,
Musée Quentovic,2014,NORD-PAS-DE-CALAIS,ETAPLES-SUR-MER,4700,0,4700,
Musée Municipal Bruno Danvin,2014,NORD-PAS-DE-CALAIS,SAINT-POL-SUR-TERNOISE,0,4350,4350,
Musée Jean-Charles Cazin,2014,NORD-PAS-DE-CALAIS,SAMER,0,613,613,
Musée du Débarquement,2014,BASSE-NORMANDIE,ARROMANCHES,335258,15303,350561,
Musée d'Ethnographie et d'Arts Populaires et Musée de la Marine,2014,BASSE-NORMANDIE,HONFLEUR,17851,244,18095,
Musée de la Mine,2014,BASSE-NORMANDIE,LE MOLAY-LITTRY,3297,894,4191,
Musée du Château,2014,BASSE-NORMANDIE,PONTECOULANT,3076,1032,4108,
Musée Quesnel-Morinière,2014,BASSE-NORMANDIE,COUTANCES,244,5782,6026,
Musée des Beaux-Arts,2014,BASSE-NORMANDIE,SAINT-LO,7229,0,7229,
"Musée du Bocage Normand, ferme du bois Jugan",2014,BASSE-NORMANDIE,SAINT-LO,1341,3563,4904,
Musée Maritime de l'Ile de Tatihou,2014,BASSE-NORMANDIE,SAINT-VAAST-LA-HOUGUE,58490,4457,62947,
Musée de la Poeslerie,2014,BASSE-NORMANDIE,VILLEDIEU-LES-POELES-ROUFFIGNY,6757,376,7133,
Musée Municipal d'Archéologie,2014,BASSE-NORMANDIE,L'AIGLE,832,419,1251,
Musée Départemental des Arts et Traditions Populaires du Perche,2014,BASSE-NORMANDIE,SAINT-CYR LA ROSIERE,11765,11540,23305,
Musée Municipal Nicolas Poussin,2014,HAUTE-NORMANDIE,LES ANDELYS,1850,1307,3157,
Pavillon Flaubert,2014,HAUTE-NORMANDIE,CANTELEU,0,828,828,
Château-Musée de Dieppe,2014,HAUTE-NORMANDIE,DIEPPE,14771,9544,24315,
Musée du Prieuré,2014,HAUTE-NORMANDIE,HARFLEUR,112,4186,4298,
La Maison de l'Armateur,2014,HAUTE-NORMANDIE,LE HAVRE,7152,9003,16155,
Musée Industriel de la Corderie Vallois,2014,HAUTE-NORMANDIE,NOTRE-DAME-DE-BONDEVILLE,2184,6823,9007,
MUNAE - Musée National de l'Education,2014,HAUTE-NORMANDIE,ROUEN,230,4579,4809,
Muséum d'Histoire Naturelle,2014,HAUTE-NORMANDIE,ROUEN,5516,30871,36387,
Musée Victor Hugo,2014,HAUTE-NORMANDIE,VILLEQUIER,4960,7543,12503,
Musée du Pays de Retz,2014,PAYS DE LA LOIRE,BOURGNEUF-EN-RETZ,2765,736,3501,
Musée du Pays de Guérande et de la Porte Saint Michel,2014,PAYS DE LA LOIRE,GUERANDE,19747,9393,29140,
Musée d'Art et d'Histoire,2014,PAYS DE LA LOIRE,BAUGE,0,5876,5876,
Musée Joseph Denais,2014,PAYS DE LA LOIRE,BEAUFORT-EN-VALLEE,6425,2697,9122,
Musée du Textile,2014,PAYS DE LA LOIRE,CHOLET,5048,6368,11416,
Musée d'Art et d'Archéologie Hôtel Fouquet,2014,PAYS DE LA LOIRE,CHATEAU-GONTIER,213,1085,1298,
Musée Communal Robert Tatin,2014,PAYS DE LA LOIRE,COSSE-LE-VIVIEN,17818,9158,26976,
Musée Archéologique Départemental de Jublains,2014,PAYS DE LA LOIRE,JUBLAINS,18258,11284,29542,
Musée des Sciences - CCSTI,2014,PAYS DE LA LOIRE,LAVAL,5966,45000,50966,
Musée du Château de Mayenne,2014,PAYS DE LA LOIRE,MAYENNE,11137,7796,18933,
Musée Vert Véron-de-Forbonnais,2014,PAYS DE LA LOIRE,LE MANS,13340,8107,21447,
Musée de la Reine Bérengère,2014,PAYS DE LA LOIRE,LE MANS,2098,9916,12014,
Historial de la Vendée,2014,PAYS DE LA LOIRE,LES LUCS-SUR-BOULOGNE,34772,38461,73233,
Musée Franco-Américain du Château de Blérancourt,2014,PICARDIE,BLERANCOURT,686,813,1499,
Musée Jean de la Fontaine,2014,PICARDIE,CHATEAU-THIERRY,11956,2216,14172,
Musée Jeanne d'Aboville,2014,PICARDIE,LA FERE,322,1041,1363,
Musée Départemental de l'Oise,2014,PICARDIE,BEAUVAIS,0,30686,30686,
Musée Gallé-Juillet,2014,PICARDIE,CREIL,1710,6069,7779,
Musée de l'Archerie et de l'Art Sacré,2014,PICARDIE,CREPY-EN-VALOIS,4013,2014,6027,
Musée de la Nacre et de la Tabletterie,2014,PICARDIE,MERU,15094,4925,20019,
Musée Archéologique de l'Oise,2014,PICARDIE,VENDEUIL-CAPLY,4391,2462,6853,
Musée des Beaux-Arts,2014,POITOU-CHARENTES,LA ROCHELLE,3747,12490,16237,
Musée National de la Marine & Ancienne école de médecine navale,2014,POITOU-CHARENTES,ROCHEFORT,18341,18329,36670,
Musée Dupuy-Mestreau,2014,POITOU-CHARENTES,SAINTES,0,2783,2783,
Musée Municipal des Cordeliers,2014,POITOU-CHARENTES,SAINT-JEAN-D'ANGELY,576,6432,7008,
Musée Henri Barré,2014,POITOU-CHARENTES,THOUARS,401,1771,2172,
Musée de Préhistoire Raymond Touchard,2014,POITOU-CHARENTES,LUSSAC-LES-CHATEAUX,3243,4373,7616,
Musée départemental de préhistoire,2014,PROVENCE-ALPES-CÔTE D'AZUR,QUINSON,58502,9915,68417,
Musée du Vieux Sisteron,2014,PROVENCE-ALPES-CÔTE D'AZUR,SISTERON,0,444,444,
Muséum d'Histoire Naturelle,2014,PROVENCE-ALPES-CÔTE D'AZUR,NICE,0,29527,29527,
Musée National Marc Chagall,2014,PROVENCE-ALPES-CÔTE D'AZUR,NICE,106900,52054,158954,
Musée du Vieux-Logis de Nice,2014,PROVENCE-ALPES-CÔTE D'AZUR,NICE,0,277,277,
Musée des Beaux-Arts Jules Chéret,2014,PROVENCE-ALPES-CÔTE D'AZUR,NICE,0,40318,40318,
Musée du Palais Lascaris,2014,PROVENCE-ALPES-CÔTE D'AZUR,NICE,0,93178,93178,
Musée Matisse,2014,PROVENCE-ALPES-CÔTE D'AZUR,NICE,0,173128,173128,
Musée d'Art et d'Histoire,2014,PROVENCE-ALPES-CÔTE D'AZUR,NICE,0,51063,51063,
Musée d'Art Moderne et d'Art Contemporain,2014,PROVENCE-ALPES-CÔTE D'AZUR,NICE,0,158714,158714,
Musée du Parlement de Provence et du Vieil Aix,2014,PROVENCE-ALPES-CÔTE D'AZUR,AIX-EN-PROVENCE,0,29689,29689,
Musée Camarguais,2014,PROVENCE-ALPES-CÔTE D'AZUR,ARLES,14835,5427,20262,
Musée de l'Uniforme - Musée de la Légion Etrangère,2014,PROVENCE-ALPES-CÔTE D'AZUR,PUYLOUBIER,0,9454,9454,
Musée Cantini,2014,PROVENCE-ALPES-CÔTE D'AZUR,MARSEILLE,22178,21334,43512,
Musée de l'Empéri de Salon et de la Crau,2014,PROVENCE-ALPES-CÔTE D'AZUR,SALON-DE-PROVENCE,0,45346,45346,
Musée des tourneurs sur Bois,2014,PROVENCE-ALPES-CÔTE D'AZUR,AIGUINES,3151,1088,4239,
Musée de l'Annonciade,2014,PROVENCE-ALPES-CÔTE D'AZUR,SAINT-TROPEZ,31614,6633,38247,
Musée National de la Marine de Toulon,2014,PROVENCE-ALPES-CÔTE D'AZUR,TOULON,21853,35086,56939,
Musée Comtadin-Duplessis,2014,PROVENCE-ALPES-CÔTE D'AZUR,CARPENTRAS,441,2370,2811,
Musée Sobirats,2014,PROVENCE-ALPES-CÔTE D'AZUR,CARPENTRAS,404,1407,1811,
Musée-Bibliothèque François Pétrarque,2014,PROVENCE-ALPES-CÔTE D'AZUR,FONTAINE-DE-VAUCLUSE,2146,1022,3168,
Musée Archéologique Théo Desplans,2014,PROVENCE-ALPES-CÔTE D'AZUR,VAISON-LA-ROMAINE,66615,16047,82662,
Musée de la Résistance et de la Déportation de l'Ain,2014,RHONE-ALPES,NANTUA,7149,4270,11419,
Cité de Préhistoire,2014,RHONE-ALPES,ORGNAC-L'AVEN,131832,11321,143153,
Musée d'Art Sacré,2014,RHONE-ALPES,MOURS SAINT-EUSEBE,568,0,568,
Musée International de la Chaussure,2014,RHONE-ALPES,ROMANS,19981,11437,31418,
Musée-château d'Annecy,2014,RHONE-ALPES,ANNECY,80009,31675,111684,
Musée du Chablais,2014,RHONE-ALPES,THONON-LES-BAINS,4839,0,4839,
Musée Jadis Allevard,2014,RHONE-ALPES,ALLEVARD-LES-BAINS,2859,3051,5910,
Musée de Bourgoin-Jallieu,2014,RHONE-ALPES,BOURGOIN-JALLIEU,2991,6088,9079,
Musée - Parc Archéologique du Lac de Paladru,2014,RHONE-ALPES,CHARAVINES,4333,1598,5931,
Musée de la Résistance de la Déportation de l'Isère,2014,RHONE-ALPES,GRENOBLE,0,28217,28217,
Maison du Patrimoine de Hières-sur-Amby,2014,RHONE-ALPES,HIERES SUR AMBY,6253,1722,7975,
Musée Hébert,2014,RHONE-ALPES,LA TRONCHE,0,27286,27286,
Conservatoire - Musée des Industries Hydroélectriques,2014,RHONE-ALPES,VAUJANY,0,452,452,
Musée Lucien Mainssieux,2014,RHONE-ALPES,VOIRON,0,5498,5498,
Musée de la Soierie,2014,RHONE-ALPES,CHARLIEU,4172,1621,5793,
Château de la Bastie d'Urfé,2014,RHONE-ALPES,SAINT-ETIENNE-LE-MOLARD,8483,19779,28262,
Musée de l'Imprimerie et de la Communication Graphique,2014,RHONE-ALPES,LYON,13942,8309,22251,
Musée d'Art Contemporain de Lyon,2014,RHONE-ALPES,LYON,39212,45853,85065,
Musée Paul Dini,2014,RHONE-ALPES,VILLEFRANCHE-SUR-SAONE,5020,18777,23797,
Musée Savoisien,2014,RHONE-ALPES,CHAMBERY,2281,23046,25327,
Musée des Charmettes,2014,RHONE-ALPES,CHAMBERY,0,14618,14618,
Musée de la Chartreuse,2015,ALSACE,MOLSHEIM,4119,1318,5437,
Musée de l'Image Populaire de Pfaffenhoffen,2015,ALSACE,PFAFFENHOFFEN,1255,817,2072,
Musée du Fer,2015,ALSACE,REICHSHOFFEN,1474,673,2147,
Musée des Arts Décoratifs,2015,ALSACE,STRASBOURG,29875,31243,61118,
Musée des Beaux-Arts,2015,ALSACE,STRASBOURG,32920,41059,73979,
Musée Tomi Ungerer,2015,ALSACE,STRASBOURG,22853,25758,48611,
Musée Westercamp,2015,ALSACE,WISSEMBOURG,0,4472,4472,
Musée Sundgauvien d'Altkirch,2015,ALSACE,ALTKIRCH,625,3151,3776,
Musée de la Porte de Thann,2015,ALSACE,CERNAY,225,141,366,
Musée Historique,2015,ALSACE,MULHOUSE,0,32426,32426,
Maison du Sundgau - Musée Paysan,2015,ALSACE,OLTINGUE,826,366,1192,
Musée du Papier Peint,2015,ALSACE,RIXHEIM,5571,5000,10571,
Musée du Tabac,2015,AQUITAINE,BERGERAC,4213,1275,5488,
Musée Fernand Desmoulin,2015,AQUITAINE,BRANTOME,19490,2716,22206,
Musée d'Art et d'Archéologie du Périgord (MAAP),2015,AQUITAINE,PERIGUEUX,6784,15673,22457,
Muséum d'Histoire Naturelle de Bordeaux,2015,AQUITAINE,BORDEAUX,0,14392,14392,
Musée de la Voiture à Cheval. Au temps des calèches,2015,AQUITAINE,BOURG-SUR-GIRONDE,1865,1207,3072,
Musée Départemental d'Histoire et d'Archéologie,2015,AQUITAINE,HASTINGUES,4759,5798,10557,
Ecomusée de la Grande Lande,2015,AQUITAINE,SABRES,70914,17076,87990,
Musée Municipal du Lac,2015,AQUITAINE,SANGUINET,2545,790,3335,
Musée de Préhistoire Mésolithique Laurent Coulonges,2015,AQUITAINE,SAUVETERRE-LA-LEMANCE,2375,334,2709,
Musée Edmond Rostand,2015,AQUITAINE,CAMBO-LES-BAINS,81356,10059,91415,
Musée Anne de Beaujeu,2015,AUVERGNE,MOULINS,10428,13207,23635,
Musée d'Art et d'Archéologie,2015,AUVERGNE,AURILLAC,1059,16303,17362,
Musée de Paléontologie,2015,AUVERGNE,CHILHAC,2183,121,2304,
Musée des Pénitents Blancs,2015,AUVERGNE,MARSAC-EN-LIVRADOIS,192,81,273,
Musée Paléontologique,2015,AUVERGNE,MENAT,382,122,504,
Musée Francisque Mandet,2015,AUVERGNE,RIOM,3324,10462,13786,
Musée Régional d'Auvergne,2015,AUVERGNE,RIOM,369,2098,2467,
"Musée de la Vie Bourguignonne, Perrin de Puycousin",2015,BOURGOGNE,DIJON,0,33502,33502,
Musée Magnin,2015,BOURGOGNE,DIJON,6798,10314,17112,
Musée des Beaux-Arts,2015,BOURGOGNE,DIJON,0,163381,163381,
"L'Atelier d'un Journal"" de Louhans - Musée Municipal",2015,BOURGOGNE,LOUHANS,1675,3360,5035,
Musée Départemental de Préhistoire de Solutré,2015,BOURGOGNE,SOLUTRE-POUILLY,10133,12094,22227,
Hôtel Dieu - Musée Greuze,2015,BOURGOGNE,TOURNUS,7331,2549,9880,
Musée Colette,2015,BOURGOGNE,SAINT-SAUVEUR-EN-PUISAYE,5148,1372,6520,
Musée d'Art et d'Histoire du Puisaye,2015,BOURGOGNE,VILLIERS-SAINT-BENOIT,534,1059,1593,
Musée d'Art et d'Histoire,2015,BRETAGNE,SAINT-BRIEUC,0,23837,23837,
Ecomusée de l'Île d'Ouessant,2015,BRETAGNE,OUESSANT,6957,1872,8829,
Musée de Pont-Aven,2015,BRETAGNE,PONT-AVEN,408,5132,5540,
Ecomusée du Pays de Rennes,2015,BRETAGNE,RENNES,15430,42757,58187,
Musée de la Compagnie des Indes,2015,BRETAGNE,PORT-LOUIS,39756,30292,70048,
"La Cohue, Musée des Beaux-Arts de vannes (+ espace d'expositions)",2015,BRETAGNE,VANNES,7078,131992,139070,
Musée des Meilleurs Ouvriers de France,2015,CENTRE,BOURGES,0,18254,18254,
Musée d'Histoire Naturelle Gabriel Foucher,2015,CENTRE,BOURGES,14802,15419,30221,
Musée Départemental Pascal Paoli,2015,CENTRE,MOROSAGLIA,5300,1270,6570,
Musée Archéologique d'Argentomagus,2015,CENTRE,SAINT-MARCEL,6706,5828,12534,
Musée Balzac,2015,CENTRE,SACHE,12857,7419,20276,
Muséum d'Histoire Naturelle,2015,CENTRE,BLOIS,5671,6334,12005,
Musée de la Corbillière,2015,CENTRE,MER,0,1695,1695,
Atelier Musée Louis Leygue,2015,CENTRE,NAVEIL,0,58,58,
Musée Municipal Théâtre Forain et Archéologique,2015,CENTRE,ARTENAY,7625,2687,10312,
Musée des Beaux-Arts,2015,CENTRE,ORLEANS,8115,42568,50683,
Musée de la Maison de la Dernière Cartouche,2015,CHAMPAGNE-ARDENNES,BAZEILLES,924,724,1648,
Musée d'Art Moderne,2015,CHAMPAGNE-ARDENNES,TROYES,12046,20326,32372,
Pharmacie Musée de l'Hôtel-Dieu,2015,CHAMPAGNE-ARDENNES,TROYES,3411,7428,10839,
Musée de l'Ancien Collège des Jésuites/Planétarium,2015,CHAMPAGNE-ARDENNES,REIMS,23062,17793,40855,
Musée de Préhistoire Corse,2015,CORSE,SARTENE,4406,4968,9374,
Musée du Château des Ducs de Wurtemberg,2015,FRANCHE-COMTE,MONTBELIARD,5600,8758,14358,
Musée-Maison Natale Gustave Courbet,2015,FRANCHE-COMTE,ORNANS,30606,17747,48353,
Musée Baron Martin,2015,FRANCHE-COMTE,GRAY,2593,2610,5203,
Musée Frédéric Japy,2015,FRANCHE-COMTE,BEAUCOURT,937,1301,2238,
Donation Maurice Jardot,2015,FRANCHE-COMTE,BELFORT,7347,0,7347,
Musée Précolombien Edgar Clerc,2015,GUADELOUPE,LE MOULE,0,10711,10711,
Musée Municipal Saint-John Perse,2015,GUADELOUPE,POINTE-A-PITRE,2205,1295,3500,
Musée Territorial Alexandre Franconie,2015,GUYANE,CAYENNE,2680,6503,9183,
Musée Belmondo et de la Sculpture Figurative du XXè siècle,2015,ILE-DE-FRANCE,BOULOGNE-BILLANCOURT,7704,0,7704,
Musée du Domaine Départemental de Sceaux,2015,ILE-DE-FRANCE,SCEAUX,14678,14260,28938,
Musée de l'Homme (Muséum National d'Histoire Naturelle),2015,ILE-DE-FRANCE,PARIS,115071,65307,180378,
Musée d'Ennery,2015,ILE-DE-FRANCE,PARIS,0,1111,1111,
Etablissement public du musée d'Orsay et de l'Orangerie - Musée d'Orsay,2015,ILE-DE-FRANCE,PARIS,1853666,1586166,3439832,
Musée Bourdelle,2015,ILE-DE-FRANCE,PARIS,16743,25849,42592,
Musée de Montmartre,2015,ILE-DE-FRANCE,PARIS,90565,0,90565,
Etablissement Public du Musée des Arts Asiatiques Guimet,2015,ILE-DE-FRANCE,PARIS,136183,123043,259226,
Palais Galliera - Musée de la Mode de la ville de Paris,2015,ILE-DE-FRANCE,PARIS,174109,8121,182230,
Musée du Maréchal Leclerc de Hauteclocque et de la Libération de Paris - musée Jean Moulin,2015,ILE-DE-FRANCE,PARIS,1953,8706,10659,
"Musée Cognacq-Jay, Musée du XVIIIe siècle de la ville de Paris",2015,ILE-DE-FRANCE,PARIS,44901,21981,66882,
"Musée Cernuschi, Musée des Arts de l'Asie de la ville de Paris",2015,ILE-DE-FRANCE,PARIS,21531,19969,41500,
Musée Nissim de Camondo (Les Arts Décoratifs),2015,ILE-DE-FRANCE,PARIS,35095,15283,50378,
Musée National d'Art Moderne (Centre National d'Art et de Culture Georges Pompidou),2015,ILE-DE-FRANCE,PARIS,2233094,887209,3120303,
L'Adresse Musée de la Poste,2015,ILE-DE-FRANCE,PARIS,7389,1740,9129,
Musée de la Grande Guerre du Pays de Meaux,2015,ILE-DE-FRANCE,MEAUX,68930,17250,86180,
Musée départemental Stéphane Mallarmé,2015,ILE-DE-FRANCE,VULAINES-SUR-SEINE,1275,2981,4256,
Musée de l'Air et de l'Espace,2015,ILE-DE-FRANCE,LE BOURGET,126785,168627,295412,
Musée Fragonard,2015,ILE-DE-FRANCE,MAISONS-ALFORT,3097,5275,8372,
Musée Archéologique du Val d'Oise,2015,ILE-DE-FRANCE,GUIRY-EN-VEXIN,2756,10010,12766,
Musée d'Art et d'Histoire Louis Senlecq,2015,ILE-DE-FRANCE,L'ISLE-ADAM,424,1248,1672,
Musée Municipal - Collections Paul et André Véra,2015,ILE-DE-FRANCE,SAINT-GERMAIN-EN-LAYE,0,2095,2095,
Musée Lambinet,2015,ILE-DE-FRANCE,VERSAILLES,6532,6462,12994,
Muséum Agricole et Industriel Stella Matutina,2015,LA REUNION,PITON-SAINT-LEU,59876,16453,76329,
Musée d'Art et d'Histoire - Ensemble monumental de Narbonne,2015,LANGUEDOC-ROUSSILLON,NARBONNE,47543,602183,649726,
Musée Archéologique,2015,LANGUEDOC-ROUSSILLON,NIMES,1835,40235,42070,
Musée des Beaux-Arts,2015,LANGUEDOC-ROUSSILLON,NIMES,1049,12317,13366,
Musée Municipal Georges Borias,2015,LANGUEDOC-ROUSSILLON,UZES,1506,1151,2657,
Musée Agathois,2015,LANGUEDOC-ROUSSILLON,AGDE,1495,2510,4005,
Musée Fleury,2015,LANGUEDOC-ROUSSILLON,LODEVE,11658,4968,16626,
Musée Paul Valéry,2015,LANGUEDOC-ROUSSILLON,SETE,59449,15342,74791,
Musée du Castillet Casa Pairal,2015,LANGUEDOC-ROUSSILLON,PERPIGNAN,11907,12099,24006,
Musée Labenche d'Art et d'Histoire,2015,LIMOUSIN,BRIVE-LA-GAILLARDE,1699,46823,48522,
Musée Départemental de la Tapisserie,2015,LIMOUSIN,AUBUSSON,16161,3407,19568,
Musée René Baubérot,2015,LIMOUSIN,CHATEAUPONSAC,2072,421,2493,
Cité de la céramique - Sèvres & Limoges - Musée National Adrien Dubouché,2015,LIMOUSIN,LIMOGES,13859,16353,30212,
Musée Départemental d'Art Contemporain,2015,LIMOUSIN,ROCHECHOUART,7957,6453,14410,
Musée Municipal des Beaux-Arts,2015,LIMOUSIN,PAU,8517,11229,19746,
Musée des Beaux-Arts de Nancy,2015,LORRAINE,NANCY,54028,64504,118532,
"Musée ""au Fil du Papier""",2015,LORRAINE,PONT-A-MOUSSON,2364,2289,4653,
Musée d'Argonne,2015,LORRAINE,VARENNES-EN-ARGONNE,1292,0,1292,
Musée Départemental de la Guerre de 70,2015,LORRAINE,GRAVELOTTE,10577,9808,20385,
Moulin de la Blies - Musée des Techniques Faïencières,2015,LORRAINE,SARREGUEMINES,10739,11177,21916,
Musée Pierre Noël - Musée de la Vie dans les Hautes-Vosges,2015,LORRAINE,SAINT-DIE-DES-VOSGES,3445,13547,16992,
Musée du Textile et du Peigne en Corne,2015,MIDI-PYRENEES,LAVELANET,2643,0,2643,
Musée d'Archéologie,2015,MIDI-PYRENEES,MONTSEGUR,1666,14716,16382,
Musée Joseph Vaylet,2015,MIDI-PYRENEES,ESPALION,2183,2889,5072,
Musée Municipal de Millau,2015,MIDI-PYRENEES,MILLAU,3440,14317,17757,
Musée Fenaille,2015,MIDI-PYRENEES,RODEZ,25459,11555,37014,
Musée Soulages,2015,MIDI-PYRENEES,RODEZ,100835,48468,149303,
Musée du Charroi Rural et de l'Artisanat Traditionnel,2015,MIDI-PYRENEES,SALMIECH,0,915,915,
Musée Municipal Urbain Cabrol,2015,MIDI-PYRENEES,VILLEFRANCHE-DE-ROUERGUE,0,5106,5106,
Musée d'Archéologie,2015,MIDI-PYRENEES,LECTOURE,1376,1036,2412,
Musée des Beaux-Arts et des Arts Décoratifs,2015,MIDI-PYRENEES,MIRANDE,53,1493,1546,
Musée Archéologique Départemental,2015,MIDI-PYRENEES,SAINT-BERTRAND-DE-COMMINGES,0,58306,58306,
Muséum d'Histoire Naturelle,2015,MIDI-PYRENEES,TOULOUSE,139251,134681,273932,
Musée Paul Dupuy,2015,MIDI-PYRENEES,TOULOUSE,6490,7695,14185,
Musée Municipal - Musée Trésor,2015,MIDI-PYRENEES,LUZ-SAINT-SAUVEUR,0,5691,5691,
Musée Massey,2015,MIDI-PYRENEES,TARBES,5388,6469,11857,
Musée Jean Jaurès,2015,MIDI-PYRENEES,CASTRES,2480,9886,12366,
Musée Charles Portal - Histoire et Patrimoine,2015,MIDI-PYRENEES,CORDES-SUR-CIEL,517,256,773,
Musée du Protestantisme en Haut-Languedoc,2015,MIDI-PYRENEES,FERRIERES,2184,1366,3550,
Musée des Beaux-Arts,2015,MIDI-PYRENEES,GAILLAC,2588,3334,5922,
Musée Théodore Calbet,2015,MIDI-PYRENEES,GRISOLLES,0,2737,2737,
"Forum Antique de Bavay, Musée Archéologique du Département du Nord",2015,NORD-PAS-DE-CALAIS,BAVAY,22688,9513,32201,
Musée Municipal d'Hazebrouck,2015,NORD-PAS-DE-CALAIS,HAZEBROUCK,6495,0,6495,
Palais des Beaux-Arts de Lille,2015,NORD-PAS-DE-CALAIS,LILLE,152093,148980,301073,
"LAM - Lille Métropole Musée d'Art Moderne, d'Art Contemporain et d'Art Brut",2015,NORD-PAS-DE-CALAIS,VILLENEUVE-D'ASCQ,89415,51666,141081,
Musée Quentovic,2015,NORD-PAS-DE-CALAIS,ETAPLES-SUR-MER,1596,412,2008,
Musée Baron Gérard,2015,BASSE-NORMANDIE,BAYEUX,21565,12331,33896,
Musée d'Ethnographie et d'Arts Populaires et Musée de la Marine,2015,BASSE-NORMANDIE,HONFLEUR,17626,1290,18916,
Musée de la Mine,2015,BASSE-NORMANDIE,LE MOLAY-LITTRY,3287,879,4166,
Musée Quesnel-Morinière,2015,BASSE-NORMANDIE,COUTANCES,366,6173,6539,
Musée Municipal,2015,BASSE-NORMANDIE,EQUEURDREVILLLE-HAINNEVILLE,0,2000,2000,
Musée Richard Anacréon,2015,BASSE-NORMANDIE,GRANVILLE,5844,6810,12654,
Musée Barbey d'Aurevilly,2015,BASSE-NORMANDIE,SAINT-SAUVEUR-LE-VICOMTE,603,456,1059,
Musée Départemental des Arts et Traditions Populaires du Perche,2015,BASSE-NORMANDIE,SAINT-CYR LA ROSIERE,10789,11693,22482,
Musée Municipal,2015,HAUTE-NORMANDIE,BERNAY,1179,7090,8269,
Musée Louis-Philippe du Château d'Eu,2015,HAUTE-NORMANDIE,EU,13422,5918,19340,
Musée d'Art Moderne André Malraux - MuMa,2015,HAUTE-NORMANDIE,LE HAVRE,33726,36737,70463,
Muséum d'Histoire Naturelle,2015,HAUTE-NORMANDIE,LE HAVRE,0,23206,23206,
Musée Départemental Pierre Corneille,2015,HAUTE-NORMANDIE,LE PETIT-COURONNE,565,3557,4122,
Musée Le Secq des Tournelles,2015,HAUTE-NORMANDIE,ROUEN,3958,5794,9752,
Musée Flaubert et d'Histoire de la Médecine,2015,HAUTE-NORMANDIE,ROUEN,2849,4855,7704,
Musée d'Art de Nantes,2015,PAYS DE LA LOIRE,NANTES,21316,208944,230260,
Musée du Chaume/Kerhinet - PNR Brière,2015,PAYS DE LA LOIRE,SAINT-LYPHARD,2517,81377,83894,
Ecomusée de Saint-Nazaire,2015,PAYS DE LA LOIRE,SAINT-NAZAIRE,34726,8704,43430,
Musée des Beaux-Arts,2015,PAYS DE LA LOIRE,ANGERS,17692,63112,80804,
Musée d'Art et d'Histoire,2015,PAYS DE LA LOIRE,CHOLET,2548,14108,16656,
Musée du Textile,2015,PAYS DE LA LOIRE,CHOLET,5020,7711,12731,
Musée de la Vigne et du Vin d'Anjou,2015,PAYS DE LA LOIRE,SAINT LAMBERT-DU-LATTAY - VAL-DU-LAYON,5223,893,6116,
Musée de l'Ardoise,2015,PAYS DE LA LOIRE,TRELAZE,11033,0,11033,
Musée d'Art et d'Archéologie Hôtel Fouquet,2015,PAYS DE LA LOIRE,CHATEAU-GONTIER,218,1277,1495,
Musée de la Reine Bérengère,2015,PAYS DE LA LOIRE,LE MANS,1615,8667,10282,
Bibliothèque-musée,2015,PAYS DE LA LOIRE,SAINT-CALAIS,0,5333,5333,
Musée des Traditions de l'Île,2015,PAYS DE LA LOIRE,LA GUERINIERE,4843,488,5331,
Musée du Château,2015,PAYS DE LA LOIRE,NOIRMOUTIER-EN-L'ILE,33551,3643,37194,
Musée La Bourrine du Bois-Juquaud,2015,PAYS DE LA LOIRE,SAINT-HILAIRE-DE-RIEZ,16890,3134,20024,
Familistère de Guise,2015,PICARDIE,GUISE,54888,8763,63651,
Musée Entomologique,2015,PICARDIE,SAINT-QUENTIN,1066,3487,4553,
Musée de la Résistance et de la Déportation,2015,PICARDIE,TERGNIER,8842,10000,18842,
Musée du Château de Compiègne,2015,PICARDIE,COMPIEGNE,31522,44392,75914,
Musée Gallé-Juillet,2015,PICARDIE,CREIL,1281,4811,6092,
Musée de l'Archerie et de l'Art Sacré,2015,PICARDIE,CREPY-EN-VALOIS,3979,3256,7235,
Musée Jean Calvin,2015,PICARDIE,NOYON,2029,892,2921,
Musée Archéologique de l'Oise,2015,PICARDIE,VENDEUIL-CAPLY,2618,3650,6268,
Atelier - Musée du Papier,2015,POITOU-CHARENTES,ANGOULEME,0,23353,23353,
Musée Municipal de Cognac,2015,POITOU-CHARENTES,COGNAC,2744,3804,6548,
Musée des Beaux-Arts,2015,POITOU-CHARENTES,LA ROCHELLE,3945,13707,17652,
Muséum d'Histoire Naturelle,2015,POITOU-CHARENTES,LA ROCHELLE,13998,38528,52526,
Musée Protestant,2015,POITOU-CHARENTES,LA ROCHELLE,1324,671,1995,
Musée Ernest Cognacq,2015,POITOU-CHARENTES,SAINT-MARTIN-DE-RE,9483,5712,15195,
Musée de Bressuire,2015,POITOU-CHARENTES,BRESSUIRE,0,784,784,
Musée Charbonneau-Lassay,2015,POITOU-CHARENTES,LOUDUN,0,1187,1187,
Musée Municipal de la Maison-Dieu,2015,POITOU-CHARENTES,MONTMORILLON,0,4784,4784,
Musée du baptistère Saint-Jean,2015,POITOU-CHARENTES,POITIERS,11414,1164,12578,
Musée de la vallée,2015,PROVENCE-ALPES-CÔTE D'AZUR,BARCELONNETTE,8901,1791,10692,
Musée de la Faïence,2015,PROVENCE-ALPES-CÔTE D'AZUR,MOUSTIERS-SAINTE-MARIE,7621,2339,9960,
Musée départemental de préhistoire,2015,PROVENCE-ALPES-CÔTE D'AZUR,QUINSON,58658,12702,71360,
Musée Renoir,2015,PROVENCE-ALPES-CÔTE D'AZUR,CAGNES-SUR-MER,27051,15664,42715,
Musée des Beaux-Arts,2015,PROVENCE-ALPES-CÔTE D'AZUR,MENTON,0,15820,15820,
Musée National du Sport,2015,PROVENCE-ALPES-CÔTE D'AZUR,NICE,21215,20921,42136,
Musée Départemental des Merveilles,2015,PROVENCE-ALPES-CÔTE D'AZUR,TENDE,1675,27077,28752,
Musées de la Citadelle,2015,PROVENCE-ALPES-CÔTE D'AZUR,VILLEFRANCHE-SUR-MER,0,82793,82793,
Musée du Pavillon de Vendôme,2015,PROVENCE-ALPES-CÔTE D'AZUR,AIX-EN-PROVENCE,5274,11739,17013,
Musée Granet,2015,PROVENCE-ALPES-CÔTE D'AZUR,AIX-EN-PROVENCE,96135,70387,166522,
Musée Réattu,2015,PROVENCE-ALPES-CÔTE D'AZUR,ARLES,13432,49640,63072,
Musée Ciotaden,2015,PROVENCE-ALPES-CÔTE D'AZUR,LA CIOTAT,2063,4092,6155,
Musée des Docks Romains,2015,PROVENCE-ALPES-CÔTE D'AZUR,MARSEILLE,0,15571,15571,
Musée Borély,2015,PROVENCE-ALPES-CÔTE D'AZUR,MARSEILLE,15032,25576,40608,
Musée Cantini,2015,PROVENCE-ALPES-CÔTE D'AZUR,MARSEILLE,9262,18459,27721,
Musée des Civilisations de l'Europe et de la Méditerranée - MuCem,2015,PROVENCE-ALPES-CÔTE D'AZUR,MARSEILLE,314183,224768,538951,
Musée de l'Empéri de Salon et de la Crau,2015,PROVENCE-ALPES-CÔTE D'AZUR,SALON-DE-PROVENCE,3817,19068,22885,
Musée Départemental des Hautes-Alpes,2015,PROVENCE-ALPES-CÔTE D'AZUR,GAP,0,16423,16423,
Musée du Vêtement Provençal (Jean Aicard),2015,PROVENCE-ALPES-CÔTE D'AZUR,SOLLIES-VILLE,0,5673,5673,
Musée Jean Garcin 39-45 : L'appel de la Liberté,2015,PROVENCE-ALPES-CÔTE D'AZUR,FONTAINE-DE-VAUCLUSE,4231,5432,9663,
Musée Municipal Camille Pautet,2015,PROVENCE-ALPES-CÔTE D'AZUR,MAZAN,0,1425,1425,
Musée Archéologique Théo Desplans,2015,PROVENCE-ALPES-CÔTE D'AZUR,VAISON-LA-ROMAINE,63330,14380,77710,
Musée Archéologique,2015,RHONE-ALPES,IZERNORE,1485,3491,4976,
Musée du Peigne et de la Plasturgie,2015,RHONE-ALPES,OYONNAX,2219,2308,4527,
Musée de la Bresse - Domaine des Planons,2015,RHONE-ALPES,SAINT-CYR-SUR-MENTHON,12331,9331,21662,
Cité de Préhistoire,2015,RHONE-ALPES,ORGNAC-L'AVEN,124618,33340,157958,
Musée et Site Archéologiques,2015,RHONE-ALPES,SOYONS,10488,1691,12179,
Château de Grignan,2015,RHONE-ALPES,GRIGNAN,110552,71042,181594,
Musée des Beaux-Arts,2015,RHONE-ALPES,VALENCE,16481,37554,54035,
Musée du Chablais,2015,RHONE-ALPES,THONON-LES-BAINS,2153,3550,5703,
Musée Archéologique Grenoble Saint-Laurent,2015,RHONE-ALPES,GRENOBLE,0,43881,43881,
Musée Hector Berlioz,2015,RHONE-ALPES,LA-COTE-SAINT-ANDRE,0,14827,14827,
Musée de la Grande Chartreuse,2015,RHONE-ALPES,SAINT-PIERRE-DE-CHARTREUSE,35412,1903,37315,
Musée de la Soierie,2015,RHONE-ALPES,CHARLIEU,4359,1397,5756,
Musée Rural,2015,RHONE-ALPES,USSON-EN-FOREZ,2613,1001,3614,
Musée Historique des Tissus,2015,RHONE-ALPES,LYON,30291,18385,48676,
Lugdunum - Musée et Théâtres Romains,2015,RHONE-ALPES,LYON,21094,58686,79780,
Centre d'Histoire de la Résistance et de la Déportation,2015,RHONE-ALPES,LYON,17870,35209,53079,
Musée de l'Imprimerie et de la Communication Graphique,2015,RHONE-ALPES,LYON,26421,0,26421,
Musée Savoisien,2015,RHONE-ALPES,CHAMBERY,8269,23859,32128,
Musée des Charmettes,2015,RHONE-ALPES,CHAMBERY,0,11402,11402,
Musée de l'Arche,2015,ST PIERRE ET MIQUELON,SAINT-PIERRE ET MIQUELON,2494,1115,3609,
Musée Départemental des Pays De l'Ain,2016,AUVERGNE-RHONE-ALPES,BOURG-EN-BRESSE,0,80,80,
Musée Archéologique,2016,AUVERGNE-RHONE-ALPES,IZERNORE,1164,1952,3116,
Musée de la Bresse - Domaine les Planons,2016,AUVERGNE-RHONE-ALPES,SAINT-CYR-SUR-MENTHON,10274,5985,16259,
Musée de la Haute Auvergne,2016,AUVERGNE-RHONE-ALPES,SAINT-FLOUR,1700,3564,5264,
Château de Grignan,2016,AUVERGNE-RHONE-ALPES,GRIGNAN,113157,71736,184893,
Musée du Château des Adhémars,2016,AUVERGNE-RHONE-ALPES,MONTELIMAR,12277,8534,20811,
Musée de Paléontologie,2016,AUVERGNE-RHONE-ALPES,CHILHAC,2149,99,2248,
Musée des Arts et Traditions Populaires de Haute Loire,2016,AUVERGNE-RHONE-ALPES,LAVAUDIEU,10127,737,10864,
Musée des Vallées de Thônes,2016,AUVERGNE-RHONE-ALPES,THONES,699,1309,2008,
Musée - Parc Archéologique du Lac de Paladru,2016,AUVERGNE-RHONE-ALPES,CHARAVINES,8114,2219,10333,
Musée de Grenoble,2016,AUVERGNE-RHONE-ALPES,GRENOBLE,93678,116590,210268,
Musée Lapidaire Saint-Pierre,2016,AUVERGNE-RHONE-ALPES,VIENNE,3162,6416,9578,
Musée Hospitalier,2016,AUVERGNE-RHONE-ALPES,CHARLIEU,2711,929,3640,
Musée d'Art et d'Industrie,2016,AUVERGNE-RHONE-ALPES,SAINT-ETIENNE,21911,19505,41416,
Château de la Bastie d'Urfé,2016,AUVERGNE-RHONE-ALPES,SAINT-ETIENNE-LE-MOLARD,8012,19873,27885,
Musée d'Art Moderne et Contemporain de Saint-Etienne Métropole,2016,AUVERGNE-RHONE-ALPES,SAINT-PRIEST-EN-JAREZ,28822,27863,56685,
Muséum d'Histoire Naturelle Henri-Lecoq,2016,AUVERGNE-RHONE-ALPES,CLERMONT-FERRAND,4595,26750,31345,
Musée d'Art Roger-Quillot,2016,AUVERGNE-RHONE-ALPES,CLERMONT-FERRAND,29705,48681,78386,
Musée Barthélemy-Thimonnier,2016,AUVERGNE-RHONE-ALPES,AMPLEPUIS,2012,2048,4060,
Musées Gadagne,2016,AUVERGNE-RHONE-ALPES,LYON,46729,32720,79449,
Musée des Confluences,2016,AUVERGNE-RHONE-ALPES,LYON,429805,337704,767509,
Centre d'Histoire de la Résistance et de la Déportation,2016,AUVERGNE-RHONE-ALPES,LYON,25889,34046,59935,
Musée du docteur Faure,2016,AUVERGNE-RHONE-ALPES,AIX-LES-BAINS,6453,6002,12455,
Musée des Charmettes,2016,AUVERGNE-RHONE-ALPES,CHAMBERY,0,11010,11010,
Musée du Vin de Bourgogne,2016,BOURGOGNE-FRANCHE-COMTE,BEAUNE,10355,3542,13897,
Musée des Beaux-Arts,2016,BOURGOGNE-FRANCHE-COMTE,BEAUNE,2972,2095,5067,
Musée du Pays Châtillonnais - Trésor de Vix,2016,BOURGOGNE-FRANCHE-COMTE,CHATILLON-SUR-SEINE,14066,7246,21312,
Musée François Rude,2016,BOURGOGNE-FRANCHE-COMTE,DIJON,0,82965,82965,
Musée Archéologique,2016,BOURGOGNE-FRANCHE-COMTE,DIJON,0,33119,33119,
Musée des Beaux-Arts,2016,BOURGOGNE-FRANCHE-COMTE,DIJON,0,155692,155692,
Musée Buffon,2016,BOURGOGNE-FRANCHE-COMTE,MONTBARD,0,7688,7688,
Musée des Beaux-Arts et d'Archéologie,2016,BOURGOGNE-FRANCHE-COMTE,BESANCON,0,11252,11252,
Muséum de Besançon,2016,BOURGOGNE-FRANCHE-COMTE,BESANCON,236458,33606,270064,
Musée Georges Garret,2016,BOURGOGNE-FRANCHE-COMTE,VESOUL,0,4094,4094,
Musée des Beaux-Arts,2016,BOURGOGNE-FRANCHE-COMTE,DOLE,0,20692,20692,
Musée du Prieuré de Charolles,2016,BOURGOGNE-FRANCHE-COMTE,CHAROLLES,872,1248,2120,
Musée de la Tour du Moulin,2016,BOURGOGNE-FRANCHE-COMTE,MARCIGNY,1170,731,1901,
Musée Départemental de Préhistoire de Solutré,2016,BOURGOGNE-FRANCHE-COMTE,SOLUTRE-POUILLY,15857,10572,26429,
Muséum - Maison de l'Eau,2016,BOURGOGNE-FRANCHE-COMTE,AUXERRE,0,14605,14605,
Musée Colette,2016,BOURGOGNE-FRANCHE-COMTE,SAINT-SAUVEUR-EN-PUISAYE,7816,230,8046,
Musée Mathurin Meheut,2016,BRETAGNE,LAMBALLE,6119,1072,7191,
Ecomusée d'Ouessant - Vivre sur une Ile,2016,BRETAGNE,OUESSANT,8097,1202,9299,
Musée de Bretagne,2016,BRETAGNE,RENNES,15364,46388,61752,
Musée d'Histoire de la Ville de Saint-Malo,2016,BRETAGNE,SAINT-MALO,17594,9592,27186,
Musée des Rochers-Sévigné,2016,BRETAGNE,VITRE,3001,0,3001,
Ecomusée de Saint-Dégan,2016,BRETAGNE,BREC'H,7690,2096,9786,
Ecomusée de l'Île de Groix,2016,BRETAGNE,ILE DE GROIX,4640,2039,6679,
Musée de la Compagnie des Indes,2016,BRETAGNE,PORT-LOUIS,37585,27921,65506,
Musée des Beaux-Arts et d'Histoire Naturelle,2016,CENTRE-VAL DE LOIRE,CHATEAUDUN,3360,5502,8862,
Musée de la Chemiserie et de l'Elégance Masculine,2016,CENTRE-VAL DE LOIRE,ARGENTON-SUR-CREUSE,3268,3329,6597,
"Le Carroi, Musée d’Arts et d’Histoire",2016,CENTRE-VAL DE LOIRE,CHINON,1160,2043,3203,
Musée Balzac,2016,CENTRE-VAL DE LOIRE,SACHE,13673,5034,18707,
Maison de la Magie,2016,CENTRE-VAL DE LOIRE,BLOIS,70470,22615,93085,
Musée de la Corbillière,2016,CENTRE-VAL DE LOIRE,MER,0,3188,3188,
Musée de la Marine de Loire,2016,CENTRE-VAL DE LOIRE,CHATEAUNEUF-SUR-LOIRE,7429,4900,12329,
Musée d'Art et d'Archéologie,2016,CENTRE-VAL DE LOIRE,CHATILLON-COLIGNY,0,689,689,
Musée d'Histoire et d'Archéologie,2016,CENTRE-VAL DE LOIRE,ORLEANS,1371,10058,11429,
Musée de la Maison Bonaparte,2016,CORSE,AJACCIO,59913,29642,89555,
Maison des Ailleurs - Arthur Rimbaud (Annexe du musée Rimbaud),2016,GRAND EST,CHARLEVILLE-MEZIERES,6050,1903,7953,
Musée Vauluisant - Musée de la Bonneterie,2016,GRAND EST,TROYES,2890,5296,8186,
Musée de la Folie Marco,2016,GRAND EST,BARR,1705,1409,3114,
Musée Historique,2016,GRAND EST,STRASBOURG,23053,28418,51471,
Musée J.F. Oberlin,2016,GRAND EST,WALDERSBACH,22413,7875,30288,
Musée des Beaux-Arts et d'Archéologie,2016,GRAND EST,CHAUMONT,688,2866,3554,
Musée d'Histoire Local,2016,GRAND EST,KAYSERSBERG,0,3122,3122,
Musée de l'Impression sur Etoffes,2016,GRAND EST,MULHOUSE,18473,13718,32191,
Musée du Papier Peint,2016,GRAND EST,RIXHEIM,5533,5190,10723,
Musée des Amis de Thann,2016,GRAND EST,THANN,485,1222,1707,
Ecomusée d'Alsace,2016,GRAND EST,UNGERSHEIM,176974,17391,194365,
Musée Hôtel le Vergeur,2016,GRAND EST,REIMS,2046,1926,3972,
Musée de Zoologie,2016,GRAND EST,NANCY,30964,60123,91087,
Musée des Beaux-Arts de Nancy,2016,GRAND EST,NANCY,48924,67159,116083,
Musée Barrois,2016,GRAND EST,BAR-LE-DUC,2362,8032,10394,
Musée d'Argonne,2016,GRAND EST,VARENNES-EN-ARGONNE,1227,0,1227,
Musée Jeanne d'Arc,2016,GRAND EST,VAUCOULEURS,838,853,1691,
Musée des Mines de fer de Lorraine,2016,GRAND EST,NEUFCHEF,16237,1884,18121,
Musée Départemental d'Art Ancien et Contemporain,2016,GRAND EST,EPINAL,3056,10728,13784,
Musée Charles de Bruyères,2016,GRAND EST,REMIREMONT,427,1898,2325,
Musée Départemental Victor Schoelcher,2016,GUADELOUPE,POINTE-A-PITRE,1584,7903,9487,
Forum Antique de Bavay,2016,HAUTS-DE-FRANCE,BAVAY,23659,6694,30353,
Musée Municipal d'Escaudain,2016,HAUTS-DE-FRANCE,ESCAUDAIN,0,600,600,
Musée Municipal d'Hazebrouck,2016,HAUTS-DE-FRANCE,HAZEBROUCK,677,3416,4093,
Musée Pillon,2016,HAUTS-DE-FRANCE,CHAUMONT-EN-VEXIN,0,508,508,
Musée Gallé-Juillet,2016,HAUTS-DE-FRANCE,CREIL,1348,5647,6995,
Musée de l'Archerie et de l'Art Sacré,2016,HAUTS-DE-FRANCE,CREPY-EN-VALOIS,3226,3882,7108,
Musée du Noyonnais,2016,HAUTS-DE-FRANCE,NOYON,770,1908,2678,
Musée de la Vénerie,2016,HAUTS-DE-FRANCE,SENLIS,1483,4754,6237,
Musée des Beaux-Arts,2016,HAUTS-DE-FRANCE,ARRAS,13497,25065,38562,
Musée de Boulogne-sur-Mer,2016,HAUTS-DE-FRANCE,BOULOGNE-SUR-MER,12668,19130,31798,
Louvre-Lens (collections nationales decentralisées),2016,HAUTS-DE-FRANCE,LENS,124489,320113,444602,
Musée Jean-Charles Cazin,2016,HAUTS-DE-FRANCE,SAMER,0,652,652,
Musée Alfred Danicourt,2016,HAUTS-DE-FRANCE,PERONNE,0,3903,3903,
Musée du Château,2016,ILE-DE-FRANCE,DOURDAN,11067,9054,20121,
Musée Français de la Carte à Jouer,2016,ILE-DE-FRANCE,ISSY-LES-MOULINEAUX,6852,16612,23464,
Musée de l'Armée,2016,ILE-DE-FRANCE,PARIS,680065,526000,1206065,
Galerie de Minéralogie et de Géologie (Muséum d'Histoire Naturelle),2016,ILE-DE-FRANCE,PARIS,46278,16514,62792,
Grande Galerie de l'Evolution (Muséum National d'Histoire Naturelle),2016,ILE-DE-FRANCE,PARIS,313742,293110,606852,
Musée de l'Homme (Muséum National d'Histoire Naturelle),2016,ILE-DE-FRANCE,PARIS,177994,106154,284148,
"Petit Palais, Musée des Beaux-Arts de la ville de Paris",2016,ILE-DE-FRANCE,PARIS,210749,684984,895733,
Musée d'Art et d'Histoire de l'Hôpital Sainte-Anne,2016,ILE-DE-FRANCE,PARIS,0,3308,3308,
Musée des Monuments Français,2016,ILE-DE-FRANCE,PARIS,80096,74906,155002,
Musée du Quai Branly,2016,ILE-DE-FRANCE,PARIS,284726,626119,910845,
Musée de l'Ecole de Barbizon - Auberge Ganne,2016,ILE-DE-FRANCE,BARBIZON,12753,9965,22718,
Musée Municipal de Chelles Alfred Bonno,2016,ILE-DE-FRANCE,CHELLES,0,3472,3472,
Musée du Château de Fontainebleau,2016,ILE-DE-FRANCE,FONTAINEBLEAU,185548,237317,422865,
Musée d'Art et d'Histoire de Melun,2016,ILE-DE-FRANCE,MELUN,502,3524,4026,
Château-musée de Nemours,2016,ILE-DE-FRANCE,NEMOURS,4885,3378,8263,
Musée de Provins et du Provinois,2016,ILE-DE-FRANCE,PROVINS,16541,3314,19855,
Musée départemental Stéphane Mallarmé,2016,ILE-DE-FRANCE,VULAINES-SUR-SEINE,1387,1942,3329,
Musée d'Art et d'Histoire,2016,ILE-DE-FRANCE,SAINT-DENIS,3170,14481,17651,
Musée Archéologique du Val d'Oise,2016,ILE-DE-FRANCE,GUIRY-EN-VEXIN,4073,11643,15716,
Musée Promenade Marly/Louveciennes,2016,ILE-DE-FRANCE,LOUVECIENNES,6931,2365,9296,
Musée-Maison Maurice Ravel,2016,ILE-DE-FRANCE,MONTFORT-L'AMAURY,1408,0,1408,
Musée d'Archéologie Nationale (des origines à l'an mille) - Château de st-Germain-en-Laye,2016,ILE-DE-FRANCE,SAINT-GERMAIN-EN-LAYE,19769,86642,106411,
Musée des Arts Décoratifs de l’Océan indien (MADOI),2016,LA REUNION,SAINT-LOUIS,8155,1118,9273,
Musée Départemental d'Archéologie Précolombienne et de Préhistoire de la Martinique,2016,MARTINIQUE,FORT-DE-FRANCE,5375,1529,6904,
Musée des Beaux-Arts,2016,NORMANDIE,CAEN,51458,73927,125385,
Mémorial de Caen,2016,NORMANDIE,CAEN,300531,48924,349455,
Musée d'Ethnographie et d'Arts Populaires et Musée de la Marine,2016,NORMANDIE,HONFLEUR,14228,1002,15230,
Musée Eugène Boudin,2016,NORMANDIE,HONFLEUR,27342,3561,30903,
Musée Municipal,2016,NORMANDIE,LOUVIERS,0,11486,11486,
Musée des Beaux-Arts,2016,NORMANDIE,SAINT-LO,1790,6734,8524,
Musée du Château de Flers,2016,NORMANDIE,FLERS,1104,1970,3074,
Museoseine,2016,NORMANDIE,CAUDEBEC-EN-CAUX,14600,0,14600,
Musée Louis-Philippe du Château d'Eu,2016,NORMANDIE,EU,12460,4349,16809,
Musée du Prieuré,2016,NORMANDIE,HARFLEUR,158,2082,2240,
Musée de l'Hôtel Dubocage de Bléville,2016,NORMANDIE,LE HAVRE,0,6420,6420,
Musée des Traditions et Arts Normands,2016,NORMANDIE,MARTAINVILLE-EPREVILLE,8341,15338,23679,
Musée Industriel de la Corderie Vallois,2016,NORMANDIE,NOTRE-DAME-DE-BONDEVILLE,2841,8525,11366,
Musée-Maison Natale Pierre Corneille,2016,NORMANDIE,ROUEN,0,5730,5730,
Association de l'Horlogerie Aliermontaise,2016,NORMANDIE,SAINT-NICOLAS-D'ALIERMONT,2807,3472,6279,
Musée des Beaux-Arts,2016,NOUVELLE-AQUITAINE,ANGOULEME,9613,19736,29349,
Atelier - Musée du Papier,2016,NOUVELLE-AQUITAINE,ANGOULEME,3438,13034,16472,
Musée Archéologique et Historique,2016,NOUVELLE-AQUITAINE,ANGOULEME,92,361,453,
Musée du Nouveau Monde,2016,NOUVELLE-AQUITAINE,LA ROCHELLE,5635,11471,17106,
Musée de l'Echevinage,2016,NOUVELLE-AQUITAINE,SAINTES,859,2175,3034,
Musée Dupuy-Mestreau,2016,NOUVELLE-AQUITAINE,SAINTES,359,689,1048,
Musée Ernest Cognacq,2016,NOUVELLE-AQUITAINE,SAINT-MARTIN-DE-RE,8951,5263,14214,
Musée de la Mémoire et des Industries Tullistes,2016,NOUVELLE-AQUITAINE,TULLE,0,3307,3307,
Musée Départemental de la Tapisserie,2016,NOUVELLE-AQUITAINE,AUBUSSON,28582,10247,38829,
Musée de Bressuire,2016,NOUVELLE-AQUITAINE,BRESSUIRE,0,2539,2539,
Musée Bernard d’Agesci,2016,NOUVELLE-AQUITAINE,NIORT,4064,9136,13200,
Musée du Tabac,2016,NOUVELLE-AQUITAINE,BERGERAC,3606,1187,4793,
CAPC Musée d'Art Contemporain de Bordeaux,2016,NOUVELLE-AQUITAINE,BORDEAUX,40018,40507,80525,
Musée des Beaux-Arts,2016,NOUVELLE-AQUITAINE,BORDEAUX,51550,57224,108774,
Musée d'Aquitaine,2016,NOUVELLE-AQUITAINE,BORDEAUX,46208,140891,187099,
Cité de la céramique - Sèvres & Limoges - Musée National Adrien Dubouché,2016,NOUVELLE-AQUITAINE,LIMOGES,13718,15922,29640,
Musée des Beaux-Arts,2016,NOUVELLE-AQUITAINE,AGEN,8851,12589,21440,
Musée de Préhistoire Mésolithique Laurent Coulonges,2016,NOUVELLE-AQUITAINE,SAUVETERRE-LA-LEMANCE,2222,379,2601,
Musée Municipal des Beaux-Arts,2016,NOUVELLE-AQUITAINE,PAU,7596,10671,18267,
Musée Municipal de Civray,2016,NOUVELLE-AQUITAINE,CIVRAY,0,142,142,
Musée Sainte-Croix,2016,NOUVELLE-AQUITAINE,POITIERS,6476,25150,31626,
Musée Soulages,2016,OCCITANIE,RODEZ,121388,56233,177621,
Musée de la Maison Romane,2016,OCCITANIE,SAINT-GILLES-DU-GARD,458,581,1039,
Musée Municipal Georges Borias,2016,OCCITANIE,UZES,1374,972,2346,
Musée d'Archéologie,2016,OCCITANIE,LECTOURE,2247,1245,3492,
Musée Campanaire,2016,OCCITANIE,L'ISLE JOURDAIN,4919,0,4919,
Musée Archéologique Départemental,2016,OCCITANIE,SAINT-BERTRAND-DE-COMMINGES,0,10347,10347,
Musée des Transports et des Communications,2016,OCCITANIE,TOULOUSE,0,248,248,
Muséum d'Histoire Naturelle,2016,OCCITANIE,TOULOUSE,137034,130549,267583,
Musée Municipal - Musée Trésor,2016,OCCITANIE,LUZ-SAINT-SAUVEUR,0,3667,3667,
Musée Massey,2016,OCCITANIE,TARBES,4971,5763,10734,
Musée de l'Etang de Thau,2016,OCCITANIE,BOUZIGUES,12666,1576,14242,
Musée de Préhistoire Amédée Lémozi,2016,OCCITANIE,CABRERETS,78800,0,78800,
Musée Eugénie et Maurice Guérin,2016,OCCITANIE,ANDILLAC,1696,2544,4240,
Musée Jean Jaurès,2016,OCCITANIE,CASTRES,2358,4931,7289,
Musée du Pays Rabastinois,2016,OCCITANIE,RABASTENS,1037,3694,4731,
Musée des Marais Salant,2016,PAYS DE LA LOIRE,BATZ-SUR-MER,12608,5592,18200,
Musée du Pays de Guérande et de la Porte Saint Michel,2016,PAYS DE LA LOIRE,GUERANDE,22267,8847,31114,
Muséum d'Histoire Naturelle de Nantes,2016,PAYS DE LA LOIRE,NANTES,44237,94863,139100,
Musée des Beaux-Arts (+ musée-château de Villevêque),2016,PAYS DE LA LOIRE,ANGERS,20444,63236,83680,
Galerie David d'Angers,2016,PAYS DE LA LOIRE,ANGERS,8844,16297,25141,
Musée Joseph Denais,2016,PAYS DE LA LOIRE,BEAUFORT-EN-VALLEE,5375,2556,7931,
Musée Jules-Desbois,2016,PAYS DE LA LOIRE,PARCAY-LES-PINS,3597,860,4457,
Musée de la Vigne et du Vin d'Anjou,2016,PAYS DE LA LOIRE,SAINT LAMBERT-DU-LATTAY - VAL-DU-LAYON,4218,1205,5423,
Château-Musée,2016,PAYS DE LA LOIRE,SAUMUR,72104,12595,84699,
Musée des Tisserands Mayennais,2016,PAYS DE LA LOIRE,AMBRIERES-LES-VALLEES,229,122,351,
Musée Archéologique Départemental de Jublains,2016,PAYS DE LA LOIRE,JUBLAINS,16765,11752,28517,
Musée Clemenceau et de Lattre-de-Tassigny,2016,PAYS DE LA LOIRE,MOUILLERON-EN-PAREDS,1371,2688,4059,
Musée Milcendeau Jean-Yole,2016,PAYS DE LA LOIRE,SOULLANS,2255,1644,3899,
Musée départemental de préhistoire,2016,PROVENCE-ALPES-CÔTE D'AZUR,QUINSON,58433,11552,69985,
Musée d'Art et d'Histoire de Provence,2016,PROVENCE-ALPES-CÔTE D'AZUR,GRASSE,1738,12181,13919,
Musée Bonnard,2016,PROVENCE-ALPES-CÔTE D'AZUR,LE CANNET,22613,8794,31407,
Musée de Préhistoire Régionale,2016,PROVENCE-ALPES-CÔTE D'AZUR,MENTON,2495,8582,11077,
Musée Matisse,2016,PROVENCE-ALPES-CÔTE D'AZUR,NICE,63981,51741,115722,
Musée Départemental des Arts Asiatiques,2016,PROVENCE-ALPES-CÔTE D'AZUR,NICE,3820,40336,44156,
Musée National du Sport,2016,PROVENCE-ALPES-CÔTE D'AZUR,NICE,14309,31516,45825,
Musée Départemental des Merveilles,2016,PROVENCE-ALPES-CÔTE D'AZUR,TENDE,4249,23220,27469,
Musée Picasso la guerre et la paix à Vallauris,2016,PROVENCE-ALPES-CÔTE D'AZUR,VALLAURIS,21355,8732,30087,
Musée du Parlement de Provence et du Vieil Aix,2016,PROVENCE-ALPES-CÔTE D'AZUR,AIX-EN-PROVENCE,0,24655,24655,
Musée Municipal Méditerranéen de Cassis A.T.P.,2016,PROVENCE-ALPES-CÔTE D'AZUR,CASSIS,0,7996,7996,
Musée d'Archéologie Méditerranéenne,2016,PROVENCE-ALPES-CÔTE D'AZUR,MARSEILLE,36294,18578,54872,
Musée des Civilisations de l'Europe et de la Méditerranée - MuCem,2016,PROVENCE-ALPES-CÔTE D'AZUR,MARSEILLE,342130,245929,588059,
Musée d'Art Contemporain - Galeries Contemporaines,2016,PROVENCE-ALPES-CÔTE D'AZUR,MARSEILLE,14694,5847,20541,
Musée du Pays Brignolais,2016,PROVENCE-ALPES-CÔTE D'AZUR,BRIGNOLES,1143,1661,2804,
Musée Municipal,2016,PROVENCE-ALPES-CÔTE D'AZUR,HYERES,5108,7824,12932,
Musée de l'Annonciade,2016,PROVENCE-ALPES-CÔTE D'AZUR,SAINT-TROPEZ,28736,6250,34986,
Muséum d'Histoire Naturelle de Toulon et du Var,2016,PROVENCE-ALPES-CÔTE D'AZUR,TOULON,0,43400,43400,
Musée d'Apt,2016,PROVENCE-ALPES-CÔTE D'AZUR,APT,2502,6371,8873,
Musée Sobirats,2016,PROVENCE-ALPES-CÔTE D'AZUR,CARPENTRAS,296,661,957,
Musée de l'Hôtel Dieu,2016,PROVENCE-ALPES-CÔTE D'AZUR,CAVAILLON,591,754,1345,
Musée-Bibliothèque François Pétrarque,2016,PROVENCE-ALPES-CÔTE D'AZUR,FONTAINE-DE-VAUCLUSE,1359,759,2118,
Musée du Vieux Pérouges,2017,AUVERGNE-RHONE-ALPES,PEROUGES,11564,1006,12570,
Musée de la Bresse - Domaine des Planons,2017,AUVERGNE-RHONE-ALPES,SAINT-CYR-SUR-MENTHON,9852,7173,17025,
Musée Municipal de Gannat,2017,AUVERGNE-RHONE-ALPES,GANNAT,722,2589,3311,
Centre National du Costume de Scène et de la Scénographie,2017,AUVERGNE-RHONE-ALPES,MOULINS,56218,12580,68798,
Musée Rieckotter,2017,AUVERGNE-RHONE-ALPES,NERIS-LES-BAINS,306,831,1137,
Ecomusée de Margeride-Haute-Auvergne,2017,AUVERGNE-RHONE-ALPES,RUYNES-EN-MARGERIDE,7986,1851,9837,
Musée-château d'Annecy,2017,AUVERGNE-RHONE-ALPES,ANNECY,107615,20243,127858,
Musée Alpin,2017,AUVERGNE-RHONE-ALPES,CHAMONIX,27057,10742,37799,
"Notre histoire, Musée de Rumilly",2017,AUVERGNE-RHONE-ALPES,RUMILLY,2400,1070,3470,
Musée - Parc Archéologique du Lac de Paladru,2017,AUVERGNE-RHONE-ALPES,CHARAVINES,7815,653,8468,
Musée Stendhal,2017,AUVERGNE-RHONE-ALPES,GRENOBLE,557,4085,4642,
Muséum d'Histoire Naturelle de Grenoble,2017,AUVERGNE-RHONE-ALPES,GRENOBLE,12099,59669,71768,
Maison du Patrimoine de Hières-sur-Amby,2017,AUVERGNE-RHONE-ALPES,HIERES SUR AMBY,6961,1412,8373,
Musée Hébert,2017,AUVERGNE-RHONE-ALPES,LA TRONCHE,0,40151,40151,
Musée Alice Taverne,2017,AUVERGNE-RHONE-ALPES,AMBIERLE,3900,750,4650,
Atelier - Musée du Chapeau,2017,AUVERGNE-RHONE-ALPES,CHAZELLES-SUR-LYON,16992,5878,22870,
Musée d'Archéologie,2017,AUVERGNE-RHONE-ALPES,FEURS,1622,2873,4495,
Musée d'Art Roger-Quillot,2017,AUVERGNE-RHONE-ALPES,CLERMONT-FERRAND,9378,25183,34561,
Musée des Pénitents Blancs,2017,AUVERGNE-RHONE-ALPES,MARSAC-EN-LIVRADOIS,134,78,212,
Musée des Peintres de l'Ecole de Murols,2017,AUVERGNE-RHONE-ALPES,MUROL,4347,81,4428,
Musée Municipal de la Coutellerie,2017,AUVERGNE-RHONE-ALPES,THIERS,18343,3790,22133,
Centre d'Histoire de la Résistance et de la Déportation,2017,AUVERGNE-RHONE-ALPES,LYON,20999,43431,64430,
Musée des Sapeurs-Pompiers de Lyon,2017,AUVERGNE-RHONE-ALPES,LYON,4517,7311,11828,
Musée Archéologique,2017,AUVERGNE-RHONE-ALPES,SAINT-ROMAIN-EN-GAL,23693,51100,74793,
Ecomusée du Haut Beaujolais,2017,AUVERGNE-RHONE-ALPES,THIZY-LES-BOURGS,369,770,1139,
Musée Paul Dini,2017,AUVERGNE-RHONE-ALPES,VILLEFRANCHE-SUR-SAONE,5794,16753,22547,
Musée du docteur Faure,2017,AUVERGNE-RHONE-ALPES,AIX-LES-BAINS,8704,7489,16193,
Musée de l'Académie de La Val d'Isère,2017,AUVERGNE-RHONE-ALPES,MOÛTIERS,36,155,191,
Musée des Beaux-Arts,2017,BOURGOGNE-FRANCHE-COMTE,BEAUNE,3699,2489,6188,
Musée du Pays Châtillonnais - Trésor de Vix,2017,BOURGOGNE-FRANCHE-COMTE,CHATILLON-SUR-SEINE,13212,6290,19502,
"Musée de la Vie Bourguignonne, Perrin de Puycousin",2017,BOURGOGNE-FRANCHE-COMTE,DIJON,0,36637,36637,
Musée des Beaux-Arts,2017,BOURGOGNE-FRANCHE-COMTE,DIJON,0,154164,154164,
Musée du Temps,2017,BOURGOGNE-FRANCHE-COMTE,BESANCON,8847,30001,38848,
Musée-Maison Natale Gustave Courbet,2017,BOURGOGNE-FRANCHE-COMTE,ORNANS,21911,13297,35208,
Musée Départemental Albert-et-Félicie Demard - ATP,2017,BOURGOGNE-FRANCHE-COMTE,CHAMPLITTE,4830,5712,10542,
Musée Baron Martin,2017,BOURGOGNE-FRANCHE-COMTE,GRAY,2260,3207,5467,
Musée d'Art et d'Histoire Romain Rolland,2017,BOURGOGNE-FRANCHE-COMTE,CLAMECY,1772,2018,3790,
Musée Auguste Grasset,2017,BOURGOGNE-FRANCHE-COMTE,VARZY,1291,400,1691,
Museum d'Histoire Naturelle Jacques de La Comble,2017,BOURGOGNE-FRANCHE-COMTE,AUTUN,533,2270,2803,
Musée René Davoine,2017,BOURGOGNE-FRANCHE-COMTE,CHAROLLES,0,120,120,
Musée Départemental du Compagnonnage,2017,BOURGOGNE-FRANCHE-COMTE,ROMANECHE-THORINS,2021,2412,4433,
Hôtel Dieu - Musée Greuze,2017,BOURGOGNE-FRANCHE-COMTE,TOURNUS,7004,1941,8945,
Donation Maurice Jardot,2017,BOURGOGNE-FRANCHE-COMTE,BELFORT,1245,5381,6626,
Muséum - Maison de l'Eau,2017,BOURGOGNE-FRANCHE-COMTE,AUXERRE,0,15324,15324,
Musée Leblanc-Duvernois,2017,BOURGOGNE-FRANCHE-COMTE,AUXERRE,0,822,822,
Musée Zervos - Maison Romain Rolland,2017,BOURGOGNE-FRANCHE-COMTE,VEZELAY,6032,3626,9658,
Musée des Beaux-Arts,2017,BRETAGNE,QUIMPER,30043,17461,47504,
Musée des Beaux-Arts,2017,BRETAGNE,RENNES,20761,70833,91594,
Musée du Faouët,2017,BRETAGNE,LE FAOUET,13780,3945,17725,
Musée d'Histoire et d'Archéologie de Vannes,2017,BRETAGNE,VANNES,2679,4575,7254,
Musée des Beaux-Arts et d'Histoire Naturelle,2017,CENTRE-VAL DE LOIRE,CHATEAUDUN,2445,5329,7774,
Musée de la Chemiserie et de l'Elégance Masculine,2017,CENTRE-VAL DE LOIRE,ARGENTON-SUR-CREUSE,2975,3919,6894,
Musées de Châteauroux - Hôtel Bertrand,2017,CENTRE-VAL DE LOIRE,CHATEAUROUX,4387,13012,17399,
Musée de Préhistoire du Grand Pressigny,2017,CENTRE-VAL DE LOIRE,LE GRAND PRESSIGNY,12940,3074,16014,
Musée de l'Hôtel de Ville,2017,CENTRE-VAL DE LOIRE,RICHELIEU,3768,474,4242,
"Château-Musée de Gien : chasse, histoire et nature en Val de Loire",2017,CENTRE-VAL DE LOIRE,GIEN,16318,9073,25391,
Musée de la Maison Bonaparte,2017,CORSE,AJACCIO,57427,28680,86107,
Musée d'archéologie d'Aleria - Jérôme Carcopino,2017,CORSE,ALERIA,29222,4738,33960,
Musée d'Histoire de Bastia,2017,CORSE,BASTIA,18303,16120,34423,
Musée Archéologique de Mariana - Prince Rainier III de Monaco,2017,CORSE,LUCCIANA,0,7500,7500,
Musée de la Maison de la Dernière Cartouche,2017,GRAND EST,BAZEILLES,1029,1344,2373,
Maison des Ailleurs - Arthur Rimbaud (Annexe musée Rimbaud),2017,GRAND EST,CHARLEVILLE-MEZIERES,6191,2841,9032,
Musée de la Résistance,2017,GRAND EST,MUSSY-SUR-SEINE,80,0,80,
Musée du Pays de Hanau - Histoire et Vies d’un Territoire,2017,GRAND EST,BOUXWILLER,1816,3973,5789,
Musée de l'Image Populaire de Pfaffenhoffen,2017,GRAND EST,PFAFFENHOFFEN,1274,922,2196,
Musée Historique,2017,GRAND EST,STRASBOURG,23448,34650,58098,
Musée d'Art Moderne et Contemporain de Strasbourg,2017,GRAND EST,STRASBOURG,47402,79351,126753,
Musée Zoologique de Strasbourg,2017,GRAND EST,STRASBOURG,7785,33133,40918,
Musée des Arts Décoratifs,2017,GRAND EST,STRASBOURG,33981,36166,70147,
Musée Alsacien,2017,GRAND EST,STRASBOURG,35069,28845,63914,
Musée des Beaux-Arts,2017,GRAND EST,STRASBOURG,32087,34446,66533,
Musée Tomi Ungerer,2017,GRAND EST,STRASBOURG,22411,22430,44841,
Musée des Beaux-Arts et d'Archéologie,2017,GRAND EST,CHAUMONT,811,2755,3566,
Maison des Lumières Denis Diderot,2017,GRAND EST,LANGRES,5000,6600,11600,
Musée Sundgauvien d'Altkirch,2017,GRAND EST,ALTKIRCH,854,1542,2396,
Musée National de l'Automobile - Collection Schlumpf,2017,GRAND EST,MULHOUSE,147583,27296,174879,
Musée Vauban,2017,GRAND EST,NEUF-BRISACH,2333,199,2532,
Ecomusée d'Alsace,2017,GRAND EST,UNGERSHEIM,160522,23226,183748,
Musée du Cloître de Notre-Dame-en-Vaux,2017,GRAND EST,CHALONS-EN-CHAMPAGNE,833,2057,2890,
Les Sources d'Hercule,2017,GRAND EST,DENEUVRE,2485,557,3042,
Musée de l'Histoire du Fer,2017,GRAND EST,JARVILLE-LA-MALGRANGE,3537,4440,7977,
Musée de Zoologie,2017,GRAND EST,NANCY,38077,68808,106885,
"Musée ""au Fil du Papier""",2017,GRAND EST,PONT-A-MOUSSON,2394,1880,4274,
Musée de la Céramique et de l'Ivoire,2017,GRAND EST,COMMERCY,219,1141,1360,
Musée de la Bière et du Pays de Stenay,2017,GRAND EST,STENAY,6712,15419,22131,
Maison du Verre et du Cristal,2017,GRAND EST,MEISENTHAL,15270,3623,18893,
Musée des Mines de fer de Lorraine,2017,GRAND EST,NEUFCHEF,16309,1372,17681,
Musée Précolombien Edgar Clerc,2017,GUADELOUPE,LE MOULE,0,11218,11218,
Musée Benoît de Puydt,2017,HAUTS-DE-FRANCE,BAILLEUL,1475,3199,4674,
Musée d'Archéologie et d'Histoire Locale,2017,HAUTS-DE-FRANCE,DENAIN,0,3895,3895,
Musée du Dessin et de l'Estampe Originale,2017,HAUTS-DE-FRANCE,GRAVELINES,3094,6627,9721,
Musée Départemental Matisse,2017,HAUTS-DE-FRANCE,LE CATEAU-CAMBRESIS,15161,37760,52921,
Musée de l'Hospice Comtesse,2017,HAUTS-DE-FRANCE,LILLE,33100,18110,51210,
Palais des Beaux-Arts de Lille,2017,HAUTS-DE-FRANCE,LILLE,106189,147628,253817,
La Piscine - Musée d'Art et d'Industrie André Diligent de Roubaix,2017,HAUTS-DE-FRANCE,ROUBAIX,52546,138322,190868,
Musée du Château de Compiègne,2017,HAUTS-DE-FRANCE,COMPIEGNE,54130,34468,88598,
Musée Antoine Vivenel,2017,HAUTS-DE-FRANCE,COMPIEGNE,1437,14063,15500,
Musée de l'Archerie et de l'Art Sacré,2017,HAUTS-DE-FRANCE,CREPY-EN-VALOIS,2960,4022,6982,
Musée de la Vénerie,2017,HAUTS-DE-FRANCE,SENLIS,2145,3294,5439,
Musée Régional d'Ethnologie,2017,HAUTS-DE-FRANCE,BETHUNE,0,1980,1980,
Musée d'Histoire et d'Archéologie,2017,HAUTS-DE-FRANCE,HARNES,0,1123,1123,
Musée de l'Hôtel Sandelin,2017,HAUTS-DE-FRANCE,SAINT-OMER,8456,8777,17233,
Musée Jean-Charles Cazin,2017,HAUTS-DE-FRANCE,SAMER,0,520,520,
Musée Lombart,2017,HAUTS-DE-FRANCE,DOULLENS,302,3939,4241,
Musée Dunoyer de Segonzac,2017,ILE-DE-FRANCE,BOUSSY-SAINT-ANTOINE,0,70,70,
Fondation Arp,2017,ILE-DE-FRANCE,CLAMART,1620,574,2194,
Musée Municipal d'Art et d'Histoire,2017,ILE-DE-FRANCE,COLOMBES,0,9187,9187,
Musée du Moyen Age-Thermes et Hôtel de Cluny,2017,ILE-DE-FRANCE,PARIS,124765,120149,244914,
Musée Bourdelle,2017,ILE-DE-FRANCE,PARIS,97436,20000,117436,
Musée de Montmartre,2017,ILE-DE-FRANCE,PARIS,98587,16048,114635,
Musée de la Musique,2017,ILE-DE-FRANCE,PARIS,169861,80955,250816,
"Musée Cognacq-Jay, Musée du XVIIIe siècle de la ville de Paris",2017,ILE-DE-FRANCE,PARIS,33957,44459,78416,
Musée des Plans et Reliefs,2017,ILE-DE-FRANCE,PARIS,93382,2932,96314,
Établissement Public de la Porte Dorée - Musée de National de l’Histoire de l’Immigration,2017,ILE-DE-FRANCE,PARIS,80532,105295,185827,
Musée de la Chasse et de la Nature,2017,ILE-DE-FRANCE,PARIS,53196,65875,119071,
Musée d'Art et d'Histoire du Judaïsme,2017,ILE-DE-FRANCE,PARIS,58587,40920,99507,
Musée de l'Ecole Nationale Supérieure des Beaux-Arts,2017,ILE-DE-FRANCE,PARIS,0,50000,50000,
Musée du Service de Santé des Armées du Val-de-Grâce,2017,ILE-DE-FRANCE,PARIS,6359,18611,24970,
L'Adresse Musée de la Poste,2017,ILE-DE-FRANCE,PARIS,0,30084,30084,
Château-musée de Nemours,2017,ILE-DE-FRANCE,NEMOURS,6279,5568,11847,
Musée de la Résistance Nationale,2017,ILE-DE-FRANCE,CHAMPIGNY-SUR-MARNE,0,213,213,
Musée Fragonard,2017,ILE-DE-FRANCE,MAISONS-ALFORT,4556,2067,6623,
Musée de Nogent-Sur-Marne,2017,ILE-DE-FRANCE,NOGENT-SUR-MARNE,467,5907,6374,
Musée de la Renaissance - Château d'Ecouen,2017,ILE-DE-FRANCE,ECOUEN,15365,42479,57844,
Musée d'Art et d'Histoire Louis Senlecq,2017,ILE-DE-FRANCE,L'ISLE-ADAM,744,3684,4428,
Musée Camille Pissarro,2017,ILE-DE-FRANCE,PONTOISE,2224,2543,4767,
Musée de la Ville,2017,ILE-DE-FRANCE,MONTIGNY LE BRETONNEUX,1806,6671,8477,
Musée Municipal - Collections Paul et André Véra,2017,ILE-DE-FRANCE,SAINT-GERMAIN-EN-LAYE,0,9227,9227,
Collections de la Fondation de Coubertin,2017,ILE-DE-FRANCE,SAINT-REMY-LES-CHEVREUSE,682,312,994,
Musée Historique de Villèle,2017,LA REUNION,SAINT-GILLES-LES-HAUTS,19590,19936,39526,
Musée Volcanologique Franck Arnold Perret,2017,MARTINIQUE,SAINT-PIERRE,15873,0,15873,
Musée d'Initiation à la Nature,2017,NORMANDIE,CAEN,0,4764,4764,
Paléospace / Musée Paléontologique,2017,NORMANDIE,VILLERS-SUR-MER,50543,7663,58206,
Musée du Verre et de la Pierre,2017,NORMANDIE,CONCHES-EN-OUCHE,1741,2672,4413,
Musée Municipal d'Avranches,2017,NORMANDIE,AVRANCHES,0,4195,4195,
Musée Richard Anacréon,2017,NORMANDIE,GRANVILLE,7755,6944,14699,
Ferme-Musée du Cotentin,2017,NORMANDIE,SAINTE-MERE-EGLISE,8066,1770,9836,
Musée des Beaux-Arts,2017,NORMANDIE,SAINT-LO,1611,8236,9847,
Musée du Château,2017,NORMANDIE,TORIGNI-SUR-VIRE,0,620,620,
Château-Musée de Dieppe,2017,NORMANDIE,DIEPPE,14293,16748,31041,
Abbaye de Graville - Musée du Prieuré de Graville,2017,NORMANDIE,LE HAVRE,3013,5833,8846,
Muséum d'Histoire Naturelle,2017,NORMANDIE,LE HAVRE,25300,23000,48300,
Musée des Sapeurs-Pompiers de France,2017,NORMANDIE,MONTVILLE,5699,4442,10141,
Musée Industriel de la Corderie Vallois,2017,NORMANDIE,NOTRE-DAME-DE-BONDEVILLE,2562,7213,9775,
Musée des Antiquités de la Seine-Maritime,2017,NORMANDIE,ROUEN,5144,22814,27958,
Musée des Beaux-Arts,2017,NORMANDIE,ROUEN,28881,137642,166523,
Musée des Beaux-Arts,2017,NOUVELLE-AQUITAINE,ANGOULEME,17001,39048,56049,
Musée Régional de Fouras,2017,NOUVELLE-AQUITAINE,FOURAS,8001,1560,9561,
Ancienne École de médecine navale - Musée national de la Marine,2017,NOUVELLE-AQUITAINE,ROCHEFORT,5029,5428,10457,
Hôtel Hèbre de Saint-Clément - Musée d'Art et d'Histoire,2017,NOUVELLE-AQUITAINE,ROCHEFORT,11679,6253,17932,
Musée Ernest Cognacq,2017,NOUVELLE-AQUITAINE,SAINT-MARTIN-DE-RE,8255,5261,13516,
Musée ethnographique et archéologique du Donjon,2017,NOUVELLE-AQUITAINE,NIORT,10029,9744,19773,
Musée Henri Barré,2017,NOUVELLE-AQUITAINE,THOUARS,534,2090,2624,
Musée National de la Préhistoire,2017,NOUVELLE-AQUITAINE,LES EYZIES-DE-TAYAC,37087,29675,66762,
Musée Militaire - Souvenir du Périgord,2017,NOUVELLE-AQUITAINE,PERIGUEUX,2086,783,2869,
Musée d'Art et d'Archéologie du Périgord (MAAP),2017,NOUVELLE-AQUITAINE,PERIGUEUX,8082,15691,23773,
Musée de la Voiture à Cheval. Au temps des calèches,2017,NOUVELLE-AQUITAINE,BOURG-SUR-GIRONDE,3017,1909,4926,
Musée des Beaux-Arts et d'Archéologie,2017,NOUVELLE-AQUITAINE,LIBOURNE,0,21357,21357,
Cité de la céramique - Sèvres & Limoges - Musée National Adrien Dubouché,2017,NOUVELLE-AQUITAINE,LIMOGES,12933,17447,30380,
Musée Départemental d'Histoire et d'Archéologie,2017,NOUVELLE-AQUITAINE,HASTINGUES,6110,2804,8914,
Musée de la Chalosse,2017,NOUVELLE-AQUITAINE,MONTFORT-EN-CHALOSSE,2189,5054,7243,
Ecomusée de la Grande Lande,2017,NOUVELLE-AQUITAINE,SABRES,85988,17210,103198,
Musée d'Art et d'Histoire du Cap de Gascogne,2017,NOUVELLE-AQUITAINE,SAINT-SEVER,0,2300,2300,
Musée Municipal du Lac,2017,NOUVELLE-AQUITAINE,SANGUINET,2275,1327,3602,
Musée de Préhistoire Mésolithique Laurent Coulonges,2017,NOUVELLE-AQUITAINE,SAUVETERRE-LA-LEMANCE,2324,326,2650,
Musée Municipal (Moulin de Gajac),2017,NOUVELLE-AQUITAINE,VILLENEUVE-SUR-LOT,4098,1683,5781,
Muséum d'Histoire Naturelle,2017,NOUVELLE-AQUITAINE,BAYONNE,0,23495,23495,
Musée Basque et de l'Histoire de Bayonne,2017,NOUVELLE-AQUITAINE,BAYONNE,22787,39359,62146,
Musée Edmond Rostand,2017,NOUVELLE-AQUITAINE,CAMBO-LES-BAINS,81407,7292,88699,
Musée Bernadotte,2017,NOUVELLE-AQUITAINE,PAU,543,472,1015,
Eburomagus Musée Archéologique,2017,OCCITANIE,BRAM,648,2272,2920,
Musée des Beaux-Arts,2017,OCCITANIE,CARCASSONNE,0,64928,64928,
Musée-Bibliothèque Pierre-André Benoît,2017,OCCITANIE,ALES,1615,10730,12345,
Musée du Colombier,2017,OCCITANIE,ALES,589,10224,10813,
Musée Municipal de la Vignasse,2017,OCCITANIE,BEAUCAIRE,587,1673,2260,
Musée des Cultures Taurines (Annexe musée du Vieux Nîmes),2017,OCCITANIE,NIMES,16349,0,16349,
Carré d'Art Musée d'Art Contemporain de Nîmes,2017,OCCITANIE,NIMES,10087,43268,53355,
Musée d'Histoire Naturelle et de Préhistoire,2017,OCCITANIE,NIMES,2448,36142,38590,
Musée de la Maison Romane,2017,OCCITANIE,SAINT-GILLES-DU-GARD,17,4,21,
Musée des Vallées Cévenoles,2017,OCCITANIE,SAINT-JEAN DU GARD,7081,5167,12248,
Musée Pierre de Luxembourg,2017,OCCITANIE,VILLENEUVE-LES-AVIGNON,2838,2811,5649,
Musée des Beaux-Arts et des Arts Décoratifs,2017,OCCITANIE,MIRANDE,0,3015,3015,
Musée Municipal,2017,OCCITANIE,MARTRES-TOLOSANE,0,1285,1285,
Musée des Augustins,2017,OCCITANIE,TOULOUSE,92923,73663,166586,
Musée de la Cloche et de la Sonnaille,2017,OCCITANIE,HEREPIAN,2449,2042,4491,
Maison des Consuls - Musée d’Arts et d’Archéologie,2017,OCCITANIE,LES MATELLES,2284,1927,4211,
Musée de l'Hôtel d'Espeyran (Annexe musée Fabre),2017,OCCITANIE,MONTPELLIER,13242,1404,14646,
Musée Archéologique Paul Soyris,2017,OCCITANIE,MURVIEL-LES-MONTPELLIER,316,1954,2270,
Musée d'Histoire de Figeac,2017,OCCITANIE,FIGEAC,470,449,919,
Musée Municipal,2017,OCCITANIE,VAYRAC,115,0,115,
Musée départemental d'Art Moderne,2017,OCCITANIE,CERET,56167,23686,79853,
Musée d'Art Moderne - Fonds Peskè,2017,OCCITANIE,COLLIOURE,9548,2683,12231,
Musée des Monnaies et Médailles Joseph Puig,2017,OCCITANIE,PERPIGNAN,0,1424,1424,
Musée du Castillet Casa Pairal,2017,OCCITANIE,PERPIGNAN,17518,18122,35640,
Musée de Cerdagne,2017,OCCITANIE,SAINTE-LEOCADIE,3387,723,4110,
Muséum d'histoire naturelle Philadelphe Thomas,2017,OCCITANIE,GAILLAC,1058,3734,4792,
Musée Ingres,2017,OCCITANIE,MONTAUBAN,0,18467,18467,
Musée du Pays de Guérande et de la Porte Saint Michel,2017,PAYS DE LA LOIRE,GUERANDE,28840,10741,39581,
Musée du Vignoble Nantais,2017,PAYS DE LA LOIRE,LE PALLET,3022,6403,9425,
Muséum d'Histoire Naturelle de Nantes,2017,PAYS DE LA LOIRE,NANTES,38000,80000,118000,
Musée d'Art de Nantes,2017,PAYS DE LA LOIRE,NANTES,194634,60323,254957,
Musée Jean Lurcat et de la Tapisserie Contemporaine,2017,PAYS DE LA LOIRE,ANGERS,19234,39318,58552,
Musée des Tisserands Mayennais,2017,PAYS DE LA LOIRE,AMBRIERES-LES-VALLEES,202,113,315,
Musée Vert Véron-de-Forbonnais,2017,PAYS DE LA LOIRE,LE MANS,12903,12789,25692,
Musée Espace Faïence de Malicorne,2017,PAYS DE LA LOIRE,MALICORNE-SUR-SARTHE,4536,6521,11057,
Bibliothèque-musée,2017,PAYS DE LA LOIRE,SAINT-CALAIS,0,3506,3506,
Musée de la Folie Marco,2001,ALSACE,BARR,2319,1067,3386,
Musée de la Porte de Thann,2001,ALSACE,CERNAY,1725,0,1725,
Musée Bartholdi,2001,ALSACE,COLMAR,7309,3025,10334,
Château de Bourdeilles,2001,AQUITAINE,BOURDEILLES,25508,0,25508,
Musée Fernand Desmoulin,2001,AQUITAINE,BRANTOME,1906,0,1906,
Musée Militaire - Souvenir du Périgord,2001,AQUITAINE,PERIGUEUX,2516,0,2516,
Muséum d'Histoire Naturelle de Bordeaux,2001,AQUITAINE,BORDEAUX,3841,27356,31197,
Centre National Jean Moulin,2001,AQUITAINE,BORDEAUX,0,22648,22648,
Musée de Borda,2001,AQUITAINE,DAX,6853,4495,11348,
Atelier-Musée  (Ecomusée de la Grande Landes),2001,AQUITAINE,LUXEY,8903,0,8903,
Musée Basque et de l'Histoire de Bayonne,2001,AQUITAINE,BAYONNE,23907,8373,32280,
Musée des Sciences,2001,AUVERGNE,AURILLAC,17179,4630,21809,
Ecomusée de Margeride-Haute-Auvergne,2001,AUVERGNE,RUYNES-EN-MARGERIDE,18558,0,18558,
Musée d'art et d'histoire Alfred Douët,2001,AUVERGNE,SAINT-FLOUR,6316,0,6316,
Musée de la Dentelle,2001,AUVERGNE,ARLANC,2786,264,3050,
Musée Francisque Mandet,2001,AUVERGNE,RIOM,7822,0,7822,
Musée Régional d'Auvergne,2001,AUVERGNE,RIOM,3128,0,3128,
Musée du Vin de Bourgogne,2001,BOURGOGNE,BEAUNE,29629,4260,33889,
"Musée de la Vie Bourguignonne, Perrin de Puycousin",2001,BOURGOGNE,DIJON,6211,23602,29813,
Musée Magnin,2001,BOURGOGNE,DIJON,4535,6614,11149,
Musée Archéologique,2001,BOURGOGNE,DIJON,4483,14852,19335,
Musée des Beaux-Arts,2001,BOURGOGNE,MONTBARD,152,186,338,
Musée Municipal François Pompon,2001,BOURGOGNE,SAULIEU,3391,1312,4703,
Musée du Costume,2001,BOURGOGNE,CHATEAU-CHINON,4922,937,5859,
Musée Municipal,2001,BOURGOGNE,LA CHARITE-SUR-LOIRE,0,7608,7608,
Musée de la Mine,2001,BOURGOGNE,LA MACHINE,6907,974,7881,
Musée de la Faïence et des Beaux-Arts,2001,BOURGOGNE,NEVERS,3895,4481,8376,
Musée Auguste Grasset,2001,BOURGOGNE,VARZY,1127,2856,3983,
Musée de la Mine,2001,BOURGOGNE,BLANZY,11879,2493,14372,
Musée Denon,2001,BOURGOGNE,CHALON-SUR-SAONE,1574,7951,9525,
Musée d'Art et d'Archéologie,2001,BOURGOGNE,CLUNY,79124,18240,97364,
Musée Bourguignon -  Perrin de Puycousin,2001,BOURGOGNE,TOURNUS,3756,0,3756,
Hôtel Dieu - Musée Greuze,2001,BOURGOGNE,TOURNUS,9610,2679,12289,
Musée d'Art et d'Histoire,2001,BOURGOGNE,AUXERRE,14721,20188,34909,
Musée d'Art et d'Histoire du Puisaye,2001,BOURGOGNE,VILLIERS-SAINT-BENOIT,1777,1440,3217,
Le Port-Musée,2001,BRETAGNE,DOUARNENEZ,32083,0,32083,
Musée des Phares et Balises,2001,BRETAGNE,OUESSANT,20858,0,20858,
Ecomusée du Pays de Montfort,2001,BRETAGNE,MONTFORT-SUR-MEU,3667,422,4089,
Musée des Beaux-Arts,2001,BRETAGNE,RENNES,18609,36314,54923,
Musée de Bretagne,2001,BRETAGNE,RENNES,14455,5875,20330,
Musée d'Histoire et d'Archéologie de Vannes,2001,BRETAGNE,VANNES,3933,695,4628,
Musée Estève,2001,CENTRE,BOURGES,0,17890,17890,
Musée des Meilleurs Ouvriers de France,2001,CENTRE,BOURGES,0,23702,23702,
Musée du Château Charles VII,2001,CENTRE,MEHUN-SUR-YEVRE,9300,0,9300,
Musée de l'Hospice Saint-Roch,2001,CENTRE,ISSOUDUN,0,16409,16409,
Musée George Sand et de la Vallée Noire,2001,CENTRE,LA CHATRE,4357,1481,5838,
Musée de l'Hôtel des Communes,2001,CENTRE,AMBOISE,0,1983,1983,
Musée du Vieux Chinon,2001,CENTRE,CHINON,2000,0,2000,
Musée Lansyer,2001,CENTRE,LOCHES,2673,0,2673,
Musée de Sologne,2001,CENTRE,ROMORANTIN-LANTHENAY,5211,7107,12318,
Musée Daniel Vannier,2001,CENTRE,BEAUGENCY,2907,1647,4554,
Musée Girodet,2001,CENTRE,MONTARGIS,1061,870,1931,
Musée des Sciences Naturelles,2001,CENTRE,ORLEANS,7929,59374,67303,
Musée Arthur Rimbaud,2001,CHAMPAGNE-ARDENNES,CHARLEVILLE-MEZIERES,7605,0,7605,
Pharmacie Musée de l'Hôtel-Dieu,2001,CHAMPAGNE-ARDENNES,TROYES,2231,2062,4293,
Musée Municipal,2001,CHAMPAGNE-ARDENNES,CHALONS-EN-CHAMPAGNE,6572,0,6572,
Musée des Beaux-Arts de Saint-Denis,2001,CHAMPAGNE-ARDENNES,REIMS,12372,22266,34638,
Musée de la résistance et de la Déportation,2001,FRANCHE-COMTE,BESANCON,79188,0,79188,
Musée Baron Martin,2001,FRANCHE-COMTE,GRAY,2186,2495,4681,
Musée de la Tour des Echevins,2001,FRANCHE-COMTE,LUXEUIL-LES-BAINS,544,575,1119,
Musée de la Vigne et du Vin,2001,FRANCHE-COMTE,ARBOIS,5099,1051,6150,
Musée des Beaux-Arts,2001,FRANCHE-COMTE,DOLE,0,13224,13224,
Forge-Musée,2001,FRANCHE-COMTE,ETUEFFONT,2830,582,3412,
Musée du Château,2001,ILE-DE-FRANCE,DOURDAN,14408,0,14408,
Musée de l'Île-de-France,2001,ILE-DE-FRANCE,SCEAUX,11800,21487,33287,
Musée national de céramique de Sèvres,2001,ILE-DE-FRANCE,SEVRES,18358,8939,27297,
Musée des Arts et Traditions Populaires,2001,ILE-DE-FRANCE,PARIS,13313,26758,40071,
Musée National Gustave Moreau,2001,ILE-DE-FRANCE,PARIS,15684,8695,24379,
Musée des Thermes et de l'Hôtel de Cluny (arts et techniques du Moyen-Age et de la Renaissance),2001,ILE-DE-FRANCE,PARIS,142603,120433,263036,
Musée de l'Assistance Publique - Hôpitaux de Paris,2001,ILE-DE-FRANCE,PARIS,9617,6359,15976,
Musée National de la Légion d'Honneur et des Ordres de Chevalerie,2001,ILE-DE-FRANCE,PARIS,3160,6897,10057,
Musée Bourdelle,2001,ILE-DE-FRANCE,PARIS,11934,22986,34920,
Maison de Balzac,2001,ILE-DE-FRANCE,PARIS,16716,6973,23689,
Musée de la Franc-Maçonnerie,2001,ILE-DE-FRANCE,PARIS,9500,0,9500,
Palais Galliera - Musée de la Mode de la ville de Paris,2001,ILE-DE-FRANCE,PARIS,41350,20319,61669,
Musée des Arts Décoratifs (Union Centrale des Arts Décoratifs),2001,ILE-DE-FRANCE,PARIS,144390,0,144390,
Musée Nissim de Camondo (Union Centrale des Arts Décoratifs),2001,ILE-DE-FRANCE,PARIS,47938,0,47938,
Musée national d'Orsay,2001,ILE-DE-FRANCE,PARIS,1088049,576629,1664678,
Musée d'Art Moderne de la ville de Paris,2001,ILE-DE-FRANCE,PARIS,198241,143701,341942,
"Musée Cernuschi, Musée des Arts de l'Asie de la ville de Paris",2001,ILE-DE-FRANCE,PARIS,41377,23331,64708,
Musée d'Art et d'Histoire Militaire,2001,ILE-DE-FRANCE,FONTAINEBLEAU,1712,1416,3128,
Musée d'Art et d'Histoire de Melun,2001,ILE-DE-FRANCE,MELUN,4050,5387,9437,
Musée de l'Air et de l'Espace,2001,ILE-DE-FRANCE,LE BOURGET Cedex,226743,0,226743,
Musée de Saint-Maur - Villa Médicis,2001,ILE-DE-FRANCE,LA VARENNE-SAINT-HILAIRE,0,15743,15743,
Musée du Vieil Argenteuil,2001,ILE-DE-FRANCE,ARGENTEUIL,1045,0,1045,
Musée de la Renaissance - Château d'Ecouen,2001,ILE-DE-FRANCE,ECOUEN,17312,35780,53092,
Musée Promenade Marly/Louveciennes,2001,ILE-DE-FRANCE,LOUVECIENNES,5295,686,5981,
Musée du Jouet Pierre Pinel,2001,ILE-DE-FRANCE,POISSY,23509,0,23509,
Musée Rambolitrain,2001,ILE-DE-FRANCE,RAMBOUILLET,18878,0,18878,
Musée Départemental de la Réunion - Musée Léon Dierx,2001,LA REUNION,SAINT-DENIS,0,12171,12171,
Musée d'Art et d'Histoire,2001,LANGUEDOC-ROUSSILLON,NARBONNE,4445,9563,14008,
Musée Albert André,2001,LANGUEDOC-ROUSSILLON,BAGNOLS-SUR-CEZE,3540,0,3540,
Musée Cévenol,2001,LANGUEDOC-ROUSSILLON,LE VIGAN,4317,1228,5545,
Carré d'Art Musée d'Art Contemporain de Nîmes,2001,LANGUEDOC-ROUSSILLON,NIMES,14907,12883,27790,
Musée d'Histoire Naturelle et de Préhistoire,2001,LANGUEDOC-ROUSSILLON,NIMES,32266,0,32266,
Musée Paul Raymond,2001,LANGUEDOC-ROUSSILLON,PONT-SAINT-ESPRIT,938,280,1218,
Musée Archéologique Henri Prades,2001,LANGUEDOC-ROUSSILLON,LATTES,6563,2657,9220,
Musée départemental d'Art Moderne,2001,LANGUEDOC-ROUSSILLON,CERET,45816,15332,61148,
Musée de Cerdagne,2001,LANGUEDOC-ROUSSILLON,SAINTE-LEOCADIE,3896,601,4497,
Musée de Tautavel,2001,LANGUEDOC-ROUSSILLON,TAUTAVEL,98119,10000,108119,
Musée du Cloître de Tulle André Mazeyrie,2001,LIMOUSIN,TULLE,3033,33625,36658,
Musée Barrois,2001,LORRAINE,BAR-LE-DUC,9000,0,9000,
Musée de la Lutherie,2001,LORRAINE,MIRECOURT,7413,2395,9808,
Musée Régional d'Histoire et d'Ethnologie,2001,MARTINIQUE,FORT-DE-FRANCE - MARTINIQUE-,3294,1732,5026,
Musée Départemental de l'Ariège,2001,MIDI-PYRENEES,FOIX,80909,0,80909,
Musée de la Préhistoire,2001,MIDI-PYRENEES,LE MAS D'AZIL,28599,3039,31638,
Musée d'Archéologie,2001,MIDI-PYRENEES,MONTSEGUR,31679,0,31679,
Musée du Palais des Evêques,2001,MIDI-PYRENEES,SAINT-LIZIER,6752,107,6859,
Musée Régional de Géologie Pierre Vetter,2001,MIDI-PYRENEES,DECAZEVILLE,2651,0,2651,
Musée du Charroi Rural et de l'Artisanat Traditionnel,2001,MIDI-PYRENEES,SALMIECH,0,2432,2432,
Musée des Jacobins,2001,MIDI-PYRENEES,AUCH,5871,4566,10437,
Musée Municipal d'Art et d'Histoire,2001,MIDI-PYRENEES,SAINT-GAUDENS,3486,0,3486,
Musée de Préhistoire de Cabrerets,2001,MIDI-PYRENEES,CABRERETS,80500,500,81000,
Musée Départemental de Cuzals,2001,MIDI-PYRENEES,SAULIAC-SUR-CELE,19750,0,19750,
Musée d'Art et d'Histoire Charles Portal,2001,MIDI-PYRENEES,CORDES-SUR-CIEL,1024,550,1574,
Musée du Vieil Auvillar,2001,MIDI-PYRENEES,AUVILLAR,4001,940,4941,
Musée de l'Ostrevant,2001,NORD-PAS-DE-CALAIS,BOUCHAIN,323,174,497,
Ecomusée de la Région,2001,NORD-PAS-DE-CALAIS,FOURMIES,47676,0,47676,
Musée du Dessin et de l'Estampe Originale,2001,NORD-PAS-DE-CALAIS,GRAVELINES,1525,9178,10703,
Musée de l'Hospice Comtesse,2001,NORD-PAS-DE-CALAIS,LILLE,32264,4289,36553,
Musée Baron Gérard,2001,BASSE-NORMANDIE,BAYEUX,40331,0,40331,
Musée des Beaux-Arts,2001,BASSE-NORMANDIE,CAEN,15992,35147,51139,
Musée de la Meunerie - Moulin de Marcy,2001,BASSE-NORMANDIE,LE MOLAY-LITTRY,6389,1266,7655,
Musée Municipal,2001,BASSE-NORMANDIE,ORBEC,0,3199,3199,
Musée des Beaux-Arts,2001,BASSE-NORMANDIE,SAINT-LO,1053,1953,3006,
Musée Barbey d'Aurevilly,2001,BASSE-NORMANDIE,SAINT-SAUVEUR-LE-VICOMTE,913,0,913,
Musée Maritime de l'Ile de Tatihou,2001,BASSE-NORMANDIE,SAINT-VAAST-LA-HOUGUE,47000,0,47000,
Musée de la Poeslerie,2001,BASSE-NORMANDIE,VILLEDIEU-LES-POELES-ROUFFIGNY,8514,0,8514,
Musée des Beaux-Arts et de la Dentelle,2001,BASSE-NORMANDIE,ALENCON,14306,9365,23671,
Musée municipal de Vernon,2001,HAUTE-NORMANDIE,VERNON,2299,5251,7550,
Musée Industriel de la Corderie Vallois,2001,HAUTE-NORMANDIE,NOTRE-DAME-DE-BONDEVILLE,3675,9187,12862,
Musée des Antiquités de la Seine-Maritime,2001,HAUTE-NORMANDIE,ROUEN,4063,26224,30287,
Musée des Beaux-Arts,2001,HAUTE-NORMANDIE,ROUEN,44072,33425,77497,
Musée-Maison Natale Pierre Corneille,2001,HAUTE-NORMANDIE,ROUEN,785,3310,4095,
Musée Flaubert et d'Histoire de la Médecine,2001,HAUTE-NORMANDIE,ROUEN,2583,3174,5757,
Musée de la Céramique,2001,HAUTE-NORMANDIE,ROUEN,10739,0,10739,
Musée Municipal des Ivoires,2001,HAUTE-NORMANDIE,YVETOT,305,172,477,
Musées du Parc Naturel Régional de Brière,2001,PAYS DE LA LOIRE,SAINT-JOACHIM,3647,0,3647,
Maison de l'Eclusier /Parc Naturel Régional de Brière,2001,PAYS DE LA LOIRE,SAINT-MALO DE GUERSAC,6908,0,6908,
Musée du Textile,2001,PAYS DE LA LOIRE,CHOLET,5192,5963,11155,
Musée de l'Ardoise et de la Géologie,2001,PAYS DE LA LOIRE,RENAZE,3895,1500,5395,
Musée de la Reine Bérengère,2001,PAYS DE LA LOIRE,LE MANS,3168,4787,7955,
Centre Minier de Faymoreau,2001,PAYS DE LA LOIRE,FAYMOREAU,23189,2177,25366,
Musée Vendéen,2001,PAYS DE LA LOIRE,FONTENAY-LE-COMTE,2147,3638,5785,
Musée des Traditions de l'Île,2001,PAYS DE LA LOIRE,LA GUERINIERE,8586,138,8724,
Musée Jean de la Fontaine,2001,PICARDIE,CHATEAU-THIERRY,7318,2789,10107,
Familistère de Guise,2001,PICARDIE,GUISE,17523,0,17523,
Musée Gallé-Juillet,2001,PICARDIE,CREIL,2703,457,3160,
Musée de la Vénerie,2001,PICARDIE,SENLIS,3566,1609,5175,
Musée Départemental de l'Abbaye de Saint-Riquier,2001,PICARDIE,ABBEVILLE,0,24731,24731,
Atelier - Musée du Papier,2001,POITOU-CHARENTES,ANGOULEME,0,12940,12940,
Musée Régional de Fouras,2001,POITOU-CHARENTES,FOURAS,5772,604,6376,
Musée Cappon,2001,POITOU-CHARENTES,MARANS,56,0,56,
Musée d'Art et d'Histoire,2001,POITOU-CHARENTES,ROCHEFORT,0,8713,8713,
Musée ethnographique et archéologique du Donjon,2001,POITOU-CHARENTES,NIORT,4121,12745,16866,
Musée de Salagon,2001,PROVENCE-ALPES-CÔTE D'AZUR,MANE,27421,4468,31889,
Musée de la Faïence,2001,PROVENCE-ALPES-CÔTE D'AZUR,MOUSTIERS-SAINTE-MARIE,13137,1974,15111,
Musée archéologique,2001,PROVENCE-ALPES-CÔTE D'AZUR,VACHERES,2134,0,2134,
Musée Fernand Léger,2001,PROVENCE-ALPES-CÔTE D'AZUR,BIOT,17043,4313,21356,
Villa-Musée Jean-Honoré Fragonard,2001,PROVENCE-ALPES-CÔTE D'AZUR,GRASSE,2405,1078,3483,
Musée Archéologique - Site de  Cimiez,2001,PROVENCE-ALPES-CÔTE D'AZUR,NICE,9393,12880,22273,
Ecomusée du Pays de la Roudoule,2001,PROVENCE-ALPES-CÔTE D'AZUR,PUGET-ROSTANG,6010,2214,8224,
Musée Picasso la guerre et la paix à Vallauris,2001,PROVENCE-ALPES-CÔTE D'AZUR,VALLAURIS,24344,7860,32204,
Musée Frédéric Mistral,2001,PROVENCE-ALPES-CÔTE D'AZUR,MAILLANE,3202,1000,4202,
Musée de l'Empéri de Salon et de la Crau,2001,PROVENCE-ALPES-CÔTE D'AZUR,SALON-DE-PROVENCE,11987,4594,16581,
Muséum d'Histoire Naturelle de Toulon,2001,PROVENCE-ALPES-CÔTE D'AZUR,TOULON,0,19364,19364,
Musée d'Art et d'Archéologie,2001,PROVENCE-ALPES-CÔTE D'AZUR,TOULON,0,29669,29669,
Musée du Petit Palais,2001,PROVENCE-ALPES-CÔTE D'AZUR,AVIGNON,22184,7562,29746,
Musée Sobirats,2001,PROVENCE-ALPES-CÔTE D'AZUR,CARPENTRAS,785,0,785,
Musée de l'Hôtel Dieu,2001,PROVENCE-ALPES-CÔTE D'AZUR,CAVAILLON,734,0,734,
Musée Municipal,2001,PROVENCE-ALPES-CÔTE D'AZUR,ORANGE,76737,1131,77868,
Musée Municipal,2001,PROVENCE-ALPES-CÔTE D'AZUR,SAULT,0,1000,1000,
Musée Archéologique Théo Desplans,2001,PROVENCE-ALPES-CÔTE D'AZUR,VAISON-LA-ROMAINE,84994,0,84994,
Musée de la Société d'Histoire et d'Archéologie,2001,RHONE-ALPES,BRIORD,62,38,100,
Musée Vivarois César Filhol,2001,RHONE-ALPES,ANNONAY,971,1863,2834,
Musée d'Histoire et d'Archéologie,2001,RHONE-ALPES,DIE,609,287,896,
Musée d'Art Sacré,2001,RHONE-ALPES,MOURS SAINT-EUSEBE,2922,0,2922,
Musée du Chablais,2001,RHONE-ALPES,THONON-LES-BAINS,2410,0,2410,
Musée d'Huez et de l'Oisans,2001,RHONE-ALPES,ALPE D'HUEZ,3801,329,4130,
Musée Archéologique Grenoble Saint-Laurent,2001,RHONE-ALPES,GRENOBLE,5628,8332,13960,
Musée de Grenoble,2001,RHONE-ALPES,GRENOBLE,56538,81404,137942,
Musée de la Grande Chartreuse,2001,RHONE-ALPES,SAINT-PIERRE-DE-CHARTREUSE,67558,0,67558,
Conservatoire - Musée des Industries Hydroélectriques,2001,RHONE-ALPES,VAUJANY,0,12073,12073,
Centre d'Histoire de la Résistance et de la Déportation,2001,RHONE-ALPES,LYON,17070,37709,54779,
Musée des Charmettes,2001,RHONE-ALPES,CHAMBERY,2488,4245,6733,
Maison de l'Archéologie des Vosges du Nord,2002,ALSACE,NIEDERBRONN-LES-BAINS,2273,977,3250,
Musée de l'Image Populaire de Pfaffenhoffen,2002,ALSACE,PFAFFENHOFFEN,2319,1384,3703,
Musée Archéologique,2002,ALSACE,STRASBOURG,12899,23626,36525,
Musée de la Porte de Thann,2002,ALSACE,CERNAY,1442,0,1442,
Cité du Train,2002,ALSACE,MULHOUSE,75215,16559,91774,
Musée Minéralogique de la Société Industrielle de Mulhouse,2002,ALSACE,MULHOUSE,0,50,50,
Musée du Papier Peint,2002,ALSACE,RIXHEIM,6911,4857,11768,
Musée du Tabac,2002,AQUITAINE,BERGERAC,5741,2538,8279,
Musée Paul Reclus,2002,AQUITAINE,DOMME,19210,0,19210,
Musée des Arts Décoratifs,2002,AQUITAINE,BORDEAUX,11421,27269,38690,
Musée de la Chalosse,2002,AQUITAINE,MONTFORT-EN-CHALOSSE,10215,1338,11553,
Ecomusée de la Grande Lande,2002,AQUITAINE,SABRES,96005,9339,105344,
Musée d'Art et d'Histoire du Cap de Gascogne,2002,AQUITAINE,SAINT-SEVER,0,2000,2000,
Musée des Beaux-Arts,2002,AQUITAINE,AGEN,6116,9530,15646,
Musée Municipal des Beaux-Arts,2002,AQUITAINE,PAU,10295,10505,20800,
Musée Bernadotte,2002,AQUITAINE,PAU,1561,1634,3195,
Musée de Paléontologie,2002,AUVERGNE,CHILHAC,3074,0,3074,
Musée d'Archéologie Bargoin,2002,AUVERGNE,CLERMONT-FERRAND,2189,6543,8732,
Musée Francisque Mandet,2002,AUVERGNE,RIOM,8339,13406,21745,
Musée Municipal de la Coutellerie,2002,AUVERGNE,THIERS,48909,0,48909,
Musée Municipal Marcel Sahut,2002,AUVERGNE,VOLVIC,888,2420,3308,
Musée du Pays Châtillonnais - Trésor de Vix,2002,BOURGOGNE,CHATILLON-SUR-SEINE,15921,4069,19990,
Musée Archéologique,2002,BOURGOGNE,DIJON,5601,17257,22858,
Musée des Beaux-Arts,2002,BOURGOGNE,MONTBARD,1140,678,1818,
Musée de la Mine,2002,BOURGOGNE,LA MACHINE,6341,1440,7781,
Musée de la Mine,2002,BOURGOGNE,BLANZY,11517,3512,15029,
Musée Denon,2002,BOURGOGNE,CHALON-SUR-SAONE,1287,9126,10413,
Ecomusée de la Communauté Le Creusot-Monceau-Les-Mines,2002,BOURGOGNE,LE CREUSOT,15616,5683,21299,
Ecomusée de la Bresse Bourguignonne,2002,BOURGOGNE,PIERRE-DE-BRESSE,24540,6501,31041,
Musée Départemental de Préhistoire de Solutré,2002,BOURGOGNE,SOLUTRE-POUILLY,19174,6033,25207,
Muséum - Maison de l'Eau,2002,BOURGOGNE,AUXERRE,1418,17669,19087,
Musée d'Art et d'Histoire,2002,BOURGOGNE,AUXERRE,13816,23390,37206,
Musée Muncipal,2002,BOURGOGNE,SENS,10776,8599,19375,
Musée Mathurin Meheut,2002,BRETAGNE,LAMBALLE,5964,0,5964,
Musée des Beaux-Arts de Brest,2002,BRETAGNE,BREST,1091,9838,10929,
Ecomusée du Pays de Rennes,2002,BRETAGNE,RENNES,31459,11118,42577,
Musée International du Long-Cours Cap-Hornier,2002,BRETAGNE,SAINT-MALO,7481,3182,10663,
Musée de Préhistoire J. Miln- Z. Le-Rouzic,2002,BRETAGNE,CARNAC,32274,1734,34008,
Musée de la Compagnie des Indes,2002,BRETAGNE,PORT-LOUIS,73051,0,73051,
Musée d'Histoire et d'Archéologie de Vannes,2002,BRETAGNE,VANNES,5186,1976,7162,
Musée du Château Charles VII,2002,CENTRE,MEHUN-SUR-YEVRE,9600,0,9600,
Conservatoire du Machinisme et des Pratiques Agricoles,2002,CENTRE,CHARTRES-MAINVILLIERS,51000,0,51000,
Musée des Beaux-Arts et d'Histoire Naturelle,2002,CENTRE,CHATEAUDUN,6444,8115,14559,
Musée de l'Histoire du Perche,2002,CENTRE,NOGENT-LE-ROTROU,7611,4879,12490,
Musée de l'Hospice Saint-Roch,2002,CENTRE,ISSOUDUN,0,12604,12604,
Musée George Sand et de la Vallée Noire,2002,CENTRE,LA CHATRE,4198,1552,5750,
Musée Ornithologique (Ecomusée de la Brenne),2002,CENTRE,LE BLANC,7770,0,7770,
Musée Balzac,2002,CENTRE,SACHE,25802,2004,27806,
Maison de la Magie,2002,CENTRE,BLOIS,68614,0,68614,
Musée Arthur Rimbaud,2002,CHAMPAGNE-ARDENNES,CHARLEVILLE-MEZIERES,11055,0,11055,
Muséum d'Histoire Naturelle (Musée Pic Saint-Loup),2002,CHAMPAGNE-ARDENNES,TROYES,0,0,0,
Musée d'Art Moderne,2002,CHAMPAGNE-ARDENNES,TROYES,15343,13570,28913,
Musée d'Art et d'Histoire,2002,CHAMPAGNE-ARDENNES,LANGRES,2803,5052,7855,
Musée Municipal,2002,CHAMPAGNE-ARDENNES,SAINT-DIZIER,0,1602,1602,
Musée Municipal,2002,CHAMPAGNE-ARDENNES,CHALONS-EN-CHAMPAGNE,892,6097,6989,
Musée Garinet,2002,CHAMPAGNE-ARDENNES,CHALONS-EN-CHAMPAGNE,1009,0,1009,
Muséum de Besançon,2002,FRANCHE-COMTE,BESANCON,243636,34141,277777,
Musée du Château des Ducs de Wurtemberg,2002,FRANCHE-COMTE,MONTBELIARD,12385,13814,26199,
Musée Départemental de la Montagne Albert Demard,2002,FRANCHE-COMTE,LE HAUT-DU-THEM,5517,4480,9997,
Musée de la Tour des Echevins,2002,FRANCHE-COMTE,LUXEUIL-LES-BAINS,2131,953,3084,
Musée Sarret de Grozon,2002,FRANCHE-COMTE,ARBOIS,0,734,734,
Musée des Beaux-Arts,2002,FRANCHE-COMTE,DOLE,0,15104,15104,
Musée du Jouet,2002,FRANCHE-COMTE,MOIRANS-EN-MONTAGNE,42160,4928,47088,
Musée Frédéric Japy,2002,FRANCHE-COMTE,BEAUCOURT,3134,1013,4147,
Musée d'Art et d'Histoire,2002,FRANCHE-COMTE,BELFORT,17835,0,17835,
Musée Précolombien Edgar Clerc,2002,GUADELOUPE,LE MOULE,0,4839,4839,
Musée Territorial Alexandre Franconie,2002,GUYANE,CAYENNE,4143,3010,7153,
Musée du Château,2002,ILE-DE-FRANCE,DOURDAN,15486,2687,18173,
Musée des Années Trente,2002,ILE-DE-FRANCE,BOULOGNE-BILLANCOURT,48868,0,48868,
Musée National des Châteaux de Malmaison et de Bois-Préau,2002,ILE-DE-FRANCE,RUEIL-MALMAISON,47759,28874,76633,
Maison de Victor Hugo,2002,ILE-DE-FRANCE,PARIS,38178,86452,124630,
Musée National Gustave Moreau,2002,ILE-DE-FRANCE,PARIS,18466,10063,28529,
Musée de l'Assistance Publique - Hôpitaux de Paris,2002,ILE-DE-FRANCE,PARIS,9472,5455,14927,
Musée Nissim de Camondo (Union Centrale des Arts Décoratifs),2002,ILE-DE-FRANCE,PARIS,35455,6425,41880,
Musée National d'Art Moderne (Centre National d'Art et de Culture Georges Pompidou),2002,ILE-DE-FRANCE,PARIS,2469154,0,2469154,
Musée Bossuet,2002,ILE-DE-FRANCE,MEAUX,4772,3429,8201,
Ecomusée,2002,ILE-DE-FRANCE,SAVIGNY-LE-TEMPLE,0,4851,4851,
Musée départemental Stéphane Mallarmé,2002,ILE-DE-FRANCE,VULAINES-SUR-SEINE,3138,715,3853,
Musée Tavet Delacour,2002,ILE-DE-FRANCE,PONTOISE,2677,2662,5339,
Musée de la Batellerie et des Voies Navigables,2002,ILE-DE-FRANCE,CONFLANS-SAINTE-HONORINE,15144,2578,17722,
Musée Promenade Marly/Louveciennes,2002,ILE-DE-FRANCE,LOUVECIENNES,3062,3128,6190,
Musée National de Port Royal des Champs,2002,ILE-DE-FRANCE,MAGNY-LES-HAMEAUX,4988,5852,10840,
Musée Victor Aubert,2002,ILE-DE-FRANCE,MAULE,0,985,985,
Musée Départemental Maurice Denis,2002,ILE-DE-FRANCE,SAINT-GERMAIN-EN-LAYE,21020,2640,23660,
Collections de la Fondation de Coubertin,2002,ILE-DE-FRANCE,SAINT-REMY-LES-CHEVREUSE,6421,0,6421,
Musée Lambinet,2002,ILE-DE-FRANCE,VERSAILLES,5998,6396,12394,
Musée Historique de Villèle,2002,LA REUNION,SAINT-GILLES-LES-HAUTS,14553,17500,32053,
Musée Petiet,2002,LANGUEDOC-ROUSSILLON,LIMOUX,1467,3963,5430,
Musée des Corbières,2002,LANGUEDOC-ROUSSILLON,SIGEAN,0,1400,1400,
Musée du Vieux Nîmes,2002,LANGUEDOC-ROUSSILLON,NIMES,0,11065,11065,
Musée de l'Ephèbe,2002,LANGUEDOC-ROUSSILLON,LE CAP D'AGDE,21863,2753,24616,
Agropolis-Muséum,2002,LANGUEDOC-ROUSSILLON,MONTPELLIER,4819,13698,18517,
Musée départemental d'Art Moderne,2002,LANGUEDOC-ROUSSILLON,CERET,46690,13478,60168,
Musée du Castillet Casa Pairal,2002,LANGUEDOC-ROUSSILLON,PERPIGNAN,12168,14022,26190,
Musée de Tautavel,2002,LANGUEDOC-ROUSSILLON,TAUTAVEL,107890,12947,120837,
Musée Labenche d'Art et d'Histoire,2002,LIMOUSIN,BRIVE-LA-GAILLARDE,3331,13041,16372,
Musée du Président Jacques Chirac,2002,LIMOUSIN,SARRAN,47850,0,47850,
Musée National Adrien Dubouché,2002,LIMOUSIN,LIMOGES,15296,9831,25127,
Musée de l'Ecole de Nancy,2002,LORRAINE,NANCY,29325,18731,48056,
Musée de Zoologie - Aquarium Tropical,2002,LORRAINE,NANCY,33600,16900,50500,
"Musée ""au Fil du Papier""",2002,LORRAINE,PONT-A-MOUSSON,3482,1369,4851,
Musée Jeanne d'Arc,2002,LORRAINE,VAUCOULEURS,696,687,1383,
Musées de la Cour d'Or,2002,LORRAINE,METZ,37253,0,37253,
Musée du Textile et du Peigne en Corne,2002,MIDI-PYRENEES,LAVELANET,3758,230,3988,
Musée des Beaux-Arts et des Arts Décoratifs,2002,MIDI-PYRENEES,MIRANDE,977,548,1525,
"Les Abattoirs, Musée d'Art Moderne et Contemporain",2002,MIDI-PYRENEES,TOULOUSE,30000,64471,94471,
Musée Massey,2002,MIDI-PYRENEES,TARBES,1756,1513,3269,
Musée Henri Martin,2002,MIDI-PYRENEES,CAHORS,1893,6505,8398,
Musée de l'Automate,2002,MIDI-PYRENEES,SOUILLAC,32675,3174,35849,
Musée Eugénie et Maurice Guérin,2002,MIDI-PYRENEES,ANDILLAC,2229,1989,4218,
Musée du protestantisme en Haut-Languedoc,2002,MIDI-PYRENEES,FERRIERES,933,143,1076,
Musée de l'Abbaye Saint-Michel,2002,MIDI-PYRENEES,GAILLAC,4466,1561,6027,
Musée du Pays Vaurais,2002,MIDI-PYRENEES,LAVAUR,2400,0,2400,
Musée du Vieil Auvillar,2002,MIDI-PYRENEES,AUVILLAR,3377,722,4099,
Musée Ingres,2002,MIDI-PYRENEES,MONTAUBAN,31634,0,31634,
Musée Benoît de Puydt,2002,NORD-PAS-DE-CALAIS,BAILLEUL,993,4392,5385,
Musée de l'Ostrevant,2002,NORD-PAS-DE-CALAIS,BOUCHAIN,0,425,425,
Musée d'Archéologie et d'Histoire Locale,2002,NORD-PAS-DE-CALAIS,DENAIN,0,1853,1853,
Musée de la Chartreuse,2002,NORD-PAS-DE-CALAIS,DOUAI,11352,22119,33471,
"Musée de la Mine, Centre Historique Minier",2002,NORD-PAS-DE-CALAIS,LEWARDE,148015,13697,161712,
Palais des Beaux-Arts de Lille,2002,NORD-PAS-DE-CALAIS,LILLE,219610,43395,263005,
Musée Municipal,2002,NORD-PAS-DE-CALAIS,SAINT-AMAND-LES-EAUX,2068,4779,6847,
Musée d'Art Moderne de Lille Métropole,2002,NORD-PAS-DE-CALAIS,VILLENEUVE-D'ASCQ,70760,9252,80012,
Musée Quentovic,2002,NORD-PAS-DE-CALAIS,ETAPLES-SUR-MER,1948,1879,3827,
Musée et Sites archéologiques de Vieux-la-Romaine,2002,BASSE-NORMANDIE,VIEUX,15686,21675,37361,
Musée de la Pomme et de la Poire,2002,BASSE-NORMANDIE,BARENTON,3545,0,3545,
Musée de l'Abbaye,2002,BASSE-NORMANDIE,CERISY-LA-FORET,8723,0,8723,
Musée de la Libération,2002,BASSE-NORMANDIE,CHERBOURG-EN-COTENTIN,4742,3578,8320,
Muséum Emmanuel Liais,2002,BASSE-NORMANDIE,CHERBOURG-EN-COTENTIN,1656,5087,6743,
Musée du Vieux Granville,2002,BASSE-NORMANDIE,GRANVILLE,8769,2036,10805,
Musée des Beaux-Arts et de la Dentelle,2002,BASSE-NORMANDIE,ALENCON,18636,11695,30331,
Musée Municipal d'Archéologie,2002,BASSE-NORMANDIE,L'AIGLE,0,200,200,
Musée Départemental des Arts et Traditions Populaires du Perche,2002,BASSE-NORMANDIE,SAINT-CYR LA ROSIERE,8216,3804,12020,
Musée du Verre et de la Pierre,2002,HAUTE-NORMANDIE,CONCHES-EN-OUCHE,1020,627,1647,
Musée des Arts & de l'Enfance,2002,HAUTE-NORMANDIE,FECAMP,1347,4358,5705,
Musée de l'Hôtel Dubocage de Bléville,2002,HAUTE-NORMANDIE,LE HAVRE,1403,2158,3561,
Muséum d'Histoire Naturelle,2002,HAUTE-NORMANDIE,LE HAVRE,0,19443,19443,
Musée Mathon-Durand,2002,HAUTE-NORMANDIE,NEUFCHATEL-EN-BRAY,558,1185,1743,
Musée National de l'Education,2002,HAUTE-NORMANDIE,ROUEN,16095,0,16095,
Musée Municipal des Ivoires,2002,HAUTE-NORMANDIE,YVETOT,250,0,250,
Muséum d'Histoire Naturelle de Nantes,2002,PAYS DE LA LOIRE,NANTES,14317,25696,40013,
Musées du Parc Naturel Régional de Brière,2002,PAYS DE LA LOIRE,SAINT-JOACHIM,2426,0,2426,
Ecomusée de Saint-Nazaire,2002,PAYS DE LA LOIRE,SAINT-NAZAIRE,0,137680,137680,
Musée d'Art et d'Histoire,2002,PAYS DE LA LOIRE,CHOLET,2122,9094,11216,
Musée des Sciences - CCSTI,2002,PAYS DE LA LOIRE,LAVAL,3400,13269,16669,
Centre Minier de Faymoreau,2002,PAYS DE LA LOIRE,FAYMOREAU,22314,3707,26021,
Ecomusée du Marais Breton Vendéen,2002,PAYS DE LA LOIRE,LA BARRE-DE-MONTS,19911,10734,30645,
Musée des Traditions de l'Île,2002,PAYS DE LA LOIRE,LA GUERINIERE,5836,263,6099,
Musée Clemenceau et de Lattre-de-Tassigny,2002,PAYS DE LA LOIRE,MOUILLERON-EN-PAREDS,2387,2186,4573,
Musée - Centre de Documentation Alfred Desmasures,2002,PICARDIE,HIRSON,0,1303,1303,
Musée Jeanne d'Aboville,2002,PICARDIE,LA FERE,373,159,532,
Musée d'Art et d'Archéologie,2002,PICARDIE,LAON,1932,2806,4738,
Musée Départemental de l'Oise,2002,PICARDIE,BEAUVAIS,5170,10008,15178,
Musée Gallé-Juillet,2002,PICARDIE,CREIL,1334,1695,3029,
Musée de l'Archerie et de l'Art Sacré,2002,PICARDIE,CREPY-EN-VALOIS,2272,826,3098,
Musée Jean Calvin,2002,PICARDIE,NOYON,3098,0,3098,
Musée d'Art et d'Archéologie,2002,PICARDIE,SENLIS,8216,0,8216,
Musée Boucher-de-Perthes,2002,PICARDIE,ABBEVILLE,0,13145,13145,
Musée de la Mytiliculture,2002,POITOU-CHARENTES,ESNANDES,3504,0,3504,
Musée Cappon,2002,POITOU-CHARENTES,MARANS,66,0,66,
Musée de l'Echevinage,2002,POITOU-CHARENTES,SAINTES,1322,4394,5716,
Musée Ernest Cognacq,2002,POITOU-CHARENTES,SAINT-MARTIN-DE-RE,16945,5352,22297,
Musée d'Art et d'Histoire Georges Turpin,2002,POITOU-CHARENTES,PARTHENAY,0,11354,11354,
Musée des Traditions Populaires et d'Archéologie,2002,POITOU-CHARENTES,CHAUVIGNY,9939,0,9939,
Musée archéologique,2002,PROVENCE-ALPES-CÔTE D'AZUR,VACHERES,1855,0,1855,
Musée d'Histoire Locale,2002,PROVENCE-ALPES-CÔTE D'AZUR,BIOT,3359,0,3359,
Musée Départemental des Arts Asiatiques,2002,PROVENCE-ALPES-CÔTE D'AZUR,NICE,18061,18187,36248,
Musée Matisse,2002,PROVENCE-ALPES-CÔTE D'AZUR,NICE,108969,53554,162523,
Musée d'Art Moderne et d'Art Contemporain,2002,PROVENCE-ALPES-CÔTE D'AZUR,NICE,80497,71909,152406,
"Musée Magnelli, Musée de la Céramique",2002,PROVENCE-ALPES-CÔTE D'AZUR,VALLAURIS,22857,7668,30525,
Musée Camarguais,2002,PROVENCE-ALPES-CÔTE D'AZUR,ARLES,18283,5982,24265,
Musée Municipal Méditerranéen de Cassis A.T.P.,2002,PROVENCE-ALPES-CÔTE D'AZUR,CASSIS,163,4260,4423,
Musée d'Histoire et d'Archéologie des Baux-de-Provence,2002,PROVENCE-ALPES-CÔTE D'AZUR,LES BAUX DE PROVENCE,274402,0,274402,
Musée des Docks Romains,2002,PROVENCE-ALPES-CÔTE D'AZUR,MARSEILLE,3178,4622,7800,
Musée des Beaux-Arts de Marseille,2002,PROVENCE-ALPES-CÔTE D'AZUR,MARSEILLE,5253,23250,28503,
Musée d'Histoire de Marseille,2002,PROVENCE-ALPES-CÔTE D'AZUR,MARSEILLE,13307,20460,33767,
Muséum d'Histoire Naturelle,2002,PROVENCE-ALPES-CÔTE D'AZUR,MARSEILLE,6192,30082,36274,
Musée des A.T.P. de Moyenne Provence,2002,PROVENCE-ALPES-CÔTE D'AZUR,DRAGUIGNAN,9786,1820,11606,
Muséum d'Histoire Naturelle Esprit Requien,2002,PROVENCE-ALPES-CÔTE D'AZUR,AVIGNON,0,21897,21897,
Synagogue Musée Juif Comtadin,2002,PROVENCE-ALPES-CÔTE D'AZUR,CAVAILLON,5456,0,5456,
Musée de l'Hôtel Dieu,2002,PROVENCE-ALPES-CÔTE D'AZUR,CAVAILLON,1354,0,1354,
Musée-Bibliothèque François Pétrarque,2002,PROVENCE-ALPES-CÔTE D'AZUR,FONTAINE-DE-VAUCLUSE,3028,0,3028,
Musée Municipal Camille Pautet,2002,PROVENCE-ALPES-CÔTE D'AZUR,MAZAN,0,1350,1350,
Musée Départemental du Cartonnage et de l'Imprimerie,2002,PROVENCE-ALPES-CÔTE D'AZUR,VALREAS,1844,1978,3822,
Musée Archéologique,2002,RHONE-ALPES,IZERNORE,0,118,118,
Musée d'Histoire et d'Archéologie,2002,RHONE-ALPES,DIE,579,794,1373,
Musée d'Art Sacré,2002,RHONE-ALPES,MOURS SAINT-EUSEBE,3165,0,3165,
Musée des Beaux-Arts,2002,RHONE-ALPES,VALENCE,15430,11498,26928,
Musée Léon Marès,2002,RHONE-ALPES,LOVAGNY,26616,0,26616,
Musée des Vallées de Thônes,2002,RHONE-ALPES,THONES,2052,1091,3143,
Musée de la Résistance de la Déportation de l'Isère,2002,RHONE-ALPES,GRENOBLE,3076,18724,21800,
Maison du Patrimoine de Hières-sur-Amby,2002,RHONE-ALPES,HIERES SUR AMBY,3449,0,3449,
Musée de la Grande Chartreuse,2002,RHONE-ALPES,SAINT-PIERRE-DE-CHARTREUSE,68681,0,68681,
Musée des Beaux-Arts et d'Archéologie,2002,RHONE-ALPES,VIENNE,1481,1370,2851,
Musée Alice Taverne,2002,RHONE-ALPES,AMBIERLE,5302,1266,6568,
Musée Hospitalier,2002,RHONE-ALPES,CHARLIEU,4780,1495,6275,
Atelier - Musée du Chapeau,2002,RHONE-ALPES,CHAZELLES-SUR-LYON,17780,3137,20917,
Musée d'Histoire du  20ème Siècle - Résistance et Déportation,2002,RHONE-ALPES,ESTIVAREILLES,3271,764,4035,
Musée d'Art Moderne et Contemporain,2002,RHONE-ALPES,SAINT-ETIENNE,40439,23810,64249,
Musée des Hospices Civils de Lyon,2002,RHONE-ALPES,LYON,10002,2616,12618,
Musées Gadagne,2002,RHONE-ALPES,LYON,17202,18223,35425,
Muséum d'Histoire Naturelle,2002,RHONE-ALPES,LYON,46044,91680,137724,
Musée Henri Malartre,2002,RHONE-ALPES,ROCHETAILLEE-SUR-SAONE,25446,26812,52258,
Musée de la Bataille du 6 Août 1870,2003,ALSACE,WOERTH,4071,403,4474,
Musée d'Histoire Local,2003,ALSACE,KAYSERSBERG,49,165,214,
Musée Historique,2003,ALSACE,MULHOUSE,0,21128,21128,
Musée National de l'Automobile - Collection Schlumpf,2003,ALSACE,MULHOUSE,180008,11114,191122,
Musée Minéralogique de la Société Industrielle de Mulhouse,2003,ALSACE,MULHOUSE,0,80,80,
Musée Vauban,2003,ALSACE,NEUF-BRISACH,2986,0,2986,
Musée du Papier Peint,2003,ALSACE,RIXHEIM,7336,4965,12301,
Musée du Tabac,2003,AQUITAINE,BERGERAC,4587,2555,7142,
Musée Paul Reclus,2003,AQUITAINE,DOMME,16500,0,16500,
Musée du Périgord,2003,AQUITAINE,PERIGUEUX,3750,24535,28285,
Musée d'Art et Traditions Populaires,2003,AQUITAINE,VILLEFRANCHE-DE-LONCHAT,0,1100,1100,
Centre National Jean Moulin,2003,AQUITAINE,BORDEAUX,0,20013,20013,
Musée de la Voiture à Cheval,2003,AQUITAINE,BOURG-SUR-GIRONDE,2657,664,3321,
Musée des Beaux-Arts et d'Archéologie,2003,AQUITAINE,LIBOURNE,0,3141,3141,
Musée Historique de l'Hydravion,2003,AQUITAINE,BISCARROSSE,9093,1414,10507,
Musée Archéologique,2003,AQUITAINE,HASTINGUES,567,225,792,
Musée Despiau-Wlérick,2003,AQUITAINE,MONT-DE-MARSAN,1676,5978,7654,
Musée du Patrimoine Religieux et des Croyances Populaires,2003,AQUITAINE,MOUSTEY,1159,124,1283,
Musée des Beaux-Arts,2003,AQUITAINE,AGEN,17353,0,17353,
Musée du Château Henri IV,2003,AQUITAINE,NERAC,10039,9475,19514,
Musée Municipal des Beaux-Arts,2003,AQUITAINE,PAU,11423,11089,22512,
Musée Municipal de Gannat,2003,AUVERGNE,GANNAT,1368,300,1668,
Musée des Musiques Populaires - MuPop,2003,AUVERGNE,MONTLUCON,3597,1178,4775,
Musée des Arts et Traditions Populaires de Haute Loire,2003,AUVERGNE,LAVAUDIEU,12961,778,13739,
Musée Alésia - Centre d'Interprétation,2003,BOURGOGNE,ALISE-SAINTE-REINE,15255,1659,16914,
Musée Archéologique,2003,BOURGOGNE,DIJON,3962,13702,17664,
Musée Noisot,2003,BOURGOGNE,FIXIN,415,1225,1640,
Musée Municipal,2003,BOURGOGNE,NUITS-SAINT-GEORGES,493,2184,2677,
Musée Municipal,2003,BOURGOGNE,SEMUR-EN-AUXOIS,1547,3330,4877,
Musée de la Faïence et des Beaux-Arts,2003,BOURGOGNE,NEVERS,3729,2613,6342,
Musée Archéologique du Nivernais (Porte du Croux),2003,BOURGOGNE,NEVERS,83,1400,1483,
Ecomusée de la Communauté Le Creusot-Monceau-Les-Mines,2003,BOURGOGNE,LE CREUSOT,19295,0,19295,
Ecomusée de la Bresse Bourguignonne,2003,BOURGOGNE,PIERRE-DE-BRESSE,23830,8172,32002,
Musée Départemental du Compagnonnage,2003,BOURGOGNE,ROMANECHE-THORINS,1647,610,2257,
Musée de l'Avallonnais Jean Després,2003,BOURGOGNE,AVALLON,0,2547,2547,
Musée Mathurin Meheut,2003,BRETAGNE,LAMBALLE,5139,711,5850,
Musée de la Pêche,2003,BRETAGNE,CONCARNEAU,39183,3032,42215,
Musée de Morlaix,2003,BRETAGNE,MORLAIX,9928,15157,25085,
Musée Bigouden,2003,BRETAGNE,PONT-L'ABBE,13619,4111,17730,
Ecomusée du Pays de Montfort,2003,BRETAGNE,MONTFORT-SUR-MEU,2685,1275,3960,
Musée des Beaux-Arts,2003,BRETAGNE,RENNES,18964,37864,56828,
Musée de Préhistoire J. Miln- Z. Le-Rouzic,2003,BRETAGNE,CARNAC,23794,12257,36051,
Ecomusée de l'Île de Groix,2003,BRETAGNE,ILE DE GROIX,7333,1496,8829,
Musée des Arts Décoratifs,2003,CENTRE,BOURGES,0,14631,14631,
Musée Emile Chénon,2003,CENTRE,CHATEAUMEILLANT,949,1301,2250,
Musée Archéologique d'Argentomagus,2003,CENTRE,SAINT-MARCEL,9980,8722,18702,
Musée du Vieux Chinon,2003,CENTRE,CHINON,1000,100,1100,
Musée du Savignéen,2003,CENTRE,SAVIGNE-SUR-LATHAN,1716,245,1961,
Ecomusée du Véron,2003,CENTRE,SAVIGNY-EN-VERON,2338,1200,3538,
Muséum d'Histoire Naturelle,2003,CENTRE,TOURS,6810,16541,23351,
Musée du Compagnonnage,2003,CENTRE,TOURS,39227,9131,48358,
Muséum d'Histoire Naturelle,2003,CENTRE,BLOIS,5999,5871,11870,
Château Musées de Blois,2003,CENTRE,BLOIS,230396,29830,260226,
Musée Daniel Vannier,2003,CENTRE,BEAUGENCY,1593,3466,5059,
Musée Gaston Couté,2003,CENTRE,MEUNG-SUR-LOIRE,116,124,240,
Musée des Sciences Naturelles,2003,CENTRE,ORLEANS,6886,59585,66471,
Musée Arthur Rimbaud,2003,CHAMPAGNE-ARDENNES,CHARLEVILLE-MEZIERES,12180,0,12180,
Musée de l'Ardenne,2003,CHAMPAGNE-ARDENNES,CHARLEVILLE-MEZIERES,66103,0,66103,
Maison de l'Outil  et de la Pensée Ouvrière,2003,CHAMPAGNE-ARDENNES,TROYES,13155,5572,18727,
Musée d'Art Moderne,2003,CHAMPAGNE-ARDENNES,TROYES,17255,14073,31328,
Musée Municipal,2003,CHAMPAGNE-ARDENNES,CHALONS-EN-CHAMPAGNE,587,8659,9246,
Musée des Beaux-Arts de Saint-Denis,2003,CHAMPAGNE-ARDENNES,REIMS,7790,23629,31419,
Musée d'archéologie d'Aleria - Jérôme Carcopino,2003,CORSE,ALERIA,25123,17246,42369,
Musée de la Corse,2003,CORSE,CORTE,50118,8662,58780,
Musée des Beaux-Arts et d'Archéologie,2003,FRANCHE-COMTE,BESANCON,10258,27405,37663,
Musée du Château des Ducs de Wurtemberg,2003,FRANCHE-COMTE,MONTBELIARD,7637,12838,20475,
Musée de Plein Air des Maisons Comtoises,2003,FRANCHE-COMTE,NANCRAY,37469,36320,73789,
Musée Sarret de Grozon,2003,FRANCHE-COMTE,ARBOIS,0,572,572,
Musée Municipal d'Archéologie,2003,FRANCHE-COMTE,CHAMPAGNOLE,1269,0,1269,
Musée du Jouet,2003,FRANCHE-COMTE,MOIRANS-EN-MONTAGNE,36266,2096,38362,
Donation Maurice Jardot,2003,FRANCHE-COMTE,BELFORT,3966,0,3966,
Musée Précolombien Edgar Clerc,2003,GUADELOUPE,LE MOULE,0,1925,1925,
Musée Municipal Saint-John Perse,2003,GUADELOUPE,POINTE-A-PITRE,4357,300,4657,
Musée des Cultures Guyanaises,2003,GUYANE,CAYENNE,0,5366,5366,
Musée des Années Trente,2003,ILE-DE-FRANCE,BOULOGNE-BILLANCOURT,15541,4843,20384,
Musée Municipal d'Art et d'Histoire,2003,ILE-DE-FRANCE,COLOMBES,0,3572,3572,
Musée de l'Île-de-France,2003,ILE-DE-FRANCE,SCEAUX,8687,25655,34342,
Musée de l'Homme (Muséum National d'Histoire Naturelle),2003,ILE-DE-FRANCE,PARIS,102405,32724,135129,
Musée de l'Armée,2003,ILE-DE-FRANCE,PARIS,590658,399992,990650,
Musée de l'Assistance Publique - Hôpitaux de Paris,2003,ILE-DE-FRANCE,PARIS,10598,5726,16324,
Musée National Picasso,2003,ILE-DE-FRANCE,PARIS,228478,166861,395339,
Musée de la Chasse et de la Nature,2003,ILE-DE-FRANCE,PARIS,13005,1995,15000,
Musée National d'Art Moderne (Centre National d'Art et de Culture Georges Pompidou),2003,ILE-DE-FRANCE,PARIS,2482967,0,2482967,
Musée Gatien Bonnet,2003,ILE-DE-FRANCE,LAGNY-SUR-MARNE,0,2245,2245,
Musée d'Art et d'Histoire de Melun,2003,ILE-DE-FRANCE,MELUN,3643,1393,5036,
Musée Municipal,2003,ILE-DE-FRANCE,LIVRY-GARGAN,0,14197,14197,
Musée de l'Histoire Vivante,2003,ILE-DE-FRANCE,MONTREUIL-SOUS-BOIS,2299,0,2299,
Musée de la Batellerie et des Voies Navigables,2003,ILE-DE-FRANCE,CONFLANS-SAINTE-HONORINE,13474,1954,15428,
Musée Victor Aubert,2003,ILE-DE-FRANCE,MAULE,0,1106,1106,
Musée Départemental Maurice Denis,2003,ILE-DE-FRANCE,SAINT-GERMAIN-EN-LAYE,24315,2706,27021,
Musée Lambinet,2003,ILE-DE-FRANCE,VERSAILLES,8969,2979,11948,
Muséum d'Histoire Naturelle,2003,LA REUNION,SAINT-DENIS DE LA REUNION,5961,21229,27190,
Musée des Beaux-Arts,2003,LANGUEDOC-ROUSSILLON,CARCASSONNE,0,24256,24256,
Musée Albert André,2003,LANGUEDOC-ROUSSILLON,BAGNOLS-SUR-CEZE,1715,1234,2949,
Musée Départemental d'Art Sacré du Gard,2003,LANGUEDOC-ROUSSILLON,PONT-SAINT-ESPRIT,1937,7319,9256,
Musée de la Maison Romane,2003,LANGUEDOC-ROUSSILLON,SAINT-GILLES-DU-GARD,0,5454,5454,
Musée Municipal Georges Borias,2003,LANGUEDOC-ROUSSILLON,UZES,991,1046,2037,
Musée des Beaux-Arts de Béziers,2003,LANGUEDOC-ROUSSILLON,BEZIERS,3135,9463,12598,
Musée de la Cloche et de la Sonnaille,2003,LANGUEDOC-ROUSSILLON,HEREPIAN,6725,242,6967,
Agropolis-Muséum,2003,LANGUEDOC-ROUSSILLON,MONTPELLIER,3688,18208,21896,
Musée de Tautavel,2003,LANGUEDOC-ROUSSILLON,TAUTAVEL,94435,11332,105767,
Musée de l'Evêché,2003,LIMOUSIN,LIMOGES,0,38778,38778,
Musée de l'Histoire du Fer,2003,LORRAINE,JARVILLE-LA-MALGRANGE,8803,0,8803,
Musée d'Art et d'Histoire de Toul,2003,LORRAINE,TOUL,2224,3096,5320,
Musée Jeanne d'Arc,2003,LORRAINE,VAUCOULEURS,1098,605,1703,
Musée Départemental du Sel,2003,LORRAINE,MARSAL,11200,0,11200,
Musée Départemental Georges de la Tour,2003,LORRAINE,VIC-SUR-SEILLE,12558,4452,17010,
Musée Départemental d'Art Ancien et Contemporain,2003,LORRAINE,EPINAL Cedex,3674,14364,18038,
Musée du Textile et du Peigne en Corne,2003,MIDI-PYRENEES,LAVELANET,2500,311,2811,
Musée de Bouxwiller et du pays de hanau,2001,ALSACE,BOUXWILLER,1175,215,1390,
Musée de la Forge,2003,MIDI-PYRENEES,MONTGAILHARD,29382,0,29382,
Musée Archéologique,2001,ALSACE,STRASBOURG,17659,19630,37289,
Musée d'Archéologie,2003,MIDI-PYRENEES,LECTOURE,2982,68,3050,
Musée Zoologique de Strasbourg,2001,ALSACE,STRASBOURG,28126,21931,50057,
Musée-château Gaston Phébus,2003,MIDI-PYRENEES,MAUVEZIN,26924,0,26924,
Musée Gallo-Romain,2001,ALSACE,BIESHEIM,1299,5601,6900,
Musée du Vieux Figeac,2003,MIDI-PYRENEES,FIGEAC,693,99,792,
Musée d'Histoire Local,2001,ALSACE,KAYSERSBERG,260,100,360,
Musée Départemental de Cuzals,2003,MIDI-PYRENEES,SAULIAC-SUR-CELE,14132,2648,16780,
Musée Historique,2001,ALSACE,MULHOUSE,0,25390,25390,
Musée de l'Automate,2003,MIDI-PYRENEES,SOUILLAC,25171,3234,28405,
Musée National de l'Automobile - Collection Schlumpf,2001,ALSACE,MULHOUSE,211540,0,211540,
Musée de l'Abbaye Saint-Michel,2003,MIDI-PYRENEES,GAILLAC,3804,2146,5950,
Musée-Aquarium,2001,AQUITAINE,CREYSSE,6527,0,6527,
Musée du Pays Vaurais,2003,MIDI-PYRENEES,LAVAUR,3000,1500,4500,
Musée Théophile Jouglet,2003,NORD-PAS-DE-CALAIS,ANZIN,0,2780,2780,
Musée du Périgord,2001,AQUITAINE,PERIGUEUX,10212,19391,29603,
"Forum Antique de Bavay, Musée Archéologique du Département du Nord",2003,NORD-PAS-DE-CALAIS,BAVAY,9105,4153,13258,
Musée des Beaux-Arts,2001,AQUITAINE,BORDEAUX,17039,23887,40926,
Musée Municipal de Cambrai,2003,NORD-PAS-DE-CALAIS,CAMBRAI,5896,12514,18410,
Ecomusée de la Région,2003,NORD-PAS-DE-CALAIS,FOURMIES,48399,0,48399,
Musée Despiau-Wlérick,2001,AQUITAINE,MONT-DE-MARSAN,2028,8399,10427,
Musée du Dessin et de l'Estampe Originale,2003,NORD-PAS-DE-CALAIS,GRAVELINES,7398,3239,10637,
Musée d'Art et d'Histoire du Cap de Gascogne,2001,AQUITAINE,SAINT-SEVER,0,1950,1950,
Musée Municipal d'Hazebrouck,2003,NORD-PAS-DE-CALAIS,HAZEBROUCK,453,3683,4136,
"Musée de la Mine, Centre Historique Minier",2003,NORD-PAS-DE-CALAIS,LEWARDE,133016,10741,143757,
Musée Municipal du Lac,2001,AQUITAINE,SANGUINET,3124,59,3183,
Musée de l'Hospice Comtesse,2003,NORD-PAS-DE-CALAIS,LILLE,15819,47142,62961,
Musée Municipal Albert Marzelles,2001,AQUITAINE,MARMANDE,0,7630,7630,
Musée des Beaux-Arts,2003,NORD-PAS-DE-CALAIS,VALENCIENNES,35601,21063,56664,
Musée Municipal des Beaux-Arts,2001,AQUITAINE,PAU,10495,7089,17584,
Château musée,2003,NORD-PAS-DE-CALAIS,BOULOGNE-SUR-MER,13566,8931,22497,
Musée Bernadotte,2001,AQUITAINE,PAU,1918,1309,3227,
Musée d'Histoire et d'Archéologie,2003,NORD-PAS-DE-CALAIS,HARNES,0,1036,1036,
Musée Henri Dupuis,2003,NORD-PAS-DE-CALAIS,SAINT-OMER,1063,1593,2656,
Musée des Arts et Traditions Populaires de Haute Loire,2001,AUVERGNE,LAVAUDIEU,13403,559,13962,
Musée Municipal Bruno Danvin,2003,NORD-PAS-DE-CALAIS,SAINT-POL-SUR-TERNOISE,0,2210,2210,
Musée Crozatier,2001,AUVERGNE,LE PUY-EN-VELAY,12437,10628,23065,
Musée du Débarquement,2003,BASSE-NORMANDIE,ARROMANCHES,302612,5216,307828,
Musée des Peintres de l'Ecole de Murols,2001,AUVERGNE,MUROL,3168,235,3403,
Musée Langlois,2003,BASSE-NORMANDIE,BEAUMONT-EN-AUGE,99,0,99,
Musée Municipal Marcel Sahut,2001,AUVERGNE,VOLVIC,1320,2170,3490,
Musée de la Poste et des Techniques de communication,2003,BASSE-NORMANDIE,CAEN,2939,4230,7169,
Musée du Pays Châtillonnais - Trésor de Vix,2001,BOURGOGNE,CHATILLON-SUR-SEINE,14940,3856,18796,
Musée Municipal,2001,BOURGOGNE,NUITS-SAINT-GEORGES,2011,402,2413,
Musée de Normandie,2003,BASSE-NORMANDIE,CAEN,76770,0,76770,
Musée d'Art et d'Histoire Romain Rolland,2001,BOURGOGNE,CLAMECY,1744,500,2244,
Musée d'Initiation à la Nature,2003,BASSE-NORMANDIE,CAEN,0,7500,7500,
Musée d'Ethnographie et d'Arts Populaires et Musée de la Marine,2003,BASSE-NORMANDIE,HONFLEUR,20993,1422,22415,
Musée du Grès de Puisaye,2001,BOURGOGNE,SAINT-AMAND-EN-PUISAYE,2619,363,2982,
Musée de la Mine,2003,BASSE-NORMANDIE,LE MOLAY-LITTRY,6861,1345,8206,
Musée Lamartine,2001,BOURGOGNE,MACON,2267,1603,3870,
Musée Municipal,2003,BASSE-NORMANDIE,ORBEC,0,3136,3136,
Muséum - Maison de l'Eau,2001,BOURGOGNE,AUXERRE,1186,11129,12315,
Musée du Château,2003,BASSE-NORMANDIE,PONTECOULANT,4276,1350,5626,
Musée Leblanc-Duvernois,2001,BOURGOGNE,AUXERRE,1058,1546,2604,
Château de Saint-Germain de Livet,2003,BASSE-NORMANDIE,SAINT-GERMAIN DE LIVET,11486,10254,21740,
Musée des Arts Naïfs et Populaires de Noyers sur Serein,2001,BOURGOGNE,NOYERS-SUR-SEREIN,2370,1183,3553,
Muséum Emmanuel Liais,2003,BASSE-NORMANDIE,CHERBOURG-EN-COTENTIN,0,18053,18053,
Musée National de la Marine,2001,BRETAGNE,BREST,47207,0,47207,
Ecomusée des Monts d'Arrée - Moulins de Kerouat & Maison Cornec de Rivoal,2001,BRETAGNE,COMMANA,17847,5762,23609,
Musée Barbey d'Aurevilly,2003,BASSE-NORMANDIE,SAINT-SAUVEUR-LE-VICOMTE,906,310,1216,
Musée de Morlaix,2001,BRETAGNE,MORLAIX,10810,13556,24366,
Musée Bigouden,2001,BRETAGNE,PONT-L'ABBE,11323,0,11323,
Musée de l'Hôtel Dubocage de Bléville,2003,HAUTE-NORMANDIE,LE HAVRE,4890,0,4890,
Musée des Beaux-Arts,2001,BRETAGNE,QUIMPER,40463,0,40463,
Ecomusée de la Basse-Seine,2003,HAUTE-NORMANDIE,NOTRE-DAME-DE-BLIQUETUIT,25944,6893,32837,
Musée de la Faucillonnaie,2001,BRETAGNE,MONTREUIL-SOUS-PEROUSE,2221,712,2933,
Musée Flaubert et d'Histoire de la Médecine,2003,HAUTE-NORMANDIE,ROUEN,2461,4802,7263,
Musée d'Histoire de la Ville de Saint-Malo,2001,BRETAGNE,SAINT-MALO,22346,5856,28202,
Musée du Château de Vitré,2001,BRETAGNE,VITRE,25836,3617,29453,
Galerie David d'Angers,2003,PAYS DE LA LOIRE,ANGERS,7028,18236,25264,
"La Cohue, Musée des Beaux-Arts de vannes",2001,BRETAGNE,VANNES,20367,8943,29310,
Musée Communal Robert Tatin,2003,PAYS DE LA LOIRE,COSSE-LE-VIVIEN,16368,2101,18469,
Musée des Beaux-Arts,2001,CENTRE,CHARTRES,8316,11000,19316,
Musée de la Reine Bérengère,2003,PAYS DE LA LOIRE,LE MANS,5494,0,5494,
Musée de l'Histoire du Perche,2001,CENTRE,NOGENT-LE-ROTROU,7349,7462,14811,
Ecomusée du Marais Breton Vendéen,2003,PAYS DE LA LOIRE,LA BARRE-DE-MONTS,17732,10562,28294,
Musée de la Chemiserie et de l'Elégance Masculine,2001,CENTRE,ARGENTON-SUR-CREUSE,3648,4171,7819,
Musée ornithologique Charles-Payraudeau,2003,PAYS DE LA LOIRE,LA-CHAIZE-LE-VICOMTE,0,816,816,
Château Musée,2001,CENTRE,AZAY-LE-FERRON,1852,0,1852,
Musée Municipal,2001,CENTRE,SAINTE-MAURE-DE-TOURAINE,93,48,141,
Musée Clemenceau et de Lattre-de-Tassigny,2003,PAYS DE LA LOIRE,MOUILLERON-EN-PAREDS,2236,1460,3696,
Musée du Savignéen,2001,CENTRE,SAVIGNE-SUR-LATHAN,1965,0,1965,
Musée Milcendeau Jean-Yole,2003,PAYS DE LA LOIRE,SOULLANS,1504,1925,3429,
Musée François Rabelais,2001,CENTRE,SEUILLY,14700,0,14700,
Musée Jean de la Fontaine,2003,PICARDIE,CHATEAU-THIERRY,7888,3152,11040,
Musée des Vins de Touraine,2001,CENTRE,TOURS,2195,3155,5350,
Musée d'Art et d'Archéologie,2003,PICARDIE,LAON,1793,3338,5131,
Musée Gaston Couté,2001,CENTRE,MEUNG-SUR-LOIRE,317,276,593,
Maison de l'Outil  et de la Pensée Ouvrière,2001,CHAMPAGNE-ARDENNES,TROYES,15500,0,15500,
Musée Départemental de l'Oise,2003,PICARDIE,BEAUVAIS,6586,9051,15637,
Musée des Beaux-Arts (Musée Pic Saint-Loup),2001,CHAMPAGNE-ARDENNES,TROYES,4756,7510,12266,
Musée du Château de Compiègne,2003,PICARDIE,COMPIEGNE,37986,75154,113140,
Musée Municipal,2001,CHAMPAGNE-ARDENNES,BOURBONNE-LES-BAINS,98,15,113,
Musée d'Art et d'Archéologie,2003,PICARDIE,SENLIS,5969,5968,11937,
Musée de la Coutellerie,2001,CHAMPAGNE-ARDENNES,NOGENT,6300,996,7296,
Musée Archéologique et Historique,2003,POITOU-CHARENTES,ANGOULEME,0,420,420,
Musée de l'Argonne Viard-Morel,2001,CHAMPAGNE-ARDENNES,SAINTE-MENEHOULD,0,1200,1200,
Musée Palais Fesch,2001,CORSE,AJACCIO,41052,11489,52541,
Musée d'Orbigny-Bernon,2003,POITOU-CHARENTES,LA ROCHELLE,1754,6966,8720,
Musée de l'Alta Rocca,2001,CORSE,LEVIE,6429,2150,8579,
Musée de la Maison de Pierre Loti,2003,POITOU-CHARENTES,ROCHEFORT,32082,1645,33727,
Musée Beurnier-Rossel,2001,FRANCHE-COMTE,MONTBELIARD,3363,408,3771,
Musée du Château des Ducs de Wurtemberg,2001,FRANCHE-COMTE,MONTBELIARD,15377,13352,28729,
Musée du Présidial,2003,POITOU-CHARENTES,SAINTES,1117,2528,3645,
Musée de Pontarlier,2001,FRANCHE-COMTE,PONTARLIER,4810,4829,9639,
Musée Départemental Albert-et-Félicie Demard - ATP,2001,FRANCHE-COMTE,CHAMPLITTE,17873,0,17873,
"Musée de la Moto, de l'Automobile et du Vélo",2003,POITOU-CHARENTES,CHATELLERAULT,9885,13651,23536,
Musée Départemental de la Montagne Albert Demard,2001,FRANCHE-COMTE,LE HAUT-DU-THEM,8930,2140,11070,
Musée Charbonneau-Lassay,2003,POITOU-CHARENTES,LOUDUN,209,151,360,
Musée Georges Garret,2001,FRANCHE-COMTE,VESOUL,0,6429,6429,
Musée du baptistère Saint-Jean,2003,POITOU-CHARENTES,POITIERS,14287,0,14287,
Musée des Beaux-Arts,2001,FRANCHE-COMTE,LONS-LE-SAUNIER,1081,3712,4793,
Collection d'Histoire Naturelle,2003,POITOU-CHARENTES,POITIERS,27413,50260,77673,
Musée du Jouet,2001,FRANCHE-COMTE,MOIRANS-EN-MONTAGNE,42288,4377,46665,
Musée de la vallée,2003,PROVENCE-ALPES-CÔTE D'AZUR,BARCELONNETTE,14446,3609,18055,
Musée Frédéric Japy,2001,FRANCHE-COMTE,BEAUCOURT,1508,846,2354,
Musée Gassendi,2003,PROVENCE-ALPES-CÔTE D'AZUR,DIGNE-LES-BAINS,4327,0,4327,
Musée Municipal Robert Dubois-Corneau,2001,ILE-DE-FRANCE,BRUNOY,353,1447,1800,
Musée de Salagon,2003,PROVENCE-ALPES-CÔTE D'AZUR,MANE,25380,4620,30000,
Musée-Jardin Paul Landowski,2001,ILE-DE-FRANCE,BOULOGNE-BILLANCOURT,0,1700,1700,
Musée de la Faïence,2003,PROVENCE-ALPES-CÔTE D'AZUR,MOUSTIERS-SAINTE-MARIE,9559,2345,11904,
Musée Roybet Fould,2001,ILE-DE-FRANCE,COURBEVOIE,0,16743,16743,
Musée Fernand Léger,2003,PROVENCE-ALPES-CÔTE D'AZUR,BIOT,12997,6964,19961,
Musée d'Art et d'Histoire,2001,ILE-DE-FRANCE,MEUDON,1195,5779,6974,
Musée d'Art et d'Histoire de Provence,2003,PROVENCE-ALPES-CÔTE D'AZUR,GRASSE,8755,0,8755,
Musée des Beaux-Arts,2003,PROVENCE-ALPES-CÔTE D'AZUR,MENTON,0,12595,12595,
Musée Jean Cocteau Collection Séverin Wunderman,2003,PROVENCE-ALPES-CÔTE D'AZUR,MENTON,9292,5573,14865,
Maison de Victor Hugo,2001,ILE-DE-FRANCE,PARIS,21778,43602,65380,
Musée Archéologique - Site de  Cimiez,2003,PROVENCE-ALPES-CÔTE D'AZUR,NICE,11701,22372,34073,
Musée National Eugène Delacroix,2001,ILE-DE-FRANCE,PARIS,21740,22378,44118,
Musée du Vieux-Logis de Nice,2003,PROVENCE-ALPES-CÔTE D'AZUR,NICE,0,111,111,
Musée de l'Armée,2001,ILE-DE-FRANCE,PARIS,1028711,0,1028711,
Musée du Parlement de Provence et du Vieil Aix,2003,PROVENCE-ALPES-CÔTE D'AZUR,AIX-EN-PROVENCE,8841,6407,15248,
Musée des Tapisseries,2003,PROVENCE-ALPES-CÔTE D'AZUR,AIX-EN-PROVENCE,11624,15598,27222,
Musée Carnavalet-Histoire de Paris,2001,ILE-DE-FRANCE,PARIS,113157,136679,249836,
Musée Camarguais,2003,PROVENCE-ALPES-CÔTE D'AZUR,ARLES,15274,5037,20311,
Musée de Montmartre,2001,ILE-DE-FRANCE,PARIS,37264,0,37264,
Musée Archéologique d'Istres René Beaucaire,2003,PROVENCE-ALPES-CÔTE D'AZUR,ISTRES,2714,2756,5470,
Musée National Picasso,2001,ILE-DE-FRANCE,PARIS,280514,190943,471457,
Musée Folklorique du Vieux Lambesc,2003,PROVENCE-ALPES-CÔTE D'AZUR,LAMBESC,159,518,677,
Musée de la Chasse et de la Nature,2001,ILE-DE-FRANCE,PARIS,15648,0,15648,
Musée Municipal de Chelles Alfred Bonno,2001,ILE-DE-FRANCE,CHELLES,0,3199,3199,
Musée des Beaux-Arts de Marseille,2003,PROVENCE-ALPES-CÔTE D'AZUR,MARSEILLE,4411,20408,24819,
Musée de l'Hôtel-Dieu,2001,ILE-DE-FRANCE,MANTES-LA-JOLIE,9101,2773,11874,
Musée Victor Aubert,2001,ILE-DE-FRANCE,MAULE,0,1019,1019,
Etablissement Public du Musée et du Domaine National de Versailles,2001,ILE-DE-FRANCE,VERSAILLES,2369001,224259,2593260,
Musée du Pays Brignolais,2003,PROVENCE-ALPES-CÔTE D'AZUR,BRIGNOLES,1604,960,2564,
Muséum Agricole et Industriel Stella Matutina,2001,LA REUNION,PITON-SAINT-LEU,57169,0,57169,
Muséum d'Histoire Naturelle,2001,LA REUNION,SAINT-DENIS DE LA REUNION,7761,16268,24029,
Musée Jean Aicard,2003,PROVENCE-ALPES-CÔTE D'AZUR,LE POUVEREL LA GARDE,0,1698,1698,
Musée Petiet,2001,LANGUEDOC-ROUSSILLON,LIMOUX,1637,3261,4898,
Muséum d'Histoire Naturelle Esprit Requien,2003,PROVENCE-ALPES-CÔTE D'AZUR,AVIGNON,0,15853,15853,
Musée Départemental d'Art Sacré du Gard,2001,LANGUEDOC-ROUSSILLON,PONT-SAINT-ESPRIT,2382,5802,8184,
Musée Calvet (et musée Lapidaire),2003,PROVENCE-ALPES-CÔTE D'AZUR,AVIGNON,18145,22130,40275,
Musée Municipal Georges Borias,2001,LANGUEDOC-ROUSSILLON,UZES,827,117,944,
Musée du Vieux Pérouges,2003,RHONE-ALPES,PEROUGES,15975,3100,19075,
Musée du Biterrois,2001,LANGUEDOC-ROUSSILLON,BEZIERS,4251,8736,12987,
Musée de la Cloche et de la Sonnaille,2001,LANGUEDOC-ROUSSILLON,HEREPIAN,10185,967,11152,
Musée d'Art Sacré,2003,RHONE-ALPES,MOURS SAINT-EUSEBE,565,1912,2477,
Musée Archéologique,2001,LANGUEDOC-ROUSSILLON,MINERVE,7040,0,7040,
Agropolis-Muséum,2001,LANGUEDOC-ROUSSILLON,MONTPELLIER,3182,13945,17127,
Musée des Beaux-Arts,2003,RHONE-ALPES,VALENCE,14231,8283,22514,
Musée Paul Valéry,2001,LANGUEDOC-ROUSSILLON,SETE,7541,6411,13952,
Musée du site Préhistorique,2003,RHONE-ALPES,VASSIEUX-EN-VERCORS,17605,0,17605,
Musée d'Art Moderne - Fonds Peskè,2001,LANGUEDOC-ROUSSILLON,COLLIOURE,6297,1906,8203,
Musée Gallo-Romain,2003,RHONE-ALPES,AOSTE,2250,1294,3544,
Musée du Castillet Casa Pairal,2001,LANGUEDOC-ROUSSILLON,PERPIGNAN,29315,0,29315,
Muséum d'Histoire Naturelle de Grenoble,2003,RHONE-ALPES,GRENOBLE,17275,45517,62792,
Musée de l'Histoire du Fer,2001,LORRAINE,JARVILLE-LA-MALGRANGE,1612,1336,2948,
Musée de la Grande Chartreuse,2003,RHONE-ALPES,SAINT-PIERRE-DE-CHARTREUSE,64031,0,64031,
Musée Municipal des Emaux et Faïences,2001,LORRAINE,LONGWY,5482,762,6244,
Conservatoire - Musée des Industries Hydroélectriques,2003,RHONE-ALPES,VAUJANY,0,12395,12395,
Musée de l'Ecole de Nancy,2001,LORRAINE,NANCY,29930,18965,48895,
Musée Départemental de la Révolution Française,2003,RHONE-ALPES,VIZILLE,13514,22769,36283,
Palais des ducs de Lorraine - Musée Historique Lorrain,2001,LORRAINE,NANCY,33586,36477,70063,
Musée Alice Taverne,2003,RHONE-ALPES,AMBIERLE,4167,1134,5301,
Musée d'Art et d'Histoire de Toul,2001,LORRAINE,TOUL,1341,3998,5339,
Musée d'Histoire du  20ème Siècle - Résistance et Déportation,2003,RHONE-ALPES,ESTIVAREILLES,3496,900,4396,
Musée Jeanne d'Arc,2001,LORRAINE,VAUCOULEURS,1250,0,1250,
Musée d'Archéologie,2003,RHONE-ALPES,FEURS,1309,2038,3347,
Musée de la Princerie,2001,LORRAINE,VERDUN,3067,1409,4476,
Musée Départemental du Sel,2001,LORRAINE,MARSAL,7950,1274,9224,
Musée de la Civilisation Gallo-Romaine,2003,RHONE-ALPES,LYON,27627,54354,81981,
Musée d'Art Contemporain de Lyon,2003,RHONE-ALPES,LYON,14950,20062,35012,
Musée de La Canne,2001,MARTINIQUE,LES TROIS ILETS,30164,653,30817,
Musée Archéologique,2003,RHONE-ALPES,SAINT-ROMAIN-EN-GAL,34089,34405,68494,
Musée Municipal,2001,MIDI-PYRENEES,MARTRES-TOLOSANE,0,1003,1003,
Musée-château Gaston Phébus,2001,MIDI-PYRENEES,MAUVEZIN,30546,0,30546,
Musée de Bouxwiller et du pays de hanau,2004,ALSACE,BOUXWILLER,1507,1577,3084,
Musée Henri Martin,2001,MIDI-PYRENEES,CAHORS,1915,4872,6787,
Musée Alsacien,2004,ALSACE,HAGUENAU,3442,0,3442,
Musée Toulouse Lautrec,2001,MIDI-PYRENEES,ALBI,134356,24946,159302,
Musée des Beaux-Arts,2001,MIDI-PYRENEES,GAILLAC,3894,2150,6044,
Musée Zoologique de Strasbourg,2004,ALSACE,STRASBOURG,17461,25681,43142,
Musée de l'Abbaye Saint-Michel,2001,MIDI-PYRENEES,GAILLAC,4528,1519,6047,
Musée des Arts Décoratifs,2004,ALSACE,STRASBOURG,25167,34342,59509,
Musée J.F. Oberlin,2004,ALSACE,WALDERSBACH,3700,16405,20105,
Musée du Pays Rabastinois,2001,MIDI-PYRENEES,RABASTENS,0,4159,4159,
Musée de la Bataille du 6 Août 1870,2004,ALSACE,WOERTH,4049,531,4580,
Musée d'Histoire Naturelle Victor Brun,2001,MIDI-PYRENEES,MONTAUBAN,962,3792,4754,
Musée Gallo-Romain,2004,ALSACE,BIESHEIM,875,1885,2760,
Musée Théophile Jouglet,2001,NORD-PAS-DE-CALAIS,ANZIN,0,2532,2532,
Musée Portuaire,2001,NORD-PAS-DE-CALAIS,DUNKERQUE,25587,15869,41456,
Musée Bartholdi,2004,ALSACE,COLMAR,8223,8133,16356,
Musée des Beaux-Arts,2001,NORD-PAS-DE-CALAIS,DUNKERQUE,19787,0,19787,
Musée du Florival,2004,ALSACE,GUEBWILLER,3915,2400,6315,
"Musée de la Mine, Centre Historique Minier",2001,NORD-PAS-DE-CALAIS,LEWARDE,113880,13961,127841,
Musée Historique,2004,ALSACE,MULHOUSE,0,38420,38420,
Musée Municipal,2001,NORD-PAS-DE-CALAIS,SAINT-AMAND-LES-EAUX,2300,5566,7866,
Musée Vauban,2004,ALSACE,NEUF-BRISACH,2148,612,2760,
Château musée,2001,NORD-PAS-DE-CALAIS,BOULOGNE-SUR-MER,21679,0,21679,
Musée du Tabac,2004,AQUITAINE,BERGERAC,10000,0,10000,
Musée d'Initiation à la Nature,2001,BASSE-NORMANDIE,CAEN,0,12100,12100,
Musée des Techniques Fromagères,2001,BASSE-NORMANDIE,SAINT-PIERRE-SUR-DIVES,1272,0,1272,
Musée d'Aquitaine,2004,AQUITAINE,BORDEAUX,88738,0,88738,
Musée de la Bataille de Tilly-Sur-Seulles 1944,2001,BASSE-NORMANDIE,TILLY-SUR-SEULLES,787,0,787,
Muséum d'Histoire Naturelle de Bordeaux,2004,AQUITAINE,BORDEAUX,39240,0,39240,
Musée Municipal d'Avranches,2001,BASSE-NORMANDIE,AVRANCHES,5500,0,5500,
Musée de la Pomme et de la Poire,2001,BASSE-NORMANDIE,BARENTON,3278,0,3278,
Musée de la Chalosse,2004,AQUITAINE,MONTFORT-EN-CHALOSSE,8032,1845,9877,
Musée Thomas Henry,2001,BASSE-NORMANDIE,CHERBOURG-EN-COTENTIN,631,4597,5228,
Musée d'Art et d'Histoire du Cap de Gascogne,2004,AQUITAINE,SAINT-SEVER,0,1700,1700,
Muséum Emmanuel Liais,2001,BASSE-NORMANDIE,CHERBOURG-EN-COTENTIN,1813,4697,6510,
Musée de Préhistoire Mésolithique Laurent Coulonges,2004,AQUITAINE,SAUVETERRE-LA-LEMANCE,1800,673,2473,
Musée du Vieux Granville,2001,BASSE-NORMANDIE,GRANVILLE,13590,0,13590,
Musée Municipal (Moulin de Gajac),2004,AQUITAINE,VILLENEUVE-SUR-LOT,3558,4066,7624,
Musée Municipal d'Archéologie,2001,BASSE-NORMANDIE,L'AIGLE,0,450,450,
Musée Municipal de Guéthary,2004,AQUITAINE,GUETHARY,551,1423,1974,
Musée Départemental des Arts et Traditions Populaires du Perche,2001,BASSE-NORMANDIE,SAINT-CYR LA ROSIERE,7825,2667,10492,
Musée National du Château,2004,AQUITAINE,PAU,58972,34956,93928,
Musée d'Elbeuf,2001,HAUTE-NORMANDIE,ELBEUF,0,20854,20854,
Musée Municipal de Souvigny,2004,AUVERGNE,SOUVIGNY,5770,535,6305,
Musée de la Dentelle,2004,AUVERGNE,ARLANC,2090,228,2318,
Musée Malraux,2001,HAUTE-NORMANDIE,LE HAVRE,44658,0,44658,
La Maison de l'Armateur,2001,HAUTE-NORMANDIE,LE HAVRE,0,1505,1505,
Musée des Sapeurs-Pompiers de France,2001,HAUTE-NORMANDIE,MONTVILLE,6975,2519,9494,
Musée d'Art Sacré,2004,BOURGOGNE,DIJON,0,5317,5317,
MUNAE - Musée National de l'Education,2001,HAUTE-NORMANDIE,ROUEN,1302,0,1302,
Musée Municipal,2004,BOURGOGNE,SEMUR-EN-AUXOIS,1453,3510,4963,
Musée Victor Hugo,2001,HAUTE-NORMANDIE,VILLEQUIER,6426,7970,14396,
"Musée de la Fève, Crèches et Traditions Populaires",2001,PAYS DE LA LOIRE,BLAIN,3294,1057,4351,
Museum d'Histoire Naturelle Jacques de La Comble,2004,BOURGOGNE,AUTUN,629,3545,4174,
Musée du Pays de Guérande et de la Porte Saint Michel,2001,PAYS DE LA LOIRE,GUERANDE,20292,264,20556,
Musée Denon,2004,BOURGOGNE,CHALON-SUR-SAONE,1253,11482,12735,
Musée des Beaux-Arts de Nantes,2001,PAYS DE LA LOIRE,NANTES,154442,0,154442,
Musée René Davoine,2004,BOURGOGNE,CHAROLLES,138,502,640,
Musée du Chaume/Kerhinet - Parc Naturel Régional de Brière,2001,PAYS DE LA LOIRE,SAINT-LYPHARD,7206,0,7206,
Musée du Prieuré de Charolles,2004,BOURGOGNE,CHAROLLES,1730,457,2187,
Musée de la Vigne et du Vin d'Anjou,2001,PAYS DE LA LOIRE,SAINT LAMBERT-DU-LATTAY - VAL-DU-LAYON,5573,707,6280,
Musée d'Art et d'Archéologie,2004,BOURGOGNE,CLUNY,79815,22608,102423,
Musée des Tisserands Mayennais,2001,PAYS DE LA LOIRE,AMBRIERES-LES-VALLEES,976,125,1101,
Musée de la Tour du Moulin,2004,BOURGOGNE,MARCIGNY,1088,258,1346,
Musée Leblanc-Duvernois,2004,BOURGOGNE,AUXERRE,792,2107,2899,
Musée du Vieux Château,2001,PAYS DE LA LOIRE,LAVAL,4715,5307,10022,
Musée de l'Avallonnais Jean Després,2004,BOURGOGNE,AVALLON,0,5488,5488,
Musée des Sciences - CCSTI,2001,PAYS DE LA LOIRE,LAVAL,2710,13069,15779,
Musée Colette,2004,BOURGOGNE,SAINT-SAUVEUR-EN-PUISAYE,15130,0,15130,
Musée de l'Abbaye de Sainte-Croix,2001,PAYS DE LA LOIRE,LES SABLES D'OLONNE,4811,13314,18125,
Musée de la Faucillonnaie,2004,BRETAGNE,MONTREUIL-SOUS-PEROUSE,2193,892,3085,
Musée du Nord de la Vendée,2001,PAYS DE LA LOIRE,MONTAIGU,0,695,695,
Ecomusée du Pays de Rennes,2004,BRETAGNE,RENNES,20403,25165,45568,
Musée Jeanne d'Aboville,2001,PICARDIE,LA FERE,698,0,698,
Musée Départemental de l'Oise,2001,PICARDIE,BEAUVAIS,7454,6736,14190,
Musée International du Long-Cours Cap-Hornier,2004,BRETAGNE,SAINT-MALO,7844,3116,10960,
Musée de l'Archerie et de l'Art Sacré,2001,PICARDIE,CREPY-EN-VALOIS,3772,0,3772,
Ecomusée de l'Île de Groix,2004,BRETAGNE,ILE DE GROIX,9997,1452,11449,
Musée du Noyonnais,2001,PICARDIE,NOYON,2568,1261,3829,
Musée des Arts Décoratifs,2004,CENTRE,BOURGES,0,16669,16669,
Musée d'Art et d'Archéologie,2001,PICARDIE,SENLIS,2915,3418,6333,
Musée de l'Hôtel de Berny,2001,PICARDIE,AMIENS,300,1778,2078,
Conservatoire du Machinisme et des Pratiques Agricoles,2004,CENTRE,CHARTRES-MAINVILLIERS,14384,36616,51000,
Musée des Beaux-Arts,2001,POITOU-CHARENTES,ANGOULEME,15674,0,15674,
Musée des Beaux-Arts et d'Histoire Naturelle,2004,CENTRE,CHATEAUDUN,3683,5702,9385,
Musée Municipal de Cognac,2001,POITOU-CHARENTES,COGNAC,2970,10464,13434,
Musée de la Chemiserie et de l'Elégance Masculine,2004,CENTRE,ARGENTON-SUR-CREUSE,3328,5150,8478,
Musée Napoléonien et Africain,2001,POITOU-CHARENTES,ILE D'AIX,17455,22152,39607,
Musée de l'Hospice Saint-Roch,2004,CENTRE,ISSOUDUN,393,12865,13258,
Musée du Nouveau Monde,2001,POITOU-CHARENTES,LA ROCHELLE,4808,6728,11536,
Musée de l'Hôtel de Ville,2004,CENTRE,RICHELIEU,917,163,1080,
Musée de la Maison de Pierre Loti,2001,POITOU-CHARENTES,ROCHEFORT,34697,1771,36468,
Ecomusée du Véron,2004,CENTRE,SAVIGNY-EN-VERON,3414,0,3414,
Musée du Présidial,2001,POITOU-CHARENTES,SAINTES,1615,2029,3644,
Musée des Vins de Touraine,2004,CENTRE,TOURS,1979,2553,4532,
Musée départemental de préhistoire,2001,PROVENCE-ALPES-CÔTE D'AZUR,QUINSON,112952,0,112952,
Musée du Compagnonnage,2004,CENTRE,TOURS,37012,19930,56942,
Musée Archéologique,2001,PROVENCE-ALPES-CÔTE D'AZUR,RIEZ-LA-ROMAINE,0,572,572,
Musée de l'Hôtel Goüin,2004,CENTRE,TOURS,10585,0,10585,
Musée d'Histoire Locale,2001,PROVENCE-ALPES-CÔTE D'AZUR,BIOT,4367,0,4367,
Maison de la Magie,2004,CENTRE,BLOIS,51082,14555,65637,
Musée International de la Parfumerie,2001,PROVENCE-ALPES-CÔTE D'AZUR,GRASSE,27269,12804,40073,
Musée de Vendôme,2004,CENTRE,VENDOME,1340,7636,8976,
Musée de Préhistoire Régionale,2001,PROVENCE-ALPES-CÔTE D'AZUR,MENTON,0,11334,11334,
Musée Municipal Théâtre Forain et Archéologique,2004,CENTRE,ARTENAY,1995,1553,3548,
Musée d'Art Naïf Anatole Jakovsky,2001,PROVENCE-ALPES-CÔTE D'AZUR,NICE,7963,11029,18992,
Musée National Message Biblique Marc Chagall,2001,PROVENCE-ALPES-CÔTE D'AZUR,NICE,137072,50359,187431,
Musée des Beaux-Arts,2004,CENTRE,ORLEANS,18201,32000,50201,
Musée du Palais Lascaris,2001,PROVENCE-ALPES-CÔTE D'AZUR,NICE,0,38036,38036,
Musée Archéologique - Site de Terra Amata,2001,PROVENCE-ALPES-CÔTE D'AZUR,NICE,3682,15105,18787,
Musée du Parlement de Provence et du Vieil Aix,2001,PROVENCE-ALPES-CÔTE D'AZUR,AIX-EN-PROVENCE,11496,2508,14004,
Muséum d'Histoire Naturelle,2001,PROVENCE-ALPES-CÔTE D'AZUR,AIX-EN-PROVENCE,7498,14581,22079,
Musée Paul Dubois-Alfred Boucher,2004,CHAMPAGNE-ARDENNES,NOGENT-SUR-SEINE,1383,448,1831,
Maison de l'Outil  et de la Pensée Ouvrière,2004,CHAMPAGNE-ARDENNES,TROYES,18477,8960,27437,
Muséon Arlaten,2001,PROVENCE-ALPES-CÔTE D'AZUR,ARLES,40961,0,40961,
Musée des Beaux-Arts et d'Archéologie,2004,CHAMPAGNE-ARDENNES,CHAUMONT,922,3746,4668,
Musée Camarguais,2001,PROVENCE-ALPES-CÔTE D'AZUR,ARLES,26815,0,26815,
Musée Municipal,2004,CHAMPAGNE-ARDENNES,CHALONS-EN-CHAMPAGNE,2013,8398,10411,
Musée Archéologique d'Istres René Beaucaire,2001,PROVENCE-ALPES-CÔTE D'AZUR,ISTRES,2239,3163,5402,
Musée Ciotaden,2001,PROVENCE-ALPES-CÔTE D'AZUR,LA CIOTAT,2171,5010,7181,
Musée des Beaux-Arts de Saint-Denis,2004,CHAMPAGNE-ARDENNES,REIMS,10417,28071,38488,
"Musée d'Arts Africains, Océaniens, Amérindiens",2001,PROVENCE-ALPES-CÔTE D'AZUR,MARSEILLE,10000,0,10000,
Muséum d'Histoire Naturelle,2001,PROVENCE-ALPES-CÔTE D'AZUR,MARSEILLE,25176,0,25176,
Musée Suffren et du Vieux Saint-Cannat,2001,PROVENCE-ALPES-CÔTE D'AZUR,SAINT-CANNAT,0,5951,5951,
Musée d'archéologie d'Aleria - Jérôme Carcopino,2004,CORSE,ALERIA,23614,18125,41739,
Musée Départemental des Hautes-Alpes,2001,PROVENCE-ALPES-CÔTE D'AZUR,GAP,2784,8996,11780,
Muséum de Besançon,2004,FRANCHE-COMTE,BESANCON,275751,0,275751,
Musée Municipal,2001,PROVENCE-ALPES-CÔTE D'AZUR,DRAGUIGNAN,0,8027,8027,
Musée de la résistance et de la Déportation,2004,FRANCHE-COMTE,BESANCON,73188,0,73188,
Musée Archéologique Municipal,2001,PROVENCE-ALPES-CÔTE D'AZUR,FREJUS,0,20920,20920,
Musée des Beaux-Arts et d'Archéologie,2004,FRANCHE-COMTE,BESANCON,11116,35671,46787,
Muséum d'Histoire Naturelle Esprit Requien,2001,PROVENCE-ALPES-CÔTE D'AZUR,AVIGNON,0,25798,25798,
Musée de Pontarlier,2004,FRANCHE-COMTE,PONTARLIER,12299,0,12299,
Musée Départemental Albert-et-Félicie Demard - ATP,2004,FRANCHE-COMTE,CHAMPLITTE,11033,6349,17382,
Ecomusée du Pays de la Cerise,2004,FRANCHE-COMTE,FOUGEROLLES,7152,0,7152,
Musée de la Résistance et de la Déportation de l'Ain,2001,RHONE-ALPES,NANTUA,7238,0,7238,
Musée Départemental de la Montagne Albert Demard,2004,FRANCHE-COMTE,LE HAUT-DU-THEM,5241,4050,9291,
Musée de la Bresse - Domaine des Planons,2001,RHONE-ALPES,SAINT-CYR-SUR-MENTHON,20115,0,20115,
Musée des Beaux-Arts,2004,FRANCHE-COMTE,DOLE,0,15756,15756,
Cité de Préhistoire,2001,RHONE-ALPES,ORGNAC-L'AVEN,115997,0,115997,
Musée National des Châteaux de Malmaison et de Bois-Préau,2004,ILE-DE-FRANCE,RUEIL-MALMAISON,45044,28087,73131,
Musée Municipal de Saint-Cloud,2004,ILE-DE-FRANCE,SAINT-CLOUD,0,5258,5258,
Musée et Site Archéologiques,2001,RHONE-ALPES,SOYONS,16667,5644,22311,
Musée de l'Île-de-France,2004,ILE-DE-FRANCE,SCEAUX,5137,31307,36444,
Musée du Rhône,2001,RHONE-ALPES,TOURNON-SUR-RHÔNE,7086,2059,9145,
Château de Grignan,2001,RHONE-ALPES,GRIGNAN,85040,15002,100042,
Galerie de Minéralogie et de Géologie (Muséum d'Histoire Naturelle),2004,ILE-DE-FRANCE,PARIS,33059,8531,41590,
Musée du site Préhistorique,2001,RHONE-ALPES,VASSIEUX-EN-VERCORS,19823,0,19823,
Musée National des Arts et des Traditions Populaires,2004,ILE-DE-FRANCE,PARIS,4536,18014,22550,
Musée Géo-Charles,2001,RHONE-ALPES,ECHIROLLES,4054,0,4054,
Musée Matheysin,2001,RHONE-ALPES,LA MURE,3650,1600,5250,
Musée National de la Marine,2004,ILE-DE-FRANCE,PARIS,121613,32616,154229,
Musée Hébert,2001,RHONE-ALPES,LA TRONCHE,0,20000,20000,
Musée National Jean-Jacques Henner,2004,ILE-DE-FRANCE,PARIS,0,2583,2583,
Musée Hector Berlioz,2001,RHONE-ALPES,LA-COTE-SAINT-ANDRE,5856,0,5856,
Musée de l'Armée,2004,ILE-DE-FRANCE,PARIS,1031945,0,1031945,
Musée-Cloître Saint-André-Le-Bas,2001,RHONE-ALPES,VIENNE,5249,6623,11872,
Musée des Thermes et de l'Hôtel de Cluny (arts et techniques du Moyen-Age et de la Renaissance),2004,ILE-DE-FRANCE,PARIS,197055,131253,328308,
Musée d'Archéologie,2001,RHONE-ALPES,FEURS,5679,0,5679,
Maison de Balzac,2004,ILE-DE-FRANCE,PARIS,0,24311,24311,
Musée de la Diana,2001,RHONE-ALPES,MONTBRISON,11400,1088,12488,
Musée de Montmartre,2004,ILE-DE-FRANCE,PARIS,36015,3924,39939,
Musée Historique des Tissus,2001,RHONE-ALPES,LYON,69296,13600,82896,
Musée National Picasso,2004,ILE-DE-FRANCE,PARIS,293307,186992,480299,
Musée des Beaux-Arts,2001,RHONE-ALPES,LYON,140566,114931,255497,
Musée Galliera,2004,ILE-DE-FRANCE,PARIS,47537,23400,70937,
Musée d'Art Contemporain de Lyon,2001,RHONE-ALPES,LYON,116534,0,116534,
Musée Hébert,2004,ILE-DE-FRANCE,PARIS,1304,1226,2530,
Musée Paul Dini,2001,RHONE-ALPES,VILLEFRANCHE-SUR-SAONE,3295,6285,9580,
Etablissement public du musée d'Orsay,2004,ILE-DE-FRANCE,PARIS,1787275,803041,2590316,
Musée Municipal d'Albertville-Conflans,2001,RHONE-ALPES,ALBERTVILLE,6136,0,6136,
Musée Bouchard,2004,ILE-DE-FRANCE,PARIS,2221,916,3137,
Musée de la Folie Marco,2002,ALSACE,BARR,3139,1148,4287,
Musée d'Art Moderne et Contemporain de Strasbourg,2002,ALSACE,STRASBOURG,48889,78053,126942,
Musée des Pays de Seine-et-Marne,2004,ILE-DE-FRANCE,SAINT-CYR-SUR-MORIN,1728,5447,7175,
Musée Zoologique de Strasbourg,2002,ALSACE,STRASBOURG,27059,15087,42146,
Musée départemental Stéphane Mallarmé,2004,ILE-DE-FRANCE,VULAINES-SUR-SEINE,2441,1410,3851,
Musée Alsacien,2002,ALSACE,STRASBOURG,30389,28980,59369,
Musée d'Art et d'Histoire,2004,ILE-DE-FRANCE,SAINT-DENIS,3213,23721,26934,
Musée des Beaux-Arts,2002,ALSACE,STRASBOURG,22131,29234,51365,
Musée de Saint-Maur - Villa Médicis,2004,ILE-DE-FRANCE,LA VARENNE-SAINT-HILAIRE,0,8866,8866,
Cabinet des Estampes et des Dessins,2002,ALSACE,STRASBOURG,0,260,260,
Musée Emile Jean,2004,ILE-DE-FRANCE,VILLIERS-SUR-MARNE,0,722,722,
Musée de la Bataille du 6 Août 1870,2002,ALSACE,WOERTH,4408,405,4813,
Musée d'Art et d'Histoire Louis Senlecq,2004,ILE-DE-FRANCE,L'ISLE-ADAM,2107,15561,17668,
Musée d'Unterlinden,2002,ALSACE,COLMAR,235157,0,235157,
Musée jean-Jacques Rousseau,2004,ILE-DE-FRANCE,MONTMORENCY,1609,1502,3111,
Musée Historique,2002,ALSACE,MULHOUSE,0,25768,25768,
Musée Tavet Delacour,2004,ILE-DE-FRANCE,PONTOISE,12852,3913,16765,
Ecomusée d'Alsace,2002,ALSACE,UNGERSHEIM,277887,35821,313708,
Musée de la Toile de Jouy,2004,ILE-DE-FRANCE,JOUY-EN-JOSAS,10342,1370,11712,
Musée de la Voiture à Cheval,2002,AQUITAINE,BOURG-SUR-GIRONDE,4139,0,4139,
Musée Promenade Marly/Louveciennes,2004,ILE-DE-FRANCE,LOUVECIENNES,5741,1886,7627,
Musée d'Archéologie Nationale (des origines à l'an mille) - Château de st-Germain-en-Laye,2004,ILE-DE-FRANCE,SAINT-GERMAIN-EN-LAYE,19224,45551,64775,
Musée Historique de l'Hydravion,2002,AQUITAINE,BISCARROSSE,19463,1739,21202,
Musée Despiau-Wlérick,2002,AQUITAINE,MONT-DE-MARSAN,2255,8620,10875,
Musée des Beaux-Arts,2004,LANGUEDOC-ROUSSILLON,CARCASSONNE,0,29530,29530,
Musée du Château Henri IV,2002,AQUITAINE,NERAC,16769,3692,20461,
Carré d'Art Musée d'Art Contemporain de Nîmes,2004,LANGUEDOC-ROUSSILLON,NIMES,37755,0,37755,
Musée Edmond Rostand,2002,AQUITAINE,CAMBO-LES-BAINS,65608,0,65608,
Musée Municipal,2004,LANGUEDOC-ROUSSILLON,FRONTIGNAN-LA-PEYRADE,0,8580,8580,
Musée Municipal de Guéthary,2002,AQUITAINE,GUETHARY,591,2603,3194,
Musée de la Préhistoire des Matelles,2004,LANGUEDOC-ROUSSILLON,LES MATELLES,676,1667,2343,
Musée Rural de la Sologne Bourbonnaise,2002,AUVERGNE,BEAULON,68,0,68,
Musée de Vulliod Saint-Germain,2004,LANGUEDOC-ROUSSILLON,PEZENAS,4451,0,4451,
Musée des Musiques Populaires - MuPop,2002,AUVERGNE,MONTLUCON,16607,5110,21717,
Musée d'Art Moderne - Fonds Peskè,2004,LANGUEDOC-ROUSSILLON,COLLIOURE,5072,0,5072,
Musée Anne de Beaujeu,2002,AUVERGNE,MOULINS,4641,2287,6928,
Muséum d'Histoire Naturelle,2004,LANGUEDOC-ROUSSILLON,PERPIGNAN,138,5099,5237,
Musée Municipal de Souvigny,2002,AUVERGNE,SOUVIGNY,5768,227,5995,
Musée d'art et d'histoire Alfred Douët,2002,AUVERGNE,SAINT-FLOUR,6853,0,6853,
Musée Départemental d'Art Contemporain,2004,LIMOUSIN,ROCHECHOUART,8375,3035,11410,
Musée de la Dentelle,2002,AUVERGNE,ARLANC,2404,241,2645,
Musée de la Bière et du Pays de Stenay,2004,LORRAINE,STENAY,4948,8237,13185,
Musée d'Art Roger-Quillot,2002,AUVERGNE,CLERMONT-FERRAND,42196,0,42196,
Musée Jeanne d'Arc,2004,LORRAINE,VAUCOULEURS,1835,0,1835,
Muséum d'Histoire Naturelle Henri-Lecoq,2002,AUVERGNE,CLERMONT-FERRAND,2454,16463,18917,
Musée de la Princerie,2004,LORRAINE,VERDUN,2353,2595,4948,
Musée des Pénitents Blancs,2002,AUVERGNE,MARSAC-EN-LIVRADOIS,532,28,560,
Moulin de la Blies - Musée des Techniques Faïencières,2004,LORRAINE,SARREGUEMINES,10219,4675,14894,
Musée des Beaux-Arts,2002,BOURGOGNE,BEAUNE,4958,2956,7914,
Musée Départemental d'Art Ancien et Contemporain,2004,LORRAINE,EPINAL,7874,16409,24283,
Musée Charles de Bruyères,2004,LORRAINE,REMIREMONT,809,4040,4849,
Musée d'Art Sacré,2002,BOURGOGNE,DIJON,946,7604,8550,
Musée Régional d'Histoire et d'Ethnologie,2004,MARTINIQUE,FORT-DE-FRANCE,2991,1385,4376,
Muséum - Jardin des Sciences,2002,BOURGOGNE,DIJON,5200,95390,100590,
Musée de La Canne,2004,MARTINIQUE,LES TROIS ILETS,28824,0,28824,
Musée Municipal,2002,BOURGOGNE,SEMUR-EN-AUXOIS,1495,2301,3796,
Musée d'Archéologie,2004,MIDI-PYRENEES,LECTOURE,3201,186,3387,
Musée du Septennat,2002,BOURGOGNE,CHATEAU-CHINON,23043,3246,26289,
Musée des Beaux-Arts et des Arts Décoratifs,2004,MIDI-PYRENEES,MIRANDE,708,378,1086,
Musée Municipal,2002,BOURGOGNE,LA CHARITE-SUR-LOIRE,0,8226,8226,
Musée du Pays de Luchon,2004,MIDI-PYRENEES,BAGNERES-DE-LUCHON,2083,274,2357,
Musée Auguste Grasset,2002,BOURGOGNE,VARZY,1761,3035,4796,
Musée Municipal,2004,MIDI-PYRENEES,MARTRES-TOLOSANE,0,492,492,
Musée Saint-Nazaire,2002,BOURGOGNE,BOURBON-LANCY,0,1762,1762,
Musée du Prieuré de Charolles,2002,BOURGOGNE,CHAROLLES,0,1561,1561,
Musée Municipal d'Art et d'Histoire,2004,MIDI-PYRENEES,SAINT-GAUDENS,517,636,1153,
Musée Leblanc-Duvernois,2002,BOURGOGNE,AUXERRE,1227,1009,2236,
"Les Abattoirs, Musée d'Art Moderne et Contemporain",2004,MIDI-PYRENEES,TOULOUSE,26977,188215,215192,
Ecomusée des Monts d'Arrée - Moulins de Kerouat & Maison Cornec de Rivoal,2002,BRETAGNE,COMMANA,21745,6805,28550,
Musée des Augustins,2004,MIDI-PYRENEES,TOULOUSE,122489,22517,145006,
Musée de Pont-Aven,2002,BRETAGNE,PONT-AVEN,40263,0,40263,
Musée Pyrénéen,2004,MIDI-PYRENEES,LOURDES,65009,4555,69564,
Musée de Bretagne,2002,BRETAGNE,RENNES,32055,0,32055,
Musée de Préhistoire Amédée Lémozi,2004,MIDI-PYRENEES,CABRERETS,74970,0,74970,
Musée du Château de Vitré,2002,BRETAGNE,VITRE,25848,5541,31389,
Musée d'Art Sacré,2004,MIDI-PYRENEES,ROCAMADOUR,4559,803,5362,
Ecomusée Industriel des Forges,2002,BRETAGNE,INZINZAC-LOCHRIST,4575,427,5002,
Musée d'Art et d'Histoire Charles Portal,2004,MIDI-PYRENEES,CORDES-SUR-CIEL,338,508,846,
Musée National de la Marine,2002,BRETAGNE,PORT-LOUIS,75196,0,75196,
Musée du Pays Rabastinois,2004,MIDI-PYRENEES,RABASTENS,910,2846,3756,
Musée Estève,2002,CENTRE,BOURGES,0,17904,17904,
Musée Municipal de Cambrai,2004,NORD-PAS-DE-CALAIS,CAMBRAI,7655,16841,24496,
Muséum des Sciences Naturelles et de Préhistoire,2002,CENTRE,CHARTRES,0,19997,19997,
Musée de la Chartreuse,2004,NORD-PAS-DE-CALAIS,DOUAI,29644,0,29644,
Ecomusée de la Région,2004,NORD-PAS-DE-CALAIS,FOURMIES,44333,0,44333,
Château Musée,2002,CENTRE,AZAY-LE-FERRON,2303,0,2303,
Musée Municipal d'Hazebrouck,2004,NORD-PAS-DE-CALAIS,HAZEBROUCK,711,2564,3275,
"""Maison Musée"" René Descartes",2002,CENTRE,DESCARTES,676,0,676,
Musée des Beaux-Arts,2004,NORD-PAS-DE-CALAIS,VALENCIENNES,57003,23544,80547,
Musée de Préhistoire du Grand Pressigny,2002,CENTRE,LE GRAND PRESSIGNY,11342,5217,16559,
Musée Municipal,2004,NORD-PAS-DE-CALAIS,BERCK-SUR-MER,9076,3244,12320,
Musée de l'Hôtel de Ville,2002,CENTRE,RICHELIEU,966,0,966,
Musée d'Histoire et d'Archéologie,2004,NORD-PAS-DE-CALAIS,HARNES,0,1291,1291,
Musée Municipal,2002,CENTRE,SAINTE-MAURE-DE-TOURAINE,103,61,164,
Musée Municipal,2004,NORD-PAS-DE-CALAIS,LE TOUQUET-PARIS-PLAGE,11024,0,11024,
Ecomusée du Véron,2002,CENTRE,SAVIGNY-EN-VERON,10310,19088,29398,
Musée Baron Gérard,2004,BASSE-NORMANDIE,BAYEUX,1594,8475,10069,
Musée de Minerve,2002,CENTRE,YZEURES-SUR-CREUSE,0,1797,1797,
Musée de la Poste et des Techniques de communication,2004,BASSE-NORMANDIE,CAEN,2688,4221,6909,
Musée Municipal Théâtre Forain et Archéologique,2002,CENTRE,ARTENAY,9360,0,9360,
Musée de la Mine,2004,BASSE-NORMANDIE,LE MOLAY-LITTRY,7061,994,8055,
Musée Daniel Vannier,2002,CENTRE,BEAUGENCY,2489,1466,3955,
Musée d'Art et d'Histoire de Lisieux,2004,BASSE-NORMANDIE,LISIEUX,469,663,1132,
Château-Musée de Gien,2002,CENTRE,GIEN,22108,4374,26482,
Musée du Château,2004,BASSE-NORMANDIE,PONTECOULANT,4080,1210,5290,
Musée de Trouville - Villa Montebello,2004,BASSE-NORMANDIE,TROUVILLE-SUR-MER,10056,0,10056,
Musée du Château-Fort,2002,CHAMPAGNE-ARDENNES,SEDAN,56867,0,56867,
Musée de la Guerre et de la Libération,2004,BASSE-NORMANDIE,CHERBOURG-EN-COTENTIN,13994,0,13994,
Musée Vauluisant - Musée Historique de Troyes et de la Champagne,2002,CHAMPAGNE-ARDENNES,TROYES,0,0,0,
Musée Quesnel-Morinière,2004,BASSE-NORMANDIE,COUTANCES,4922,0,4922,
Musée Vauluisant - Musée de la Bonneterie,2002,CHAMPAGNE-ARDENNES,TROYES,3931,4016,7947,
Musée Christian Dior,2004,BASSE-NORMANDIE,GRANVILLE,14733,0,14733,
Maison de l'Outil  et de la Pensée Ouvrière,2002,CHAMPAGNE-ARDENNES,TROYES,17000,0,17000,
Musée des Beaux-Arts,2004,BASSE-NORMANDIE,SAINT-LO,5899,0,5899,
Pharmacie Musée de l'Hôtel-Dieu,2002,CHAMPAGNE-ARDENNES,TROYES,2655,2788,5443,
Musée Maritime de l'Ile de Tatihou,2004,BASSE-NORMANDIE,SAINT-VAAST-LA-HOUGUE,51866,0,51866,
Musée Hôtel le Vergeur,2002,CHAMPAGNE-ARDENNES,REIMS,7142,4098,11240,
Musée Départemental des Arts et Traditions Populaires du Perche,2004,BASSE-NORMANDIE,SAINT-CYR LA ROSIERE,13599,5794,19393,
Musée du Verre et de la Pierre,2004,HAUTE-NORMANDIE,CONCHES-EN-OUCHE,1364,584,1948,
Musée de la Maison Bonaparte,2002,CORSE,AJACCIO,52317,22085,74402,
Musée Artisanal et Industriel d'Instruments à Vent,2004,HAUTE-NORMANDIE,LA COUTURE-BOUSSEY,1462,860,2322,
Musée d'archéologie d'Aleria - Jérôme Carcopino,2002,CORSE,ALERIA,31530,18210,49740,
Musée Municipal,2004,HAUTE-NORMANDIE,LOUVIERS,0,3911,3911,
Musée de la Corse,2002,CORSE,CORTE,61618,9104,70722,
Museoseine,2004,HAUTE-NORMANDIE,CAUDEBEC-EN-CAUX,3793,1150,4943,
Musée de la résistance et de la Déportation,2002,FRANCHE-COMTE,BESANCON,78888,0,78888,
Musée des Traditions et Arts Normands,2004,HAUTE-NORMANDIE,MARTAINVILLE-EPREVILLE,6799,9641,16440,
Musée des Beaux-Arts et d'Archéologie,2002,FRANCHE-COMTE,BESANCON,15478,26482,41960,
Ecomusée de la Basse-Seine,2004,HAUTE-NORMANDIE,NOTRE-DAME-DE-BLIQUETUIT,19731,6207,25938,
Musée Georges Garret,2002,FRANCHE-COMTE,VESOUL,0,8475,8475,
Musée Le Secq des Tournelles,2004,HAUTE-NORMANDIE,ROUEN,6626,5501,12127,
Musée de la Vigne et du Vin,2002,FRANCHE-COMTE,ARBOIS,6035,1795,7830,
Musée du Pays de Retz,2004,PAYS DE LA LOIRE,BOURGNEUF-EN-RETZ,4484,1228,5712,
Musée d'Archéologie,2002,FRANCHE-COMTE,LONS-LE-SAUNIER,7587,5860,13447,
Musée des Beaux-Arts de Nantes,2004,PAYS DE LA LOIRE,NANTES,83501,0,83501,
Musée des Beaux-Arts,2002,FRANCHE-COMTE,LONS-LE-SAUNIER,1071,5252,6323,
Musée du Chaume/Kerhinet - Pard Naturel Régional de Brière,2004,PAYS DE LA LOIRE,SAINT-LYPHARD,3516,0,3516,
Forge-Musée,2002,FRANCHE-COMTE,ETUEFFONT,1238,736,1974,
Ecomusée de Saint-Nazaire,2004,PAYS DE LA LOIRE,SAINT-NAZAIRE,1054,93840,94894,
Musée Pincé,2004,PAYS DE LA LOIRE,ANGERS,3656,8565,12221,
Musée des Cultures Guyanaises,2002,GUYANE,CAYENNE,0,4623,4623,
Musée des Beaux-Arts,2004,PAYS DE LA LOIRE,ANGERS,44685,53235,97920,
Musée Français de la Photographie,2002,ILE-DE-FRANCE,BIEVRES,3200,592,3792,
Musée d'Art et d'Histoire,2004,PAYS DE LA LOIRE,BAUGE,6255,0,6255,
Musée Départemental Albert-Kahn,2002,ILE-DE-FRANCE,BOULOGNE-BILLANCOURT,55261,16853,72114,
Château-Musée,2004,PAYS DE LA LOIRE,SAUMUR,50586,10504,61090,
Musée Roybet Fould,2002,ILE-DE-FRANCE,COURBEVOIE,0,11856,11856,
Musée des Tisserands Mayennais,2004,PAYS DE LA LOIRE,AMBRIERES-LES-VALLEES,704,88,792,
Musée Municipal de Saint-Cloud,2002,ILE-DE-FRANCE,SAINT-CLOUD,0,5895,5895,
Musée Archéologique Départemental de Jublains,2004,PAYS DE LA LOIRE,JUBLAINS,12857,22446,35303,
Musée de l'Homme (Muséum National d'Histoire Naturelle),2002,ILE-DE-FRANCE,PARIS,93622,13774,107396,
Musée des Arts et des Traditions Populaires,2002,ILE-DE-FRANCE,PARIS,14250,27313,41563,
Musée Vert Véron-de-Forbonnais,2004,PAYS DE LA LOIRE,LE MANS,16624,0,16624,
Musée des Traditions de l'Île,2004,PAYS DE LA LOIRE,LA GUERINIERE,5472,427,5899,
Musée National Jean-Jacques Henner,2002,ILE-DE-FRANCE,PARIS,803,1475,2278,
Musée Municipal,2004,PAYS DE LA LOIRE,LA ROCHE-SUR-YON,0,12820,12820,
Musée des Thermes et de l'Hôtel de Cluny (arts et techniques du Moyen-Age et de la Renaissance),2002,ILE-DE-FRANCE,PARIS,157193,142811,300004,
Musée Clemenceau et de Lattre-de-Tassigny,2004,PAYS DE LA LOIRE,MOUILLERON-EN-PAREDS,1929,1539,3468,
Musée Carnavalet-Histoire de Paris,2002,ILE-DE-FRANCE,PARIS,48250,441798,490048,
Musée du Château,2004,PAYS DE LA LOIRE,NOIRMOUTIER-EN-L'ILE,41606,3412,45018,
Musée Milcendeau Jean-Yole,2004,PAYS DE LA LOIRE,SOULLANS,1639,2721,4360,
Musée Bourdelle,2002,ILE-DE-FRANCE,PARIS,2650,36701,39351,
Musée - Centre de Documentation Alfred Desmasures,2004,PICARDIE,HIRSON,0,674,674,
Maison de Balzac,2002,ILE-DE-FRANCE,PARIS,11166,18663,29829,
Musée Jeanne d'Aboville,2004,PICARDIE,LA FERE,295,180,475,
Musée Bouchard,2002,ILE-DE-FRANCE,PARIS,1361,847,2208,
Musée d'Art et d'Archéologie,2004,PICARDIE,LAON,5918,0,5918,
Palais Galliera - Musée de la Mode de la ville de Paris,2002,ILE-DE-FRANCE,PARIS,46670,21715,68385,
Musée de La Thiérache,2004,PICARDIE,VERVINS,0,6000,6000,
Musée Antoine Vivenel,2004,PICARDIE,COMPIEGNE,1265,6257,7522,
Musée Hébert,2002,ILE-DE-FRANCE,PARIS,1315,2413,3728,
Musée du Noyonnais,2004,PICARDIE,NOYON,1388,1201,2589,
Musée National d'Orsay,2002,ILE-DE-FRANCE,PARIS,1422863,704916,2127779,
"Musée Cognacq-Jay, Musée du XVIIIe siècle de la ville de Paris",2002,ILE-DE-FRANCE,PARIS,1399,34654,36053,
Musée des Arts d'Afrique et d'Océanie,2002,ILE-DE-FRANCE,PARIS,136725,177999,314724,
Musée des Arts du Cognac (Annexe musée municipal),2004,POITOU-CHARENTES,COGNAC,3903,5760,9663,
Musée des Monnaies et des Médailles,2002,ILE-DE-FRANCE,PARIS,26104,0,26104,
Musée Régional de Fouras,2004,POITOU-CHARENTES,FOURAS,8911,1154,10065,
Musée Protestant,2004,POITOU-CHARENTES,LA ROCHELLE,1446,629,2075,
Musée de la Poste,2002,ILE-DE-FRANCE,PARIS,38553,0,38553,
Musée d'Orbigny-Bernon,2004,POITOU-CHARENTES,LA ROCHELLE,7351,0,7351,
Musée Municipal de Chelles Alfred Bonno,2002,ILE-DE-FRANCE,CHELLES,0,6090,6090,
Musée de l'Air et de l'Espace,2002,ILE-DE-FRANCE,LE BOURGET,115247,33081,148328,
Musée Archéologique,2004,POITOU-CHARENTES,SAINTES,1470,34143,35613,
Musée Municipal,2002,ILE-DE-FRANCE,LIVRY-GARGAN,0,11919,11919,
Ecomusée du Val de Bièvre,2002,ILE-DE-FRANCE,FRESNES,0,13461,13461,
Musée d'Art et d'Histoire Georges Turpin,2004,POITOU-CHARENTES,PARTHENAY,5900,0,5900,
Musée de Saint-Maur - Villa Médicis,2002,ILE-DE-FRANCE,LA VARENNE-SAINT-HILAIRE,0,16901,16901,
Musée Sainte-Croix,2004,POITOU-CHARENTES,POITIERS,3464,15662,19126,
Musée du Vieil Argenteuil,2002,ILE-DE-FRANCE,ARGENTEUIL,399,1124,1523,
Musée départemental de préhistoire,2004,PROVENCE-ALPES-CÔTE D'AZUR,QUINSON,74191,0,74191,
Musée de la Renaissance - Château d'Ecouen,2002,ILE-DE-FRANCE,ECOUEN,15717,36022,51739,
Musée Renoir,2004,PROVENCE-ALPES-CÔTE D'AZUR,CAGNES-SUR-MER,21707,8574,30281,
Villa-Musée Jean-Honoré Fragonard,2004,PROVENCE-ALPES-CÔTE D'AZUR,GRASSE,2804,3663,6467,
Etablissement Public du Musée et du Domaine National de Versailles,2002,ILE-DE-FRANCE,VERSAILLES,3529193,697686,4226879,
Musée International de la Parfumerie,2004,PROVENCE-ALPES-CÔTE D'AZUR,GRASSE,33747,0,33747,
Musée Départemental de la Réunion - Musée Léon Dierx,2002,LA REUNION,SAINT-DENIS,0,18992,18992,
Musée Archéologique - Site de  Cimiez,2004,PROVENCE-ALPES-CÔTE D'AZUR,NICE,10831,22301,33132,
Muséum d'Histoire Naturelle,2002,LA REUNION,SAINT-DENIS DE LA REUNION,4625,17476,22101,
Muséum d'Histoire Naturelle,2004,PROVENCE-ALPES-CÔTE D'AZUR,NICE,0,14250,14250,
Musée du Vieux-Logis de Nice,2004,PROVENCE-ALPES-CÔTE D'AZUR,NICE,0,359,359,
Musée du Palais Lascaris,2004,PROVENCE-ALPES-CÔTE D'AZUR,NICE,0,55602,55602,
Musée Léon Alègre,2002,LANGUEDOC-ROUSSILLON,BAGNOLS-SUR-CEZE,310,473,783,
Ecomusée du Pays de la Roudoule,2004,PROVENCE-ALPES-CÔTE D'AZUR,PUGET-ROSTANG,6253,0,6253,
Musée Municipal de la Vignasse,2002,LANGUEDOC-ROUSSILLON,BEAUCAIRE,663,3968,4631,
"Musée Magnelli, Musée de la Céramique",2004,PROVENCE-ALPES-CÔTE D'AZUR,VALLAURIS,29430,12591,42021,
Musée Archéologique,2002,LANGUEDOC-ROUSSILLON,NIMES,9641,15630,25271,
Musée du Pavillon de Vendôme,2004,PROVENCE-ALPES-CÔTE D'AZUR,AIX-EN-PROVENCE,3073,10237,13310,
Carré d'Art Musée d'Art Contemporain de Nîmes,2002,LANGUEDOC-ROUSSILLON,NIMES,19236,17445,36681,
Musée Paul Arbaud,2004,PROVENCE-ALPES-CÔTE D'AZUR,AIX-EN-PROVENCE,1172,0,1172,
Musée des Vallées Cévenoles,2002,LANGUEDOC-ROUSSILLON,SAINT-JEAN DU GARD,14077,1508,15585,
Musée Départemental de l'Arles Antique,2004,PROVENCE-ALPES-CÔTE D'AZUR,ARLES,26689,43541,70230,
Musée Municipal Georges Borias,2002,LANGUEDOC-ROUSSILLON,UZES,1185,998,2183,
Musée Municipal Méditerranéen de Cassis A.T.P.,2004,PROVENCE-ALPES-CÔTE D'AZUR,CASSIS,187,4774,4961,
Musée du Biterrois,2002,LANGUEDOC-ROUSSILLON,BEZIERS,12933,3351,16284,
Musée d'Histoire et d'Archéologie des Baux-de-Provence (Château),2004,PROVENCE-ALPES-CÔTE D'AZUR,LES BAUX DE PROVENCE,233000,0,233000,
Musée Municipal,2002,LANGUEDOC-ROUSSILLON,FRONTIGNAN-LA-PEYRADE,0,11302,11302,
"Musée d'Arts Africains, Océaniens, Amérindiens",2004,PROVENCE-ALPES-CÔTE D'AZUR,MARSEILLE,20631,0,20631,
Musée Archéologique Henri Prades,2002,LANGUEDOC-ROUSSILLON,LATTES,5275,2846,8121,
Musée Grobet-Labadié,2004,PROVENCE-ALPES-CÔTE D'AZUR,MARSEILLE,9812,0,9812,
Musée Fleury,2002,LANGUEDOC-ROUSSILLON,LODEVE,42806,9902,52708,
Musée de la Mode,2004,PROVENCE-ALPES-CÔTE D'AZUR,MARSEILLE,4027,5082,9109,
Musée Languedocien,2002,LANGUEDOC-ROUSSILLON,MONTPELLIER,2987,1878,4865,
Ecomusée du Mont Lozère,2002,LANGUEDOC-ROUSSILLON,LE PONT DE MONTVERT,3851,3140,6991,
Musée Ziem,2004,PROVENCE-ALPES-CÔTE D'AZUR,MARTIGUES,0,7652,7652,
Musée Hyacinthe Rigaud,2002,LANGUEDOC-ROUSSILLON,PERPIGNAN,3345,2616,5961,
Musée Départemental des Hautes-Alpes,2004,PROVENCE-ALPES-CÔTE D'AZUR,GAP,23912,0,23912,
Musée de Cerdagne,2002,LANGUEDOC-ROUSSILLON,SAINTE-LEOCADIE,2633,263,2896,
Musée d'Art et d'Archéologie,2002,LIMOUSIN,GUERET,4711,7125,11836,
Musée du Vêtement Provençal (Jean Aicard),2004,PROVENCE-ALPES-CÔTE D'AZUR,SOLLIES-VILLE,0,3897,3897,
Musée Départemental d'Art Contemporain,2002,LIMOUSIN,ROCHECHOUART,9239,1789,11028,
Musée Comtadin-Duplessis,2004,PROVENCE-ALPES-CÔTE D'AZUR,CARPENTRAS,637,1540,2177,
Musée de l'Histoire du Fer,2002,LORRAINE,JARVILLE-LA-MALGRANGE,7254,0,7254,
Musée Municipal des Emaux et Faïences,2002,LORRAINE,LONGWY,3708,2134,5842,
Musée de la Bresse - Domaine des Planons,2004,RHONE-ALPES,SAINT-CYR-SUR-MENTHON,16566,0,16566,
Musée de la Bière et du Pays de Stenay,2002,LORRAINE,STENAY,13708,0,13708,
Musée d'Argonne,2002,LORRAINE,VARENNES-EN-ARGONNE,3037,120,3157,
Musée de la Batellerie du Rhône,2004,RHONE-ALPES,SERRIERES,810,0,810,
Musée de la Princerie,2002,LORRAINE,VERDUN,2346,2423,4769,
Musée Léon Marès,2004,RHONE-ALPES,LOVAGNY,21664,0,21664,
"Notre histoire, Musée de Rumilly",2004,RHONE-ALPES,RUMILLY,0,2038,2038,
Musée Matheysin,2004,RHONE-ALPES,LA MURE,2251,2229,4480,
Musée d'Archéologie,2002,MIDI-PYRENEES,MONTSEGUR,34120,0,34120,
Conservatoire - Musée des Industries Hydroélectriques,2004,RHONE-ALPES,VAUJANY,0,13804,13804,
Musée du Palais des Evêques,2002,MIDI-PYRENEES,SAINT-LIZIER,6876,1471,8347,
Musée Départemental de la Révolution Française,2004,RHONE-ALPES,VIZILLE,0,72647,72647,
Musée Municipal de Millau,2002,MIDI-PYRENEES,MILLAU,9981,10796,20777,
Musée d'Archéologie,2004,RHONE-ALPES,FEURS,1537,3920,5457,
Musée Municipal d'archéologie,2002,MIDI-PYRENEES,ROQUEFORT-SUR-SOULZON,0,2970,2970,
Musée d'Allard,2004,RHONE-ALPES,MONTBRISON,10891,0,10891,
Musée du Charroi Rural et de l'Artisanat Traditionnel,2002,MIDI-PYRENEES,SALMIECH,0,2559,2559,
Musée des Jacobins,2002,MIDI-PYRENEES,AUCH,6461,4854,11315,
Musée d'Archéologie,2002,MIDI-PYRENEES,LECTOURE,4087,304,4391,
Château de la Bastie d'Urfé,2004,RHONE-ALPES,SAINT-ETIENNE-LE-MOLARD,12757,862,13619,
Musée Municipal d'Art et d'Histoire,2002,MIDI-PYRENEES,SAINT-GAUDENS,2018,0,2018,
Musée des Hospices Civils de Lyon,2004,RHONE-ALPES,LYON,7990,0,7990,
Musée Salies,2002,MIDI-PYRENEES,BAGNERES-DE-BIGORRE,2384,358,2742,
Musée d'Art Contemporain de Lyon,2004,RHONE-ALPES,LYON,29879,34753,64632,
Musée Municipal,2002,MIDI-PYRENEES,LUZ-SAINT-SAUVEUR,1477,0,1477,
Musée-château Gaston Phébus,2002,MIDI-PYRENEES,MAUVEZIN,33099,0,33099,
Musée Savoisien,2004,RHONE-ALPES,CHAMBERY,5952,14596,20548,
Musée Champollion,2002,MIDI-PYRENEES,FIGEAC,29428,0,29428,
Muséum d'histoire naturelle,2004,RHONE-ALPES,CHAMBERY,723,2282,3005,
Musée Gallo-Romain d'Uxellodunum,2002,MIDI-PYRENEES,MARTEL,200,120,320,
Musée de la Folie Marco,2005,ALSACE,BARR,3388,3563,6951,
Musée d'Art Sacré,2002,MIDI-PYRENEES,ROCAMADOUR,7355,1334,8689,
Musée de la Poterie,2005,ALSACE,BETSCHDORF,2214,268,2482,
Musée Toulouse Lautrec,2002,MIDI-PYRENEES,ALBI,135999,11249,147248,
Musée de Bouxwiller et du pays de hanau,2005,ALSACE,BOUXWILLER,1387,1772,3159,
Musée Jean Jaurès,2002,MIDI-PYRENEES,CASTRES,1366,8496,9862,
Musée J.F. Oberlin,2005,ALSACE,WALDERSBACH,15244,2789,18033,
Muséum d'histoire naturelle Philadelphe Thomas,2002,MIDI-PYRENEES,GAILLAC,1020,3063,4083,
Musée Raymond Lafage,2002,MIDI-PYRENEES,LISLE-SUR-TARN,0,1385,1385,
Musée d'Histoire Local,2005,ALSACE,KAYSERSBERG,358,149,507,
Musée Théophile Jouglet,2002,NORD-PAS-DE-CALAIS,ANZIN,0,2734,2734,
Musée EDF Electropolis,2005,ALSACE,MULHOUSE,36088,5793,41881,
Musée Portuaire,2002,NORD-PAS-DE-CALAIS,DUNKERQUE,29455,17392,46847,
Musée Minéralogique de la Société Industrielle de Mulhouse,2005,ALSACE,MULHOUSE,0,1025,1025,
Musée d'Art et d'Industrie,2002,NORD-PAS-DE-CALAIS,TOURCOING,0,21048,21048,
Musée de l'Impression sur Etoffes,2005,ALSACE,MULHOUSE,11395,11706,23101,
Musée Municipal,2002,NORD-PAS-DE-CALAIS,BERCK-SUR-MER,8402,0,8402,
Château musée,2002,NORD-PAS-DE-CALAIS,BOULOGNE-SUR-MER,20594,0,20594,
Maison du Sundgau - Musée Paysan,2005,ALSACE,OLTINGUE,2046,450,2496,
Musée Municipal Bruno Danvin,2002,NORD-PAS-DE-CALAIS,SAINT-POL-SUR-TERNOISE,0,2452,2452,
Musée du Dolder,2005,ALSACE,RIQUEWIHR,5679,513,6192,
Musée du Débarquement,2002,BASSE-NORMANDIE,ARROMANCHES,337485,0,337485,
Musée des Amis de Thann,2005,ALSACE,THANN,669,1283,1952,
Musée-Aquarium,2005,AQUITAINE,CREYSSE,2977,0,2977,
Musée de la Mine,2002,BASSE-NORMANDIE,LE MOLAY-LITTRY,6982,1231,8213,
Musée Paul Reclus,2005,AQUITAINE,DOMME,0,15300,15300,
Musée de la Meunerie - Moulin de Marcy,2002,BASSE-NORMANDIE,LE MOLAY-LITTRY,5559,1127,6686,
Musée National de la Préhistoire,2005,AQUITAINE,LES EYZIES-DE-TAYAC,55541,36523,92064,
Musée d'Art et d'Histoire de Lisieux,2002,BASSE-NORMANDIE,LISIEUX,495,4184,4679,
Musée du Château,2002,BASSE-NORMANDIE,PONTECOULANT,5179,0,5179,
Musée d'Aquitaine,2005,AQUITAINE,BORDEAUX,13573,86307,99880,
Musée du Vieux Château,2002,BASSE-NORMANDIE,BRICQUEBEC-EN-COTENTIN,533,0,533,
Centre National Jean Moulin,2005,AQUITAINE,BORDEAUX,0,23361,23361,
Musée Richard Anacréon,2002,BASSE-NORMANDIE,GRANVILLE,2904,2572,5476,
Musée Maritime de l'Ile de Tatihou,2002,BASSE-NORMANDIE,SAINT-VAAST-LA-HOUGUE,52088,0,52088,
Musée Municipal - Musée du Jouet,2002,BASSE-NORMANDIE,LA FERTE-MACE,456,0,456,
Musée Départemental d'Art Sacré,2002,BASSE-NORMANDIE,SEES,762,453,1215,
Musée Despiau-Wlérick,2005,AQUITAINE,MONT-DE-MARSAN,11315,0,11315,
Musée Municipal Nicolas Poussin,2002,HAUTE-NORMANDIE,LES ANDELYS,1667,0,1667,
Musée de Préhistoire Mésolithique Laurent Coulonges,2005,AQUITAINE,SAUVETERRE-LA-LEMANCE,2030,1048,3078,
Musée d'Art Moderne André Malraux - MuMa,2002,HAUTE-NORMANDIE,LE HAVRE,66172,0,66172,
Musée Municipal (Moulin de Gajac),2005,AQUITAINE,VILLENEUVE-SUR-LOT,4630,4810,9440,
Musée Le Secq des Tournelles,2002,HAUTE-NORMANDIE,ROUEN,7697,7780,15477,
Musée Municipal de Guéthary,2005,AQUITAINE,GUETHARY,986,2353,3339,
Musée Flaubert et d'Histoire de la Médecine,2002,HAUTE-NORMANDIE,ROUEN,2284,4654,6938,
Musée Municipal de Gannat,2005,AUVERGNE,GANNAT,1124,965,2089,
Association de l'Horlogerie Aliermontaise,2002,HAUTE-NORMANDIE,SAINT-NICOLAS-D'ALIERMONT,453,434,887,
Musée Rieckotter,2005,AUVERGNE,NERIS-LES-BAINS,518,505,1023,
Musée du Vignoble Nantais,2002,PAYS DE LA LOIRE,LE PALLET,5534,900,6434,
Musée des Sciences,2005,AUVERGNE,AURILLAC,5575,9213,14788,
Musée du Château des Ducs de Bretagne,2002,PAYS DE LA LOIRE,NANTES,40174,12232,52406,
Musée de la Haute Auvergne,2005,AUVERGNE,SAINT-FLOUR,3085,2610,5695,
Musée  Départemental Dobrée,2002,PAYS DE LA LOIRE,NANTES,7095,23059,30154,
Musée d'art et d'histoire Alfred Douët,2005,AUVERGNE,SAINT-FLOUR,2001,3310,5311,
Maison de l'Eclusier /Parc Naturel Régional de Brière,2002,PAYS DE LA LOIRE,SAINT-MALO DE GUERSAC,4457,0,4457,
Musée Municipal Marcel Sahut,2005,AUVERGNE,VOLVIC,447,1614,2061,
Musée Pincé,2002,PAYS DE LA LOIRE,ANGERS,4157,10463,14620,
Musée du Vin de Bourgogne,2005,BOURGOGNE,BEAUNE,24150,4457,28607,
Musée des Beaux-Arts,2002,PAYS DE LA LOIRE,ANGERS,0,3453,3453,
Musée Jean Lurcat et de la Tapisserie Contemporaine,2002,PAYS DE LA LOIRE,ANGERS,16989,55620,72609,
"Musée de la Vie Bourguignonne, Perrin de Puycousin",2005,BOURGOGNE,DIJON,0,33156,33156,
Musée d'Art et d'Histoire,2002,PAYS DE LA LOIRE,BAUGE,5332,1428,6760,
Musée Municipal,2005,BOURGOGNE,NUITS-SAINT-GEORGES,841,1003,1844,
Musée Archéologique Départemental de Jublains,2002,PAYS DE LA LOIRE,JUBLAINS,12464,23864,36328,
Musée René Davoine,2005,BOURGOGNE,CHAROLLES,116,195,311,
Musée du Vieux Château,2002,PAYS DE LA LOIRE,LAVAL,4662,8837,13499,
Musée de la Tour du Moulin,2005,BOURGOGNE,MARCIGNY,1294,120,1414,
Hôtel Dieu - Musée Greuze,2005,BOURGOGNE,TOURNUS,11580,3895,15475,
Musée de la Reine Bérengère,2002,PAYS DE LA LOIRE,LE MANS,6810,0,6810,
Musée Colette,2005,BOURGOGNE,SAINT-SAUVEUR-EN-PUISAYE,10587,0,10587,
Musée de la Construction Navale Artisanale,2002,PAYS DE LA LOIRE,NOIRMOUTIER EN L'ILE,14828,525,15353,
Musée Jean de la Fontaine,2002,PICARDIE,CHATEAU-THIERRY,7201,2926,10127,
Musée Mathurin Meheut,2005,BRETAGNE,LAMBALLE,4893,142,5035,
Musée Entomologique,2002,PICARDIE,SAINT-QUENTIN,2914,9270,12184,
Musée de la Pêche,2005,BRETAGNE,CONCARNEAU,37488,3204,40692,
Musée Municipal de Soissons,2002,PICARDIE,SOISSONS,0,17783,17783,
Musée de Pont-Aven,2005,BRETAGNE,PONT-AVEN,40472,2795,43267,
Musée Alexandre Dumas,2002,PICARDIE,VILLERS COTTERETS,4015,0,4015,
Musée d'Histoire de la Ville de Saint-Malo,2005,BRETAGNE,SAINT-MALO,19971,5818,25789,
Musée Antoine Vivenel,2002,PICARDIE,COMPIEGNE,2279,6802,9081,
Musée Emile Chénon,2005,CENTRE,CHATEAUMEILLANT,876,1819,2695,
Muséum des Sciences Naturelles et de Préhistoire,2005,CENTRE,CHARTRES,615,11553,12168,
Cité International de la Bande Dessinée et de l'Image - Musée de la Bande Dessinée,2002,POITOU-CHARENTES,ANGOULEME,30264,0,30264,
Musée Balzac,2005,CENTRE,SACHE,16517,6239,22756,
Musée Napoléonien et Africain,2002,POITOU-CHARENTES,ILE D'AIX,14956,23490,38446,
Musée de la Corbillière,2005,CENTRE,MER,917,0,917,
Musée des Beaux-Arts,2002,POITOU-CHARENTES,LA ROCHELLE,6711,0,6711,
Musée de Sologne,2005,CENTRE,ROMORANTIN-LANTHENAY,3845,7708,11553,
Muséum d'Histoire Naturelle,2002,POITOU-CHARENTES,LA ROCHELLE,0,21818,21818,
Musée Girodet,2005,CENTRE,MONTARGIS,9665,0,9665,
Musée Dupuy-Mestreau,2002,POITOU-CHARENTES,SAINTES,1003,1958,2961,
Musée d'Art et d'Histoire,2005,CHAMPAGNE-ARDENNES,LANGRES,0,15715,15715,
Musée des Tumulus de Bougon,2002,POITOU-CHARENTES,BOUGON,31106,0,31106,
Musée Hôtel le Vergeur,2005,CHAMPAGNE-ARDENNES,REIMS,5170,5310,10480,
Musée des Ruralies,2002,POITOU-CHARENTES,PRAHECQ,11200,0,11200,
Musée de l'Ancien Collège des Jésuites/Planétarium,2005,CHAMPAGNE-ARDENNES,REIMS,28720,10294,39014,
Musée de la Faïence,2002,PROVENCE-ALPES-CÔTE D'AZUR,MOUSTIERS-SAINTE-MARIE,7198,4789,11987,
Musée départemental de préhistoire,2002,PROVENCE-ALPES-CÔTE D'AZUR,QUINSON,106546,0,106546,
Musée d'archéologie d'Aleria - Jérôme Carcopino,2005,CORSE,ALERIA,23884,18227,42111,
Musée d'Histoire et d'Archéologie,2002,PROVENCE-ALPES-CÔTE D'AZUR,ANTIBES,4819,7703,12522,
Musée de la Corse,2005,CORSE,CORTE,40064,8437,48501,
Musée Fernand Léger,2002,PROVENCE-ALPES-CÔTE D'AZUR,BIOT,15975,6799,22774,
Musée des Beaux-Arts,2005,FRANCHE-COMTE,DOLE,0,21646,21646,
Musée-Château de Cagnes,2002,PROVENCE-ALPES-CÔTE D'AZUR,CAGNES-SUR-MER,17126,8172,25298,
Musée de la Castre,2002,PROVENCE-ALPES-CÔTE D'AZUR,CANNES,7807,7540,15347,
Musée Précolombien Edgar Clerc,2005,GUADELOUPE,LE MOULE,0,2000,2000,
Musée de la Mer,2002,PROVENCE-ALPES-CÔTE D'AZUR,CANNES,23214,15937,39151,
Musée Territorial Alexandre Franconie,2005,GUYANE,CAYENNE,7418,2537,9955,
Musée International de la Parfumerie,2002,PROVENCE-ALPES-CÔTE D'AZUR,GRASSE,23066,13355,36421,
Musée Français de la Photographie,2005,ILE-DE-FRANCE,BIEVRES,2700,650,3350,
Musée des Beaux-Arts,2002,PROVENCE-ALPES-CÔTE D'AZUR,MENTON,0,14971,14971,
Musée-Jardin Paul Landowski,2005,ILE-DE-FRANCE,BOULOGNE-BILLANCOURT,1098,0,1098,
Musée du Palais Lascaris,2002,PROVENCE-ALPES-CÔTE D'AZUR,NICE,0,50955,50955,
Fondation Arp,2005,ILE-DE-FRANCE,CLAMART,2098,602,2700,
Musée Archéologique - Site de Terra Amata,2002,PROVENCE-ALPES-CÔTE D'AZUR,NICE,3732,12884,16616,
Musée Municipal d'Art et d'Histoire,2005,ILE-DE-FRANCE,COLOMBES,0,3685,3685,
Ecomusée du Pays de la Roudoule,2002,PROVENCE-ALPES-CÔTE D'AZUR,PUGET-ROSTANG,6003,2256,8259,
Musées de la Citadelle,2002,PROVENCE-ALPES-CÔTE D'AZUR,VILLEFRANCHE-SUR-MER,0,55173,55173,
Musée du Pavillon de Vendôme,2002,PROVENCE-ALPES-CÔTE D'AZUR,AIX-EN-PROVENCE,1480,8856,10336,
Musée National des Châteaux de Malmaison et de Bois-Préau,2005,ILE-DE-FRANCE,RUEIL-MALMAISON,42300,30692,72992,
Muséum d'Histoire Naturelle,2002,PROVENCE-ALPES-CÔTE D'AZUR,AIX-EN-PROVENCE,9785,15221,25006,
Musée de l'Île-de-France,2005,ILE-DE-FRANCE,SCEAUX,926,35513,36439,
Musée des Tapisseries,2002,PROVENCE-ALPES-CÔTE D'AZUR,AIX-EN-PROVENCE,10640,7400,18040,
Musée Réattu,2002,PROVENCE-ALPES-CÔTE D'AZUR,ARLES,37242,0,37242,
Galerie d'Anatomie Comparée et de Paléontologie (Muséum d'Histoire Naturelle),2005,ILE-DE-FRANCE,PARIS,170367,50080,220447,
Musée Folklorique du Vieux Lambesc,2002,PROVENCE-ALPES-CÔTE D'AZUR,LAMBESC,469,593,1062,
Musée de Montmartre,2005,ILE-DE-FRANCE,PARIS,40070,6138,46208,
Musée du Vieux Marseille,2002,PROVENCE-ALPES-CÔTE D'AZUR,MARSEILLE,2879,4621,7500,
Musée d'Art Moderne de la ville de Paris,2005,ILE-DE-FRANCE,PARIS,12925,67801,80726,
Musée Ziem,2002,PROVENCE-ALPES-CÔTE D'AZUR,MARTIGUES,0,7321,7321,
Musée Municipal Paul Lafran,2002,PROVENCE-ALPES-CÔTE D'AZUR,SAINT-CHAMAS,0,4480,4480,
Musée Baroncelli,2002,PROVENCE-ALPES-CÔTE D'AZUR,SAINTES-MARIES-DE-LA-MER,1418,0,1418,
Musée Henri Chapu,2005,ILE-DE-FRANCE,LE MEE-SUR-SEINE,0,866,866,
Musée Municipal,2002,PROVENCE-ALPES-CÔTE D'AZUR,DRAGUIGNAN,0,8262,8262,
Musée d'Art et d'Histoire de Melun,2005,ILE-DE-FRANCE,MELUN,1707,4625,6332,
Musée de la Société d’Etudes Scientifiques et Achéologiques,2002,PROVENCE-ALPES-CÔTE D'AZUR,DRAGUIGNAN,0,200,200,
Musée de l'Annonciade,2002,PROVENCE-ALPES-CÔTE D'AZUR,SAINT-TROPEZ,43058,5711,48769,
Musée des Pays de Seine-et-Marne,2005,ILE-DE-FRANCE,SAINT-CYR-SUR-MORIN,7131,0,7131,
Musée d'Apt,2002,PROVENCE-ALPES-CÔTE D'AZUR,APT,3464,0,3464,
Ecomusée,2005,ILE-DE-FRANCE,SAVIGNY-LE-TEMPLE,0,7589,7589,
Musée Archéologique Théo Desplans,2002,PROVENCE-ALPES-CÔTE D'AZUR,VAISON-LA-ROMAINE,79352,235,79587,
Musée Emile Jean,2005,ILE-DE-FRANCE,VILLIERS-SUR-MARNE,0,850,850,
Musée de la Résistance et de la Déportation de l'Ain,2002,RHONE-ALPES,NANTUA,9025,0,9025,
"MAC VAL, Musée d'Art Contemporain du Val-de-Marne",2005,ILE-DE-FRANCE,VITRY SUR SEINE,7439,25167,32606,
Musée Chintreuil,2002,RHONE-ALPES,PONT-DE-VAUX,4477,958,5435,
Musée du Vieil Argenteuil,2005,ILE-DE-FRANCE,ARGENTEUIL,354,1005,1359,
Cité de Préhistoire,2002,RHONE-ALPES,ORGNAC-L'AVEN,138817,0,138817,
Musée de la Renaissance - Château d'Ecouen,2005,ILE-DE-FRANCE,ECOUEN,19445,35177,54622,
Musée du Château des Adhémars,2002,RHONE-ALPES,MONTELIMAR,17984,0,17984,
Musée National de Port Royal des Champs,2005,ILE-DE-FRANCE,MAGNY-LES-HAMEAUX,8345,10237,18582,
Musée Alpin,2002,RHONE-ALPES,CHAMONIX,18366,8034,26400,
Musée d'Archéologie Nationale (des origines à l'an mille) - Château de st-Germain-en-Laye,2005,ILE-DE-FRANCE,SAINT-GERMAIN-EN-LAYE,20976,44949,65925,
Musée du Chablais,2002,RHONE-ALPES,THONON-LES-BAINS,2813,0,2813,
Collections de la Fondation de Coubertin,2005,ILE-DE-FRANCE,SAINT-REMY-LES-CHEVREUSE,6545,1010,7555,
Musée de Bourgoin-Jallieu,2002,RHONE-ALPES,BOURGOIN-JALLIEU,4805,4692,9497,
Musée Historique de Villèle,2005,LA REUNION,SAINT-GILLES-LES-HAUTS,20241,11064,31305,
Musée de Grenoble,2002,RHONE-ALPES,GRENOBLE,49964,84069,134033,
Musée Dauphinois,2002,RHONE-ALPES,GRENOBLE,45893,0,45893,
Musée d'Allard,2002,RHONE-ALPES,MONTBRISON,6831,2717,9548,
Musée Archéologique,2005,LANGUEDOC-ROUSSILLON,SALLELES D'AUDE,11560,0,11560,
Musée Folklorique du Vieux Saint-Etienne,2002,RHONE-ALPES,SAINT-ETIENNE,1496,0,1496,
Musée Cévenol,2005,LANGUEDOC-ROUSSILLON,LE VIGAN,3167,2237,5404,
Musée de la Mine / Site Couriot,2002,RHONE-ALPES,SAINT-ETIENNE,34120,20387,54507,
Musée du Biterrois,2005,LANGUEDOC-ROUSSILLON,BEZIERS,4218,12752,16970,
Musée de l'Ephèbe,2005,LANGUEDOC-ROUSSILLON,LE CAP D'AGDE,9738,4231,13969,
Centre d'Histoire de la Résistance et de la Déportation,2002,RHONE-ALPES,LYON,60626,0,60626,
Musée de la Préhistoire des Matelles,2005,LANGUEDOC-ROUSSILLON,LES MATELLES,550,1106,1656,
Musée des Beaux-Arts,2002,RHONE-ALPES,LYON,184553,147993,332546,
Musée Fleury,2005,LANGUEDOC-ROUSSILLON,LODEVE,57058,0,57058,
Musée Archéologique,2002,RHONE-ALPES,SAINT-ROMAIN-EN-GAL,76632,0,76632,
Musée Archéologique,2005,LANGUEDOC-ROUSSILLON,MINERVE,5177,0,5177,
Musée du docteur Faure,2002,RHONE-ALPES,AIX-LES-BAINS,9387,3850,13237,
Musée Municipal d'Albertville-Conflans,2002,RHONE-ALPES,ALBERTVILLE,6575,0,6575,
Musée Paul Valéry,2005,LANGUEDOC-ROUSSILLON,SETE,4479,9484,13963,
Musée du Costume,2002,RHONE-ALPES,BOURG-SAINT-MAURICE,1502,0,1502,
Ecomusée du Mont Lozère,2005,LANGUEDOC-ROUSSILLON,LE PONT DE MONTVERT,2809,1810,4619,
Musée Savoisien,2002,RHONE-ALPES,CHAMBERY,6268,12721,18989,
Musée départemental d'Art Moderne,2005,LANGUEDOC-ROUSSILLON,CERET,121541,24944,146485,
Musée des Charmettes,2002,RHONE-ALPES,CHAMBERY,3117,7050,10167,
Musée Barrois,2005,LORRAINE,BAR-LE-DUC,2844,7136,9980,
Musée de la Folie Marco,2003,ALSACE,BARR,2548,1139,3687,
Musée d'Art Sacré de la Meuse,2005,LORRAINE,SAINT-MIHIEL,2831,564,3395,
Musée de Bouxwiller et du pays de hanau,2003,ALSACE,BOUXWILLER,2374,931,3305,
Musée de la Bière et du Pays de Stenay,2005,LORRAINE,STENAY,8255,4134,12389,
Musée du Fer,2003,ALSACE,REICHSHOFFEN,1614,0,1614,
Musée Départemental du Sel,2005,LORRAINE,MARSAL,6079,5834,11913,
Musée du Château des Rohan,2003,ALSACE,SAVERNE,4115,8791,12906,
La Tour aux Puces - Musée du Pays Thionvillois,2005,LORRAINE,THIONVILLE,2724,11399,14123,
Musée Archéologique,2003,ALSACE,STRASBOURG,16645,30400,47045,
Ecomusée de la Martinique,2005,MARTINIQUE,RIVIERE-PILOTE,9207,2000,11207,
Musée Zoologique de Strasbourg,2003,ALSACE,STRASBOURG,9309,25969,35278,
Musée Régional de Géologie Pierre Vetter,2005,MIDI-PYRENEES,DECAZEVILLE,1338,2079,3417,
Musée de l'Œuvre Notre-Dame,2003,ALSACE,STRASBOURG,16369,21448,37817,
Musée des Arts Décoratifs,2003,ALSACE,STRASBOURG,13565,38813,52378,
Musée Municipal Urbain Cabrol,2005,MIDI-PYRENEES,VILLEFRANCHE-DE-ROUERGUE,0,3452,3452,
Musée d'Archéologie,2005,MIDI-PYRENEES,LECTOURE,1855,1200,3055,
Musée Sundgauvien d'Altkirch,2003,ALSACE,ALTKIRCH,1970,8906,10876,
Musée Paul Dupuy,2005,MIDI-PYRENEES,TOULOUSE,5789,6492,12281,
Musée Bartholdi,2003,ALSACE,COLMAR,6523,2835,9358,
Musée des Augustins,2005,MIDI-PYRENEES,TOULOUSE,45433,50268,95701,
Musée du Florival,2003,ALSACE,GUEBWILLER,3575,2485,6060,
Musée des Beaux-Arts,2003,ALSACE,MULHOUSE,0,9327,9327,
Musée Salies,2005,MIDI-PYRENEES,BAGNERES-DE-BIGORRE,2205,190,2395,
Cité du Train,2003,ALSACE,MULHOUSE,64802,0,64802,
Musée de Préhistoire Amédée Lémozi,2005,MIDI-PYRENEES,CABRERETS,72870,0,72870,
Musée EDF Electropolis,2003,ALSACE,MULHOUSE,19928,3095,23023,
Musée-Aquarium,2003,AQUITAINE,CREYSSE,5813,0,5813,
Musée d'Art et d'Histoire Charles Portal,2005,MIDI-PYRENEES,CORDES-SUR-CIEL,423,509,932,
Musée National de la Préhistoire,2003,AQUITAINE,LES EYZIES-DE-TAYAC,29265,33213,62478,
Musée du Pays Vaurais,2005,MIDI-PYRENEES,LAVAUR,5418,2082,7500,
Musée du Vieil Auvillar,2005,MIDI-PYRENEES,AUVILLAR,1990,394,2384,
Musée Militaire - Souvenir du Périgord,2003,AQUITAINE,PERIGUEUX,1995,453,2448,
Muséum d'Histoire Naturelle de Bordeaux,2003,AQUITAINE,BORDEAUX,3427,28073,31500,
Musée d'Archéologie et d'Histoire Locale,2005,NORD-PAS-DE-CALAIS,DENAIN,0,2500,2500,
Ecomusée de la Région,2005,NORD-PAS-DE-CALAIS,FOURMIES,48377,0,48377,
Musée de la Chalosse,2003,AQUITAINE,MONTFORT-EN-CHALOSSE,7719,1726,9445,
Musée Municipal d'Hazebrouck,2005,NORD-PAS-DE-CALAIS,HAZEBROUCK,2150,1177,3327,
Ecomusée de la Grande Lande,2003,AQUITAINE,SABRES,75703,8327,84030,
Musée des Beaux-Arts,2005,NORD-PAS-DE-CALAIS,ROUBAIX,71173,99355,170528,
Musée d'Art et d'Histoire du Cap de Gascogne,2003,AQUITAINE,SAINT-SEVER,0,2000,2000,
Musée des Beaux-Arts,2005,NORD-PAS-DE-CALAIS,VALENCIENNES,44536,0,44536,
Musée Municipal du Lac,2003,AQUITAINE,SANGUINET,1864,118,1982,
Musée Quentovic,2005,NORD-PAS-DE-CALAIS,ETAPLES-SUR-MER,3271,1855,5126,
Musée Municipal (Moulin de Gajac),2003,AQUITAINE,VILLENEUVE-SUR-LOT,1923,3951,5874,
Musée de l'Hôtel Sandelin,2005,NORD-PAS-DE-CALAIS,SAINT-OMER,16574,0,16574,
Musée Bonnat,2003,AQUITAINE,BAYONNE,14139,17433,31572,
Musée Municipal Bruno Danvin,2005,NORD-PAS-DE-CALAIS,SAINT-POL-SUR-TERNOISE,0,1833,1833,
Musée Municipal de Guéthary,2003,AQUITAINE,GUETHARY,442,2142,2584,
Mémorial de Caen,2005,BASSE-NORMANDIE,CAEN,368345,36395,404740,
Musée National du Château,2003,AQUITAINE,PAU,52731,30365,83096,
Musée de la Meunerie - Moulin de Marcy,2005,BASSE-NORMANDIE,LE MOLAY-LITTRY,5057,2142,7199,
Musée des Arts D'Afrique et D'Asie,2003,AUVERGNE,VICHY,2419,1178,3597,
Musée du Château,2005,BASSE-NORMANDIE,PONTECOULANT,3274,1416,4690,
Château de Saint-Germain de Livet,2005,BASSE-NORMANDIE,SAINT-GERMAIN DE LIVET,16457,5325,21782,
Musée Paléontologique,2003,AUVERGNE,MENAT,1035,20,1055,
Musée de l'Abbaye,2005,BASSE-NORMANDIE,CERISY-LA-FORET,6700,670,7370,
Musée des Peintres de l'Ecole de Murols,2003,AUVERGNE,MUROL,4633,128,4761,
Musée Thomas Henry,2005,BASSE-NORMANDIE,CHERBOURG-EN-COTENTIN,0,14269,14269,
Musée Francisque Mandet,2003,AUVERGNE,RIOM,2028,4754,6782,
Musée Quesnel-Morinière,2005,BASSE-NORMANDIE,COUTANCES,2254,7250,9504,
Musée du Pays Châtillonnais - Trésor de Vix,2003,BOURGOGNE,CHATILLON-SUR-SEINE,27112,6610,33722,
"Musée de la Vie Bourguignonne, Perrin de Puycousin",2003,BOURGOGNE,DIJON,6178,21341,27519,
"Musée du Bocage Normand, ferme du bois Jugan",2005,BASSE-NORMANDIE,SAINT-LO,2972,2081,5053,
Musée d'Art Sacré,2003,BOURGOGNE,DIJON,1708,3224,4932,
Musée des Beaux-Arts et de la Dentelle,2005,BASSE-NORMANDIE,ALENCON,9254,6907,16161,
Muséum - Jardin des Sciences,2003,BOURGOGNE,DIJON,6288,115552,121840,
Musée Départemental des Arts et Traditions Populaires du Perche,2005,BASSE-NORMANDIE,SAINT-CYR LA ROSIERE,15772,6774,22546,
Musée des Arts et Traditions des Hautes-Côtes,2003,BOURGOGNE,GEVREY-CHAMBERTIN - Reulle Vergy,654,159,813,
Musée Artisanal et Industriel d'Instruments à Vent,2005,HAUTE-NORMANDIE,LA COUTURE-BOUSSEY,1783,820,2603,
Musée du Costume,2003,BOURGOGNE,CHATEAU-CHINON,5076,683,5759,
Musée Municipal Nicolas Poussin,2005,HAUTE-NORMANDIE,LES ANDELYS,959,1199,2158,
Musée de la Loire,2003,BOURGOGNE,COSNE-SUR-LOIRE,764,4095,4859,
Musée Municipal,2005,HAUTE-NORMANDIE,LOUVIERS,97,3456,3553,
Musée d'Art et d'Archéologie,2003,BOURGOGNE,CLUNY,81150,20421,101571,
Musée des Ursulines,2003,BOURGOGNE,MACON,2441,7312,9753,
Musée d'Elbeuf,2005,HAUTE-NORMANDIE,ELBEUF,0,6738,6738,
Musée des Terres-Neuvas et de la Pêche,2005,HAUTE-NORMANDIE,FECAMP,16438,13841,30279,
Musée Eucharistique du Hiéron,2003,BOURGOGNE,PARAY-LE-MONIAL,1895,1745,3640,
Musée des Sapeurs-Pompiers de France,2005,HAUTE-NORMANDIE,MONTVILLE,4475,1960,6435,
Musée Bourguignon -  Perrin de Puycousin,2003,BOURGOGNE,TOURNUS,1247,1231,2478,
Ecomusée de la Basse-Seine,2005,HAUTE-NORMANDIE,NOTRE-DAME-DE-BLIQUETUIT,32588,0,32588,
Hôtel Dieu - Musée Greuze,2003,BOURGOGNE,TOURNUS,9449,2311,11760,
MUNAE - Musée National de l'Education,2005,HAUTE-NORMANDIE,ROUEN,12763,0,12763,
Maison du Blé et du Pain,2003,BOURGOGNE,VERDUN-SUR-LE-DOUBS,4633,837,5470,
Association de l'Horlogerie Aliermontaise,2005,HAUTE-NORMANDIE,SAINT-NICOLAS-D'ALIERMONT,216,297,513,
Musée Leblanc-Duvernois,2003,BOURGOGNE,AUXERRE,1246,1350,2596,
Musée des Marais Salant,2005,PAYS DE LA LOIRE,BATZ-SUR-MER,16255,971,17226,
Musée Colette,2003,BOURGOGNE,SAINT-SAUVEUR-EN-PUISAYE,10463,1949,12412,
Musée du Vignoble Nantais,2005,PAYS DE LA LOIRE,LE PALLET,4027,1685,5712,
Musée National de la Marine,2003,BRETAGNE,BREST,28158,22491,50649,
Musée d'Art de Nantes,2005,PAYS DE LA LOIRE,NANTES,46110,75037,121147,
Musée de la Faucillonnaie,2003,BRETAGNE,MONTREUIL-SOUS-PEROUSE,2176,1747,3923,
Ecomusée de Saint-Nazaire,2005,PAYS DE LA LOIRE,SAINT-NAZAIRE,2424,78410,80834,
Musée de Bretagne,2003,BRETAGNE,RENNES,57123,0,57123,
Musée d'Art et d'Histoire,2005,PAYS DE LA LOIRE,BAUGE,1944,1192,3136,
Ecomusée Industriel des Forges,2003,BRETAGNE,INZINZAC-LOCHRIST,3883,379,4262,
Musée du Textile,2005,PAYS DE LA LOIRE,CHOLET,4923,6860,11783,
Muséum des Sciences Naturelles et de Préhistoire,2003,CENTRE,CHARTRES,0,14344,14344,
Musée de l'Ardoise,2005,PAYS DE LA LOIRE,TRELAZE,9200,4400,13600,
Conservatoire du Machinisme et des Pratiques Agricoles,2003,CENTRE,CHARTRES-MAINVILLIERS,14688,37912,52600,
Musée Vert Véron-de-Forbonnais,2005,PAYS DE LA LOIRE,LE MANS,5780,7392,13172,
Musée de la Chemiserie et de l'Elégance Masculine,2003,CENTRE,ARGENTON-SUR-CREUSE,3741,3315,7056,
Musée de l'Abbaye de Sainte-Croix,2005,PAYS DE LA LOIRE,LES SABLES D'OLONNE,5162,14350,19512,
Musées de Châteauroux - Hôtel Bertrand,2003,CENTRE,CHATEAUROUX,0,13045,13045,
Musée Milcendeau Jean-Yole,2005,PAYS DE LA LOIRE,SOULLANS,1439,3430,4869,
Musée François Rabelais,2003,CENTRE,SEUILLY,15048,0,15048,
Musée municipal de Chauny,2005,PICARDIE,CHAUNY,0,2750,2750,
Maison de la Magie,2003,CENTRE,BLOIS,48197,14845,63042,
Musée du Château de Compiègne,2005,PICARDIE,COMPIEGNE,41505,55467,96972,
Château-Musée de Gien,2003,CENTRE,GIEN,20293,3938,24231,
Musée Historique et Archéologique,2003,CENTRE,ORLEANS,1061,3211,4272,
Musée Antoine Vivenel,2005,PICARDIE,COMPIEGNE,950,7635,8585,
Musée Napoléon Ier,2003,CHAMPAGNE-ARDENNES,BRIENNE-LE-CHATEAU,3110,2161,5271,
Musée Jean Calvin,2005,PICARDIE,NOYON,2975,0,2975,
Musée Paul Dubois - Alfred Boucher,2003,CHAMPAGNE-ARDENNES,NOGENT-SUR-SEINE,6655,679,7334,
Musée de la Vénerie,2005,PICARDIE,SENLIS,603,4867,5470,
Musée Vauluisant - Musée de la Bonneterie,2003,CHAMPAGNE-ARDENNES,TROYES,2921,3143,6064,
Musée de l'Hôtel de Berny,2005,PICARDIE,AMIENS,72,2755,2827,
Musée Municipal,2003,CHAMPAGNE-ARDENNES,BOURBONNE-LES-BAINS,385,60,445,
Atelier - Musée du Papier,2005,POITOU-CHARENTES,ANGOULEME,0,14042,14042,
Musée des Beaux-Arts et d'Archéologie,2003,CHAMPAGNE-ARDENNES,CHAUMONT,1552,4281,5833,
Musée Archéologique,2005,POITOU-CHARENTES,SAINTES,1463,39059,40522,
Musée Municipal,2003,CHAMPAGNE-ARDENNES,SAINT-DIZIER,0,3846,3846,
Musée de l'Echevinage,2005,POITOU-CHARENTES,SAINTES,900,3897,4797,
Musée Hôtel le Vergeur,2003,CHAMPAGNE-ARDENNES,REIMS,5476,6120,11596,
Musée des Tumulus de Bougon,2005,POITOU-CHARENTES,BOUGON,22612,6186,28798,
Musée Saint-Rémi,2003,CHAMPAGNE-ARDENNES,REIMS,38653,0,38653,
Musée de Bressuire,2005,POITOU-CHARENTES,BRESSUIRE,0,3870,3870,
Planétarium/Musée de l'Ancien Collège des Jésuites,2003,CHAMPAGNE-ARDENNES,REIMS,33968,8557,42525,
Musée Comtois,2003,FRANCHE-COMTE,BESANCON,60000,3716,63716,
Musée Municipal de l'Hôtel de Sully,2005,POITOU-CHARENTES,CHATELLERAULT,365,27,392,
Musée de la résistance et de la Déportation,2003,FRANCHE-COMTE,BESANCON,61978,7936,69914,
Musée Gassendi,2005,PROVENCE-ALPES-CÔTE D'AZUR,DIGNE-LES-BAINS,2734,6759,9493,
Musée Baron Martin,2003,FRANCHE-COMTE,GRAY,3041,3047,6088,
Musée de la Vigne et du Vin,2003,FRANCHE-COMTE,ARBOIS,5507,1583,7090,
Musée Picasso,2005,PROVENCE-ALPES-CÔTE D'AZUR,ANTIBES,128757,41619,170376,
Musée des Beaux-Arts,2003,FRANCHE-COMTE,LONS-LE-SAUNIER,931,3676,4607,
Musée d'Art et d'Histoire de Provence,2005,PROVENCE-ALPES-CÔTE D'AZUR,GRASSE,4912,18000,22912,
Musée Départemental Albert-Kahn,2003,ILE-DE-FRANCE,BOULOGNE-BILLANCOURT,57097,14643,71740,
Musée Jean Cocteau Collection Séverin Wunderman,2005,PROVENCE-ALPES-CÔTE D'AZUR,MENTON,10867,4836,15703,
Musée-Jardin Paul Landowski,2003,ILE-DE-FRANCE,BOULOGNE-BILLANCOURT,1907,0,1907,
Musée du Vieux-Logis de Nice,2005,PROVENCE-ALPES-CÔTE D'AZUR,NICE,0,404,404,
Musée des Automates,2003,ILE-DE-FRANCE,NEUILLY-SUR-SEINE,5842,7541,13383,
Musée d'Art Moderne et d'Art Contemporain,2005,PROVENCE-ALPES-CÔTE D'AZUR,NICE,53419,52421,105840,
Musée national de céramique de Sèvres,2003,ILE-DE-FRANCE,SEVRES,17700,24708,42408,
Musée Archéologique - Site de Terra Amata,2005,PROVENCE-ALPES-CÔTE D'AZUR,NICE,3362,12014,15376,
Grande Galerie de l'Evolution (Muséum National d'Histoire Naturelle),2003,ILE-DE-FRANCE,PARIS,317699,164513,482212,
Musée Picasso la guerre et la paix à Vallauris,2005,PROVENCE-ALPES-CÔTE D'AZUR,VALLAURIS,22133,7143,29276,
Musée National des Arts et des Traditions Populaires,2003,ILE-DE-FRANCE,PARIS,4675,17043,21718,
"Musée Magnelli, Musée de la Céramique",2005,PROVENCE-ALPES-CÔTE D'AZUR,VALLAURIS,22140,7148,29288,
Musée National de la Marine,2003,ILE-DE-FRANCE,PARIS,119049,49223,168272,
Musée du Parlement de Provence et du Vieil Aix,2005,PROVENCE-ALPES-CÔTE D'AZUR,AIX-EN-PROVENCE,7498,6582,14080,
Musée des Tapisseries,2005,PROVENCE-ALPES-CÔTE D'AZUR,AIX-EN-PROVENCE,13410,13328,26738,
Musée de Montmartre,2003,ILE-DE-FRANCE,PARIS,45274,3654,48928,
Muséon Arlaten,2005,PROVENCE-ALPES-CÔTE D'AZUR,ARLES,15558,26989,42547,
Musée de la Musique,2003,ILE-DE-FRANCE,PARIS,123013,26848,149861,
Musée Réattu,2005,PROVENCE-ALPES-CÔTE D'AZUR,ARLES,15094,15740,30834,
Musée National Auguste Rodin,2003,ILE-DE-FRANCE,PARIS,299641,213709,513350,
Musée Municipal Méditerranéen de Cassis A.T.P.,2005,PROVENCE-ALPES-CÔTE D'AZUR,CASSIS,301,5204,5505,
Musée d'Orsay,2003,ILE-DE-FRANCE,PARIS,1197071,632503,1829574,
Musée Alphonse Daudet,2005,PROVENCE-ALPES-CÔTE D'AZUR,FONTVIEILLE,34474,0,34474,
Musée Municipal de Chelles Alfred Bonno,2003,ILE-DE-FRANCE,CHELLES,0,4169,4169,
Musée Archéologique d'Istres René Beaucaire,2005,PROVENCE-ALPES-CÔTE D'AZUR,ISTRES,1837,3015,4852,
Musée Municipal des Capucins,2003,ILE-DE-FRANCE,COULOMMIERS,1019,1452,2471,
Musée d'Histoire et d'Archéologie des Baux-de-Provence,2005,PROVENCE-ALPES-CÔTE D'AZUR,LES BAUX DE PROVENCE,176309,0,176309,
Musée de la Faïence,2005,PROVENCE-ALPES-CÔTE D'AZUR,MARSEILLE,3405,9565,12970,
Musée du Château de Fontainebleau,2003,ILE-DE-FRANCE,FONTAINEBLEAU,205593,93323,298916,
Musée de l'Empéri de Salon et de la Crau,2005,PROVENCE-ALPES-CÔTE D'AZUR,SALON-DE-PROVENCE,7605,15257,22862,
Musée Bossuet,2003,ILE-DE-FRANCE,MEAUX,4743,3743,8486,
Muséum d'Histoire Naturelle de Toulon,2005,PROVENCE-ALPES-CÔTE D'AZUR,TOULON,0,29645,29645,
Musée Départemental de Préhistoire d'Île de France,2003,ILE-DE-FRANCE,NEMOURS,3892,20743,24635,
Musée d'Apt,2005,PROVENCE-ALPES-CÔTE D'AZUR,APT,5104,0,5104,
Musée Calvet (et musée Lapidaire),2005,PROVENCE-ALPES-CÔTE D'AZUR,AVIGNON,16575,14242,30817,
Musée de la Société d'Histoire et d'Archéologie,2005,RHONE-ALPES,BRIORD,10,25,35,
Ecomusée du Val de Bièvre,2003,ILE-DE-FRANCE,FRESNES,0,10000,10000,
Musée de Saint-Maur - Villa Médicis,2003,ILE-DE-FRANCE,LA VARENNE-SAINT-HILAIRE,0,9331,9331,
Musée Vivarois César Filhol,2005,RHONE-ALPES,ANNONAY,615,1488,2103,
Musée d'Histoire et d'Archéologie,2005,RHONE-ALPES,DIE,1106,1237,2343,
Musée d'Art et d'Histoire Louis Senlecq,2003,ILE-DE-FRANCE,L'ISLE-ADAM,3261,14635,17896,
Musée du Château des Adhémars,2005,RHONE-ALPES,MONTELIMAR,11481,0,11481,
Musée Camille Pissarro,2003,ILE-DE-FRANCE,PONTOISE,0,2196,2196,
Musée Léon Marès,2005,RHONE-ALPES,LOVAGNY,20832,0,20832,
Musée intercommunal d’histoire et d’archéologie de Louvres,2003,ILE-DE-FRANCE,ROISSY-EN-FRANCE,747,0,747,
"Notre histoire, Musée de Rumilly",2005,RHONE-ALPES,RUMILLY,0,3975,3975,
Musée Promenade Marly/Louveciennes,2003,ILE-DE-FRANCE,LOUVECIENNES,13823,2977,16800,
Musée Géo-Charles,2005,RHONE-ALPES,ECHIROLLES,0,4686,4686,
Musée de la Ville,2003,ILE-DE-FRANCE,MONTIGNY LE BRETONNEUX,3715,4303,8018,
Musée de la Soierie,2005,RHONE-ALPES,CHARLIEU,4733,811,5544,
Musée du Jouet Pierre Pinel,2003,ILE-DE-FRANCE,POISSY,17366,3310,20676,
Musée Rambolitrain,2003,ILE-DE-FRANCE,RAMBOUILLET,14741,1580,16321,
Musée Départemental de la Réunion - Musée Léon Dierx,2003,LA REUNION,SAINT-DENIS,2080,3665,5745,
Musée Archéologique du Lauragais,2003,LANGUEDOC-ROUSSILLON,CASTELNAUDARY,0,1000,1000,
Carré d'Art Musée d'Art Contemporain de Nîmes,2003,LANGUEDOC-ROUSSILLON,NIMES,22202,28028,50230,
Musée des Beaux-Arts,2005,RHONE-ALPES,LYON,104006,140269,244275,
Musée de l'Ephèbe,2003,LANGUEDOC-ROUSSILLON,LE CAP D'AGDE,15259,3849,19108,
Musée du docteur Faure,2005,RHONE-ALPES,AIX-LES-BAINS,5666,3828,9494,
Musée de la Préhistoire des Matelles,2003,LANGUEDOC-ROUSSILLON,LES MATELLES,707,1379,2086,
Musée Savoisien,2005,RHONE-ALPES,CHAMBERY,16967,0,16967,
Musée Fabre,2003,LANGUEDOC-ROUSSILLON,MONTPELLIER,25588,18377,43965,
Musée des Charmettes,2005,RHONE-ALPES,CHAMBERY,0,10258,10258,
Musée Languedocien,2003,LANGUEDOC-ROUSSILLON,MONTPELLIER,4426,0,4426,
Musée de Bouxwiller et du pays de hanau,2006,ALSACE,BOUXWILLER,1450,303,1753,
Musée de Préhistoire Régionale et du Mégalithisme,2003,LANGUEDOC-ROUSSILLON,SAINT-PONS-DE-THOMIERES,1812,0,1812,
Maison de l'Archéologie des Vosges du Nord,2006,ALSACE,NIEDERBRONN-LES-BAINS,1223,595,1818,
Musée d'Art Moderne - Fonds Peskè,2003,LANGUEDOC-ROUSSILLON,COLLIOURE,6795,1944,8739,
Musée Alsacien,2006,ALSACE,STRASBOURG,20252,28186,48438,
Musée du Cloître de Tulle André Mazeyrie,2003,LIMOUSIN,TULLE,3138,24655,27793,
Cabinet des Estampes et des Dessins,2006,ALSACE,STRASBOURG,0,88,88,
Musée Départemental de la Tapisserie,2003,LIMOUSIN,AUBUSSON,17031,4483,21514,
Les Sources d'Hercule,2003,LORRAINE,DENEUVRE,5209,734,5943,
Musée Gallo-Romain,2006,ALSACE,BIESHEIM,912,1956,2868,
Musée de l'Ecole de Nancy,2003,LORRAINE,NANCY,28220,20175,48395,
Cité du Train,2006,ALSACE,MULHOUSE,66680,33857,100537,
Musée Barrois,2003,LORRAINE,BAR-LE-DUC,4000,6000,10000,
Musée EDF Electropolis,2006,ALSACE,MULHOUSE,29139,5184,34323,
Musée de la Céramique et de l'Ivoire,2003,LORRAINE,COMMERCY,1484,814,2298,
Ecomusée d'Alsace,2006,ALSACE,UNGERSHEIM,156553,23952,180505,
Musée Départemental Raymond Poincaré,2003,LORRAINE,SAMPIGNY,292,529,821,
Musée du Tabac,2006,AQUITAINE,BERGERAC,3918,1851,5769,
Musée d'Argonne,2003,LORRAINE,VARENNES-EN-ARGONNE,2459,102,2561,
Musée Militaire - Souvenir du Périgord,2006,AQUITAINE,PERIGUEUX,1691,943,2634,
Maison du Verre et du Cristal,2003,LORRAINE,MEISENTHAL,15356,667,16023,
Musée de la Lutherie et de l'Archèterie Française,2003,LORRAINE,MIRECOURT,6299,2305,8604,
Muséum d'Histoire Naturelle de Bordeaux,2006,AQUITAINE,BORDEAUX,7088,52466,59554,
Musée Régional de Géologie Pierre Vetter,2003,MIDI-PYRENEES,DECAZEVILLE,994,222,1216,
Musée des Arts Décoratifs,2006,AQUITAINE,BORDEAUX,12526,27797,40323,
Musée Municipal de Millau,2003,MIDI-PYRENEES,MILLAU,11935,10731,22666,
Musée de la Voiture à Cheval,2006,AQUITAINE,BOURG-SUR-GIRONDE,2667,533,3200,
Musée de l'Armagnac,2003,MIDI-PYRENEES,CONDOM,5636,97,5733,
Musée des Beaux-Arts et d'Archéologie,2006,AQUITAINE,LIBOURNE,0,3448,3448,
Musée Historique de l'Hydravion,2006,AQUITAINE,BISCARROSSE,20781,1181,21962,
Musée du Pays de Luchon,2003,MIDI-PYRENEES,BAGNERES-DE-LUCHON,2218,373,2591,
Musée Archéologique,2006,AQUITAINE,HASTINGUES,4210,5840,10050,
Musée Municipal,2003,MIDI-PYRENEES,LUZ-SAINT-SAUVEUR,1080,0,1080,
Musée de la Faïence et des arts de la table,2006,AQUITAINE,SAMADET,3496,3823,7319,
Musée Massey,2003,MIDI-PYRENEES,TARBES,1200,300,1500,
Musée des Beaux-Arts,2006,AQUITAINE,AGEN,10728,12796,23524,
Musée Municipal,2003,MIDI-PYRENEES,VAYRAC,305,43,348,
Musée du Liège et du Bouchon,2006,AQUITAINE,MEZIN,6008,1069,7077,
Musée Départemental du Textile,2003,MIDI-PYRENEES,LA-BASTIDE-ROUAIROUX,2013,3039,5052,
Musée du Château Henri IV,2006,AQUITAINE,NERAC,16682,4700,21382,
Musée Ingres,2003,MIDI-PYRENEES,MONTAUBAN,12555,25748,38303,
Musée de Préhistoire Mésolithique Laurent Coulonges,2006,AQUITAINE,SAUVETERRE-LA-LEMANCE,2371,1070,3441,
Musée du Mont-de-Piété,2003,NORD-PAS-DE-CALAIS,BERGUES,1677,1043,2720,
Musée Basque et de l'Histoire de Bayonne,2006,AQUITAINE,BAYONNE,21085,10576,31661,
Musée de l'Ostrevant,2003,NORD-PAS-DE-CALAIS,BOUCHAIN,68,873,941,
Musée Municipal de Guéthary,2006,AQUITAINE,GUETHARY,502,1247,1749,
Musée de la Chartreuse,2003,NORD-PAS-DE-CALAIS,DOUAI,10564,25887,36451,
Musée des Musiques Populaires - MuPop,2006,AUVERGNE,MONTLUCON,5586,1896,7482,
Musée Portuaire,2003,NORD-PAS-DE-CALAIS,DUNKERQUE,27894,16644,44538,
Musée des Arts D'Afrique et D'Asie,2006,AUVERGNE,VICHY,2992,1508,4500,
Musée des Beaux-Arts,2003,NORD-PAS-DE-CALAIS,DUNKERQUE,4794,12324,17118,
Musée d'Art et d'Archéologie,2006,AUVERGNE,AURILLAC,965,18593,19558,
Musée d'Histoire Naturelle et de Géologie,2003,NORD-PAS-DE-CALAIS,LILLE,21525,27086,48611,
Musée de Paléontologie,2006,AUVERGNE,CHILHAC,1228,0,1228,
Musée d'Art et d'Industrie,2003,NORD-PAS-DE-CALAIS,TOURCOING,0,20664,20664,
Musée Paléontologique,2006,AUVERGNE,MENAT,1686,0,1686,
Musée des Beaux-Arts et de la Dentelle,2003,NORD-PAS-DE-CALAIS,CALAIS,3474,15176,18650,
Musée Régional d'Auvergne,2006,AUVERGNE,RIOM,2122,730,2852,
Musée Jean-Charles Cazin,2003,NORD-PAS-DE-CALAIS,SAMER,0,950,950,
Musée Bonaparte,2006,BOURGOGNE,AUXONNE,0,3163,3163,
Musée Baron Gérard,2003,BASSE-NORMANDIE,BAYEUX,1483,12054,13537,
Musée François Rude,2006,BOURGOGNE,DIJON,0,31089,31089,
Musée des Techniques Fromagères,2003,BASSE-NORMANDIE,SAINT-PIERRE-SUR-DIVES,965,0,965,
Musée Archéologique,2006,BOURGOGNE,DIJON,0,22568,22568,
Musée du Vieux Château,2003,BASSE-NORMANDIE,BRICQUEBEC-EN-COTENTIN,465,207,672,
Musée des Beaux-Arts,2006,BOURGOGNE,MONTBARD,209,941,1150,
Musée de l'Abbaye,2003,BASSE-NORMANDIE,CERISY-LA-FORET,6718,1829,8547,
Musée Buffon,2006,BOURGOGNE,MONTBARD,1776,5901,7677,
Musée des Beaux-Arts,2003,BASSE-NORMANDIE,SAINT-LO,2591,7141,9732,
Musée Municipal,2006,BOURGOGNE,SEMUR-EN-AUXOIS,1682,3285,4967,
Musée Départemental des Arts et Traditions Populaires du Perche,2003,BASSE-NORMANDIE,SAINT-CYR LA ROSIERE,12014,3511,15525,
Musée du Septennat,2006,BOURGOGNE,CHATEAU-CHINON,17759,3441,21200,
Musée Municipal,2003,HAUTE-NORMANDIE,BERNAY,3172,6326,9498,
Musée René Davoine,2006,BOURGOGNE,CHAROLLES,928,0,928,
Musée de l'Ancien Evêché,2003,HAUTE-NORMANDIE,EVREUX,7147,6201,13348,
"L'Atelier d'un Journal"" de Louhans - Musée Municipal",2006,BOURGOGNE,LOUHANS,1887,502,2389,
Musée Artisanal et Industriel d'Instruments à Vent,2003,HAUTE-NORMANDIE,LA COUTURE-BOUSSEY,679,98,777,
Ecomusée de la Bresse Bourguignonne,2006,BOURGOGNE,PIERRE-DE-BRESSE,23612,6763,30375,
Musée municipal de Vernon,2003,HAUTE-NORMANDIE,VERNON,1965,5518,7483,
Musée Départemental du Compagnonnage,2006,BOURGOGNE,ROMANECHE-THORINS,2367,1423,3790,
Hôtel Dieu - Musée Greuze,2006,BOURGOGNE,TOURNUS,8144,2276,10420,
Musée Louis-Philippe du Château d'Eu,2003,HAUTE-NORMANDIE,EU,2533,2399,4932,
Musée d'Art et d'Histoire,2006,BOURGOGNE,AUXERRE,9700,22082,31782,
Musée des Arts & de l'Enfance,2003,HAUTE-NORMANDIE,FECAMP,1195,4244,5439,
Musée Muncipal,2006,BOURGOGNE,SENS,9195,19919,29114,
Musée d'Art Moderne André Malraux - MuMa,2003,HAUTE-NORMANDIE,LE HAVRE,39203,12102,51305,
Musée des Beaux-Arts de Brest,2006,BRETAGNE,BREST,3017,14102,17119,
La Maison de l'Armateur,2003,HAUTE-NORMANDIE,LE HAVRE,0,182,182,
Musée de Morlaix,2006,BRETAGNE,MORLAIX,7410,10426,17836,
Abbaye de Graville - Musée du Prieuré de Graville,2003,HAUTE-NORMANDIE,LE HAVRE,1921,3283,5204,
Musée Bigouden,2006,BRETAGNE,PONT-L'ABBE,9076,2031,11107,
Muséum d'Histoire Naturelle,2003,HAUTE-NORMANDIE,LE HAVRE,0,32639,32639,
Musée de la Faucillonnaie,2006,BRETAGNE,MONTREUIL-SOUS-PEROUSE,1606,697,2303,
Musée des Antiquités de la Seine-Maritime,2003,HAUTE-NORMANDIE,ROUEN,24340,0,24340,
Musée des Beaux-Arts,2006,BRETAGNE,RENNES,13805,42092,55897,
Musée National de l'Education,2003,HAUTE-NORMANDIE,ROUEN,3643,9954,13597,
Musée d'Histoire de la Ville de Saint-Malo,2006,BRETAGNE,SAINT-MALO,19261,7503,26764,
Musée Municipal des Ivoires,2003,HAUTE-NORMANDIE,YVETOT,598,137,735,
Musée International du Long-Cours Cap-Hornier,2006,BRETAGNE,SAINT-MALO,6867,3283,10150,
Musée Saint-Nicolas,2006,BRETAGNE,VITRE,1972,914,2886,
Musée des Beaux-Arts de Nantes,2003,PAYS DE LA LOIRE,NANTES,52309,91766,144075,
Musée du Château de Suscinio,2006,BRETAGNE,SARZEAU,90721,0,90721,
Musée Pincé,2003,PAYS DE LA LOIRE,ANGERS,5532,10622,16154,
Musée du Château Charles VII,2006,CENTRE,MEHUN-SUR-YEVRE,10000,0,10000,
Musée d'Art et d'Histoire,2003,PAYS DE LA LOIRE,CHOLET,2509,10912,13421,
Musée des Beaux-Arts,2006,CENTRE,CHARTRES,6760,9582,16342,
Musée de l'Ardoise et de la Géologie,2003,PAYS DE LA LOIRE,RENAZE,1274,1200,2474,
Musée d'Art et d'Histoire de Dreux,2006,CENTRE,DREUX,8866,0,8866,
Musée Vert Véron-de-Forbonnais,2003,PAYS DE LA LOIRE,LE MANS,13721,2120,15841,
Musée de l'Histoire du Perche,2006,CENTRE,NOGENT-LE-ROTROU,12635,6742,19377,
Bibliothèque-musée,2003,PAYS DE LA LOIRE,SAINT-CALAIS,0,5000,5000,
Musée Ornithologique (Ecomusée de la Brenne),2006,CENTRE,LE BLANC,3304,1589,4893,
Musée - Centre de Documentation Alfred Desmasures,2003,PICARDIE,HIRSON,0,973,973,
Musée de l'Hôtel de Ville,2006,CENTRE,RICHELIEU,684,0,684,
Musée Antoine Lecuyer,2003,PICARDIE,SAINT-QUENTIN,4566,7020,11586,
Musée Balzac,2006,CENTRE,SACHE,15366,4462,19828,
Musée Municipal,2006,CENTRE,SAINTE-MAURE-DE-TOURAINE,51,0,51,
Musée de l'Archerie et de l'Art Sacré,2003,PICARDIE,CREPY-EN-VALOIS,2646,1064,3710,
Ecomusée du Véron,2006,CENTRE,SAVIGNY-EN-VERON,4186,2904,7090,
Musée de Picardie,2003,PICARDIE,AMIENS,24306,32661,56967,
Musée du Gatinais,2006,CENTRE,MONTARGIS,337,0,337,
Musée Girodet,2006,CENTRE,MONTARGIS,1695,2955,4650,
Musée-Historial de la Grande Guerre,2003,PICARDIE,PERONNE,66286,6049,72335,
Musée des Sciences Naturelles,2006,CENTRE,ORLEANS,7671,57841,65512,
Muséum d'Histoire Naturelle,2003,POITOU-CHARENTES,LA ROCHELLE,0,17746,17746,
Musée Arthur Rimbaud,2006,CHAMPAGNE-ARDENNES,CHARLEVILLE-MEZIERES,5329,11659,16988,
Musée de l'Echevinage,2003,POITOU-CHARENTES,SAINTES,1859,6755,8614,
Musée du Feutre,2006,CHAMPAGNE-ARDENNES,MOUZON,6759,0,6759,
Musée Dupuy-Mestreau,2003,POITOU-CHARENTES,SAINTES,951,1869,2820,
Musée du Château-Fort,2006,CHAMPAGNE-ARDENNES,SEDAN,68406,0,68406,
Musée Municipal des Cordeliers,2003,POITOU-CHARENTES,SAINT-JEAN-D'ANGELY,2094,0,2094,
Pharmacie Musée de l'Hôtel-Dieu,2006,CHAMPAGNE-ARDENNES,TROYES,2351,2473,4824,
Musée Picasso,2003,PROVENCE-ALPES-CÔTE D'AZUR,ANTIBES,101221,31365,132586,
Musée Municipal,2006,CHAMPAGNE-ARDENNES,SAINT-DIZIER,0,10160,10160,
Musée d'Art Naïf Anatole Jakovsky,2003,PROVENCE-ALPES-CÔTE D'AZUR,NICE,4082,11168,15250,
Musée National Message Biblique Marc Chagall,2003,PROVENCE-ALPES-CÔTE D'AZUR,NICE,91809,86671,178480,
Musée d'archéologie d'Aleria - Jérôme Carcopino,2006,CORSE,ALERIA,24544,18547,43091,
Musée Matisse,2003,PROVENCE-ALPES-CÔTE D'AZUR,NICE,74647,47581,122228,
Musées de la Citadelle,2003,PROVENCE-ALPES-CÔTE D'AZUR,VILLEFRANCHE-SUR-MER,0,60117,60117,
Muséum de Besançon,2006,FRANCHE-COMTE,BESANCON,222515,0,222515,
Musée du Pavillon de Vendôme,2003,PROVENCE-ALPES-CÔTE D'AZUR,AIX-EN-PROVENCE,4982,6472,11454,
Musée Paul Arbaud,2003,PROVENCE-ALPES-CÔTE D'AZUR,AIX-EN-PROVENCE,1148,1925,3073,
Musée des Beaux-Arts et d'Archéologie,2006,FRANCHE-COMTE,BESANCON,59858,25714,85572,
Musée Réattu,2003,PROVENCE-ALPES-CÔTE D'AZUR,ARLES,5726,16196,21922,
Musée Sarret de Grozon,2006,FRANCHE-COMTE,ARBOIS,0,337,337,
Musée Frédéric Mistral,2003,PROVENCE-ALPES-CÔTE D'AZUR,MAILLANE,1709,338,2047,
Musée de la Vigne et du Vin,2006,FRANCHE-COMTE,ARBOIS,5597,0,5597,
"Musée d'Arts Africains, Océaniens, Amérindiens",2003,PROVENCE-ALPES-CÔTE D'AZUR,MARSEILLE,8889,16011,24900,
Musée Municipal d'Archéologie,2006,FRANCHE-COMTE,CHAMPAGNOLE,249,426,675,
Musée du Vieux Marseille,2003,PROVENCE-ALPES-CÔTE D'AZUR,MARSEILLE,326,1898,2224,
Musée des Beaux-Arts,2006,FRANCHE-COMTE,DOLE,0,18976,18976,
Musée d'Art Contemporain - Galeries Contemporaines,2003,PROVENCE-ALPES-CÔTE D'AZUR,MARSEILLE,16387,6236,22623,
Musée des Beaux-Arts,2006,FRANCHE-COMTE,LONS-LE-SAUNIER,873,5531,6404,
Musée d'Archéologie Méditerranéenne,2003,PROVENCE-ALPES-CÔTE D'AZUR,MARSEILLE,7446,19976,27422,
Viséum-Musée de la Lunette,2006,FRANCHE-COMTE,MOREZ HAUTS DE BIENNE,17600,0,17600,
Musée de l'Empéri de Salon et de la Crau,2003,PROVENCE-ALPES-CÔTE D'AZUR,SALON-DE-PROVENCE,9462,5672,15134,
Musée de la Société d’Etudes Scientifiques et Achéologiques,2003,PROVENCE-ALPES-CÔTE D'AZUR,DRAGUIGNAN,0,100,100,
Donation Maurice Jardot,2006,FRANCHE-COMTE,BELFORT,4275,0,4275,
Muséum d'Histoire Naturelle de Toulon,2003,PROVENCE-ALPES-CÔTE D'AZUR,TOULON,0,42774,42774,
Musée d'Art et d'Archéologie,2003,PROVENCE-ALPES-CÔTE D'AZUR,TOULON,0,37547,37547,
Musée du Château,2006,ILE-DE-FRANCE,DOURDAN,9243,6436,15679,
Musée National de la Marine de Toulon,2003,PROVENCE-ALPES-CÔTE D'AZUR,TOULON,16508,14370,30878,
Musée d'Art et d'Histoire,2006,ILE-DE-FRANCE,MEUDON,683,11114,11797,
Musée d'Apt,2003,PROVENCE-ALPES-CÔTE D'AZUR,APT,3950,1269,5219,
Musée Franco-Suisse,2006,ILE-DE-FRANCE,RUEIL-MALMAISON,379,530,909,
Synagogue Musée Juif Comtadin,2003,PROVENCE-ALPES-CÔTE D'AZUR,CAVAILLON,5026,0,5026,
Musée de l'Île-de-France,2006,ILE-DE-FRANCE,SCEAUX,0,39089,39089,
Musée national de la céramique de Sèvres,2006,ILE-DE-FRANCE,SEVRES,20092,14345,34437,
Musée-Bibliothèque François Pétrarque,2003,PROVENCE-ALPES-CÔTE D'AZUR,FONTAINE-DE-VAUCLUSE,263,0,263,
Galerie d'Anatomie Comparée et de Paléontologie (Muséum d'Histoire Naturelle),2006,ILE-DE-FRANCE,PARIS,156968,45608,202576,
Musée National Eugène Delacroix,2006,ILE-DE-FRANCE,PARIS,24154,9890,34044,
Musée Archéologique,2003,RHONE-ALPES,IZERNORE,0,300,300,
Musée de l'Armée,2006,ILE-DE-FRANCE,PARIS,840731,259269,1100000,
Musée-château d'Annecy,2003,RHONE-ALPES,ANNECY,51066,76634,127700,
Musée Carnavalet-Histoire de Paris,2006,ILE-DE-FRANCE,PARIS,291763,505358,797121,
Musée - Parc Archéologique du Lac de Paladru,2003,RHONE-ALPES,CHARAVINES,5274,7486,12760,
"Petit Palais, Musée des Beaux-Arts de la ville de Paris",2006,ILE-DE-FRANCE,PARIS,104034,690515,794549,
Musée Hébert,2003,RHONE-ALPES,LA TRONCHE,0,2658,2658,
Etablissement Public du Musée des Arts Asiatiques Guimet,2006,ILE-DE-FRANCE,PARIS,170694,93239,263933,
Musée Hector Berlioz,2003,RHONE-ALPES,LA-COTE-SAINT-ANDRE,4130,7359,11489,
Musée Nissim de Camondo (UCAD),2006,ILE-DE-FRANCE,PARIS,27031,12031,39062,
Musée des Beaux-Arts et d'Archéologie,2003,RHONE-ALPES,VIENNE,2908,0,2908,
Musée Folklorique du Vieux Saint-Etienne,2003,RHONE-ALPES,SAINT-ETIENNE,364,525,889,
Etablissement public du musée d'Orsay,2006,ILE-DE-FRANCE,PARIS,1823952,1185251,3009203,
Musée d'Art et d'Industrie,2003,RHONE-ALPES,SAINT-ETIENNE,25749,16103,41852,
Musée d'Art Moderne et Contemporain,2003,RHONE-ALPES,SAINT-ETIENNE,32570,21233,53803,
Musée du Château de Fontainebleau,2006,ILE-DE-FRANCE,FONTAINEBLEAU,223607,121762,345369,
Château de la Bastie d'Urfé,2003,RHONE-ALPES,SAINT-ETIENNE-LE-MOLARD,13328,1006,14334,
Musée Municipal,2003,RHONE-ALPES,SAINT-GERMAIN-LAVAL,0,100,100,
Musée Municipal,2006,ILE-DE-FRANCE,LIVRY-GARGAN,0,11887,11887,
Musée des Civilisations : Daniel Pouget,2003,RHONE-ALPES,SAINT-JUST-SAINT-RAMBERT,4431,676,5107,
Musée Emile Jean,2006,ILE-DE-FRANCE,VILLIERS-SUR-MARNE,0,370,370,
Musées Gadagne,2003,RHONE-ALPES,LYON,9339,10532,19871,
Musée du Vieil Argenteuil,2006,ILE-DE-FRANCE,ARGENTEUIL,1308,1266,2574,
Musée des Beaux-Arts,2003,RHONE-ALPES,LYON,200658,159116,359774,
Musée Archéologique du Val d'Oise,2006,ILE-DE-FRANCE,GUIRY-EN-VEXIN,12725,0,12725,
Musée de l'Académie de La Val d'Isère,2003,RHONE-ALPES,MOÛTIERS,165,286,451,
Musée Promenade Marly/Louveciennes,2006,ILE-DE-FRANCE,LOUVECIENNES,10340,2096,12436,
Musée de la Folie Marco,2004,ALSACE,BARR,2498,2213,4711,
Musée National de Port Royal des Champs,2006,ILE-DE-FRANCE,MAGNY-LES-HAMEAUX,7264,12311,19575,
Musée de la Poterie,2004,ALSACE,BETSCHDORF,2801,0,2801,
Musée de l'Image Populaire de Pfaffenhoffen,2004,ALSACE,PFAFFENHOFFEN,2446,1255,3701,
Etablissement Public du Musée et du Domaine National de Versailles,2006,ILE-DE-FRANCE,VERSAILLES,3830231,911527,4741758,
Musée Archéologique,2004,ALSACE,STRASBOURG,23669,34304,57973,
Musée Agathois,2006,LANGUEDOC-ROUSSILLON,AGDE,3817,1427,5244,
Musée de l'Œuvre Notre-Dame,2004,ALSACE,STRASBOURG,15376,21671,37047,
Site Archéologique Lattara - Musée Henri Prades de Montpellier Agglomération,2006,LANGUEDOC-ROUSSILLON,LATTES,3608,5477,9085,
Musée Alsacien,2004,ALSACE,STRASBOURG,24731,27303,52034,
Musée du Vieux Montpellier,2006,LANGUEDOC-ROUSSILLON,MONTPELLIER,0,6200,6200,
Musée du Vignoble et des Vins d'Alsace,2004,ALSACE,KIENTZHEIM,5125,80,5205,
Musée du Cloître de Tulle André Mazeyrie,2006,LIMOUSIN,TULLE,37148,0,37148,
Musée EDF Electropolis,2004,ALSACE,MULHOUSE,35990,6258,42248,
Musée d'Art et d'Archéologie,2006,LIMOUSIN,GUERET,5521,5822,11343,
Château de Bourdeilles,2004,AQUITAINE,BOURDEILLES,25325,0,25325,
Musée Départemental d'Art Contemporain,2006,LIMOUSIN,ROCHECHOUART,6556,5673,12229,
Musée de l'Ecole de Nancy,2006,LORRAINE,NANCY,26014,16631,42645,
Muséum- Aquarium de Nancy,2006,LORRAINE,NANCY,30344,52156,82500,
Musée des Beaux-Arts,2004,AQUITAINE,BORDEAUX,100017,0,100017,
"Musée ""au Fil du Papier""",2006,LORRAINE,PONT-A-MOUSSON,2645,2800,5445,
Atelier-Musée  (Ecomusée de la Grande Landes),2004,AQUITAINE,LUXEY,5721,0,5721,
Musée de la Bière et du Pays de Stenay,2006,LORRAINE,STENAY,8276,5745,14021,
Musée Despiau-Wlérick,2004,AQUITAINE,MONT-DE-MARSAN,7426,0,7426,
Musées de la Cour d'Or,2006,LORRAINE,METZ,8135,20007,28142,
Musée du Patrimoine Religieux et des Croyances Populaires,2004,AQUITAINE,MOUSTEY,1054,0,1054,
Musée du Château Henri IV,2004,AQUITAINE,NERAC,17569,2697,20266,
Moulin de la Blies - Musée des Techniques Faïencières,2006,LORRAINE,SARREGUEMINES,3826,9386,13212,
Musée Edmond Rostand,2004,AQUITAINE,CAMBO-LES-BAINS,56163,2006,58169,
Musée Charles de Bruyères,2006,LORRAINE,REMIREMONT,7221,1112,8333,
Musée Municipal de Gannat,2004,AUVERGNE,GANNAT,1135,593,1728,
Musée de La Canne,2006,MARTINIQUE,LES TROIS ILETS,18417,2269,20686,
Musée des Musiques Populaires - MuPop,2004,AUVERGNE,MONTLUCON,1016,2942,3958,
Ecomusée de la Martinique,2006,MARTINIQUE,RIVIERE-PILOTE,8908,2242,11150,
Musée des Arts D'Afrique et D'Asie,2004,AUVERGNE,VICHY,2533,1623,4156,
Musée du Textile et du Peigne en Corne,2006,MIDI-PYRENEES,LAVELANET,974,0,974,
Musée des Manufactures de Dentelles,2004,AUVERGNE,RETOURNAC,3811,1191,5002,
Musée d'Archéologie,2006,MIDI-PYRENEES,MONTSEGUR,24754,0,24754,
Musée d'Archéologie Bargoin,2004,AUVERGNE,CLERMONT-FERRAND,136,6532,6668,
Musée du Palais des Evêques,2006,MIDI-PYRENEES,SAINT-LIZIER,5539,1003,6542,
Muséum d'Histoire Naturelle Henri-Lecoq,2004,AUVERGNE,CLERMONT-FERRAND,22323,0,22323,
Musée Municipal de Millau,2006,MIDI-PYRENEES,MILLAU,10634,11687,22321,
Musée Fenaille,2006,MIDI-PYRENEES,RODEZ,8532,10358,18890,
Musée des Beaux-Arts,2004,BOURGOGNE,BEAUNE,6382,1791,8173,
Musée Magnin,2004,BOURGOGNE,DIJON,8237,9988,18225,
Musée Albert André,2006,MIDI-PYRENEES,BAGNOLS-SUR-CEZE,1748,1341,3089,
Musée Archéologique,2004,BOURGOGNE,DIJON,2336,24279,26615,
Musée Cévenol,2006,MIDI-PYRENEES,LE VIGAN,2553,1904,4457,
Musée Noisot,2004,BOURGOGNE,FIXIN,374,305,679,
Musée de la Maison Romane,2006,MIDI-PYRENEES,SAINT-GILLES-DU-GARD,0,6290,6290,
Musée des Beaux-Arts,2004,BOURGOGNE,MONTBARD,0,952,952,
Musée Municipal Georges Borias,2006,MIDI-PYRENEES,UZES,1129,1451,2580,
Musée Buffon,2004,BOURGOGNE,MONTBARD,800,1656,2456,
Musée Paul Dupuy,2006,MIDI-PYRENEES,TOULOUSE,7575,7220,14795,
Musée de la Loire,2004,BOURGOGNE,COSNE-SUR-LOIRE,4321,0,4321,
Muséum d'Histoire Naturelle,2006,MIDI-PYRENEES,BAGNERES-DE-BIGORRE,1500,289,1789,
Musée de la Mine,2004,BOURGOGNE,LA MACHINE,5943,558,6501,
Musée du Grès de Puisaye,2004,BOURGOGNE,SAINT-AMAND-EN-PUISAYE,3196,0,3196,
Musée Eugénie et Maurice Guérin,2006,MIDI-PYRENEES,ANDILLAC,2295,2970,5265,
Musée des Beaux-Arts,2006,MIDI-PYRENEES,GAILLAC,3941,3225,7166,
Ecomusée de la Communauté Le Creusot-Monceau-Les-Mines,2004,BOURGOGNE,LE CREUSOT,14431,5375,19806,
Muséum d'histoire naturelle Philadelphe Thomas,2006,MIDI-PYRENEES,GAILLAC,506,2472,2978,
"L'Atelier d'un Journal"" de Louhans - Musée Municipal",2004,BOURGOGNE,LOUHANS,2242,357,2599,
Musée de l'Abbaye Saint-Michel,2006,MIDI-PYRENEES,GAILLAC,2909,869,3778,
Musée des Ursulines,2004,BOURGOGNE,MACON,4042,7664,11706,
Musée Départemental du Textile,2006,MIDI-PYRENEES,LA-BASTIDE-ROUAIROUX,3336,3705,7041,
Musée Lamartine,2004,BOURGOGNE,MACON,1659,2028,3687,
Musée Théophile Jouglet,2006,NORD-PAS-DE-CALAIS,ANZIN,0,2500,2500,
Musée Bourguignon -  Perrin de Puycousin,2004,BOURGOGNE,TOURNUS,1445,969,2414,
Musée Benoît de Puydt,2006,NORD-PAS-DE-CALAIS,BAILLEUL,1678,3647,5325,
Musée Muncipal,2004,BOURGOGNE,SENS,9968,8947,18915,
Musée d'Archéologie et d'Histoire Locale,2006,NORD-PAS-DE-CALAIS,DENAIN,0,2550,2550,
Musée d'Art et d'Histoire,2004,BRETAGNE,SAINT-BRIEUC,0,24035,24035,
Palais des Beaux-Arts de Lille,2006,NORD-PAS-DE-CALAIS,LILLE,190929,0,190929,
Le Port-Musée,2004,BRETAGNE,DOUARNENEZ,47711,0,47711,
Musée d'Histoire Locale de Marchiennes,2006,NORD-PAS-DE-CALAIS,MARCHIENNES,186,434,620,
Ecomusée d'Ouessant - Vivre sur une Ile,2004,BRETAGNE,OUESSANT,12228,0,12228,
Musée Municipal,2006,NORD-PAS-DE-CALAIS,BERCK-SUR-MER,3171,7612,10783,
Musée de Pont-Aven,2004,BRETAGNE,PONT-AVEN,45551,4200,49751,
Musée des Beaux-Arts et de la Dentelle,2006,NORD-PAS-DE-CALAIS,CALAIS,0,16437,16437,
Musée des Beaux-Arts,2004,BRETAGNE,QUIMPER,21195,14137,35332,
Musée Quentovic,2006,NORD-PAS-DE-CALAIS,ETAPLES-SUR-MER,2738,1036,3774,
Musée des Rochers-Sévigné,2004,BRETAGNE,VITRE,8150,2072,10222,
Musée Langlois,2006,BASSE-NORMANDIE,BEAUMONT-EN-AUGE,192,0,192,
Ecomusée de Saint-Dégan,2004,BRETAGNE,BREC'H,10811,1100,11911,
Musée de la Meunerie - Moulin de Marcy,2006,BASSE-NORMANDIE,LE MOLAY-LITTRY,3777,2787,6564,
Musée du Château de Suscinio,2004,BRETAGNE,SARZEAU,105569,0,105569,
Musée Municipal,2006,BASSE-NORMANDIE,ORBEC,750,1750,2500,
Musée d'Art et d'Histoire de Dreux,2004,CENTRE,DREUX,4866,0,4866,
Musée du Vieux Château,2006,BASSE-NORMANDIE,BRICQUEBEC-EN-COTENTIN,545,183,728,
Musée du Vieux Granville,2006,BASSE-NORMANDIE,GRANVILLE,4605,4596,9201,
"Musée du Bocage Normand, ferme du bois Jugan",2006,BASSE-NORMANDIE,SAINT-LO,4017,2225,6242,
Musée Archéologique d'Argentomagus,2004,CENTRE,SAINT-MARCEL,10869,10531,21400,
Musée Régional du Cidre et du Calvados,2006,BASSE-NORMANDIE,VALOGNES,3682,425,4107,
Musée Départemental des Arts et Traditions Populaires du Perche,2006,BASSE-NORMANDIE,SAINT-CYR LA ROSIERE,14953,8843,23796,
Musée Lansyer,2004,CENTRE,LOCHES,4519,0,4519,
Pavillon Flaubert,2006,HAUTE-NORMANDIE,CANTELEU,0,1045,1045,
Musée Balzac,2004,CENTRE,SACHE,26583,0,26583,
Musée des Beaux-Arts,2004,CENTRE,TOURS,18741,26396,45137,
Muséum d'Histoire Naturelle,2006,HAUTE-NORMANDIE,LE HAVRE,0,19828,19828,
Château Musées de Blois,2004,CENTRE,BLOIS,224132,35134,259266,
Musée des Sapeurs-Pompiers de France,2006,HAUTE-NORMANDIE,MONTVILLE,5156,2117,7273,
Musée de la Céramique,2006,HAUTE-NORMANDIE,ROUEN,5959,6826,12785,
Musée de la Marine de Loire,2004,CENTRE,CHATEAUNEUF-SUR-LOIRE,10201,3581,13782,
Musée Victor Hugo,2006,HAUTE-NORMANDIE,VILLEQUIER,4974,8675,13649,
Musée Girodet,2004,CENTRE,MONTARGIS,1229,1820,3049,
"Musée de la Fève, Crèches et Traditions Populaires",2006,PAYS DE LA LOIRE,BLAIN,508,83,591,
Musée d'Art Moderne,2004,CHAMPAGNE-ARDENNES,TROYES,13004,11736,24740,
Muséum d'Histoire Naturelle de Nantes,2006,PAYS DE LA LOIRE,NANTES,12343,39580,51923,
Musée Municipal,2004,CHAMPAGNE-ARDENNES,BOURBONNE-LES-BAINS,0,426,426,
Musée des Beaux-Arts de Nantes,2006,PAYS DE LA LOIRE,NANTES,32055,62905,94960,
Musée de la Coutellerie,2004,CHAMPAGNE-ARDENNES,NOGENT,4738,1330,6068,
Maison de l'Eclusier /Parc Naturel Régional de Brière,2006,PAYS DE LA LOIRE,SAINT-MALO DE GUERSAC,3779,269,4048,
Ecomusée de la Montagne de Reims,2004,CHAMPAGNE-ARDENNES,POURCY,921,0,921,
Musée des Beaux-Arts,2006,PAYS DE LA LOIRE,ANGERS,23288,50875,74163,
Musée de la Maison Bonaparte,2004,CORSE,AJACCIO,37399,19019,56418,
Château-Musée,2006,PAYS DE LA LOIRE,SAUMUR,30078,0,30078,
Musée Georges Garret,2004,FRANCHE-COMTE,VESOUL,0,5747,5747,
Musée des Beaux-Arts,2004,FRANCHE-COMTE,LONS-LE-SAUNIER,4954,0,4954,
Musée de la Reine Bérengère,2006,PAYS DE LA LOIRE,LE MANS,3581,3090,6671,
Musée Frédéric Japy,2004,FRANCHE-COMTE,BEAUCOURT,3658,0,3658,
Historial de la Vendée,2006,PAYS DE LA LOIRE,LES LUCS-SUR-BOULOGNE,19859,18633,38492,
Donation Maurice Jardot,2004,FRANCHE-COMTE,BELFORT,4596,0,4596,
Musée de la Construction Navale Artisanale,2006,PAYS DE LA LOIRE,NOIRMOUTIER EN L'ILE,6737,912,7649,
Musée du Château,2006,PAYS DE LA LOIRE,NOIRMOUTIER-EN-L'ILE,37126,976,38102,
Musée des Cultures Guyanaises,2004,GUYANE,CAYENNE,0,6276,6276,
Musée Milcendeau Jean-Yole,2006,PAYS DE LA LOIRE,SOULLANS,1295,2066,3361,
Fondation Arp,2004,ILE-DE-FRANCE,CLAMART,1247,925,2172,
Musée d'Art et d'Archéologie,2006,PICARDIE,LAON,1718,4788,6506,
Musée Entomologique,2006,PICARDIE,SAINT-QUENTIN,8472,0,8472,
Galerie d'Anatomie Comparée et de Paléontologie (Muséum d'Histoire Naturelle),2004,ILE-DE-FRANCE,PARIS,164193,40764,204957,
Musée des Beaux-Arts Antoine Lecuyer,2006,PICARDIE,SAINT-QUENTIN,5670,5870,11540,
Musée de Picardie,2006,PICARDIE,AMIENS,45319,11205,56524,
Musée Municipal de Cognac,2006,POITOU-CHARENTES,COGNAC,2093,8568,10661,
Musée Napoléonien et Africain,2006,POITOU-CHARENTES,ILE D'AIX,12145,10946,23091,
Musée de la Musique,2004,ILE-DE-FRANCE,PARIS,107058,23146,130204,
Musée des Beaux-Arts,2006,POITOU-CHARENTES,LA ROCHELLE,7434,0,7434,
Musée des Tumulus de Bougon,2006,POITOU-CHARENTES,BOUGON,17550,6559,24109,
Musée ethnographique et archéologique du Donjon,2006,POITOU-CHARENTES,NIORT,709,1662,2371,
Musée des Arts d'Afrique et d'Océanie - Aquarium,2004,ILE-DE-FRANCE,PARIS,172326,94577,266903,
Musée Municipal de l'Hôtel de Sully,2006,POITOU-CHARENTES,CHATELLERAULT,11,1181,1192,
Musée du Louvre,2004,ILE-DE-FRANCE,PARIS,4561000,2333000,6894000,
Musée Rupert de Chièvres,2006,POITOU-CHARENTES,POITIERS,863,2376,3239,
Musée de la Poste,2004,ILE-DE-FRANCE,PARIS,39662,0,39662,
Musée Sainte-Croix,2006,POITOU-CHARENTES,POITIERS,3775,19195,22970,
Musée de la vallée,2006,PROVENCE-ALPES-CÔTE D'AZUR,BARCELONNETTE,15026,0,15026,
Musée Municipal des Capucins,2004,ILE-DE-FRANCE,COULOMMIERS,1318,1797,3115,
Musée Gassendi,2006,PROVENCE-ALPES-CÔTE D'AZUR,DIGNE-LES-BAINS,9182,0,9182,
Musée Bossuet,2004,ILE-DE-FRANCE,MEAUX,9139,7552,16691,
Musée Jean Cocteau Collection Séverin Wunderman,2006,PROVENCE-ALPES-CÔTE D'AZUR,MENTON,11240,6739,17979,
Musée de Préhistoire Régionale,2006,PROVENCE-ALPES-CÔTE D'AZUR,MENTON,0,8961,8961,
Musée d'Art Naïf Anatole Jakovsky,2006,PROVENCE-ALPES-CÔTE D'AZUR,NICE,4331,16442,20773,
Musée National de Port Royal des Champs,2004,ILE-DE-FRANCE,MAGNY-LES-HAMEAUX,4729,7231,11960,
Musée Matisse,2006,PROVENCE-ALPES-CÔTE D'AZUR,NICE,63682,41863,105545,
Musée de l'Hôtel-Dieu,2004,ILE-DE-FRANCE,MANTES-LA-JOLIE,2857,1809,4666,
Musée Lambinet,2004,ILE-DE-FRANCE,VERSAILLES,14937,4293,19230,
Musée d'Art Moderne et d'Art Contemporain,2006,PROVENCE-ALPES-CÔTE D'AZUR,NICE,47101,78536,125637,
Muséum d'Histoire Naturelle,2004,LA REUNION,SAINT-DENIS DE LA REUNION,5933,30410,36343,
Musée Départemental des Merveilles,2006,PROVENCE-ALPES-CÔTE D'AZUR,TENDE,14192,9202,23394,
Musée Historique de Villèle,2004,LA REUNION,SAINT-GILLES-LES-HAUTS,12304,20849,33153,
Musée Archéologique du Lauragais,2004,LANGUEDOC-ROUSSILLON,CASTELNAUDARY,0,3000,3000,
Musée Paul Arbaud,2006,PROVENCE-ALPES-CÔTE D'AZUR,AIX-EN-PROVENCE,467,1800,2267,
Musée Archéologique,2004,LANGUEDOC-ROUSSILLON,SALLELES D'AUDE,12750,0,12750,
Musée Départemental de l'Arles Antique,2006,PROVENCE-ALPES-CÔTE D'AZUR,ARLES,42527,60806,103333,
Musée-Bibliothèque Pierre-André Benoît,2004,LANGUEDOC-ROUSSILLON,ALES,0,12881,12881,
Musée Municipal Méditerranéen de Cassis A.T.P.,2006,PROVENCE-ALPES-CÔTE D'AZUR,CASSIS,350,5418,5768,
Musée Albert André,2004,LANGUEDOC-ROUSSILLON,BAGNOLS-SUR-CEZE,2274,2410,4684,
Musée Léon Alègre,2004,LANGUEDOC-ROUSSILLON,BAGNOLS-SUR-CEZE,264,504,768,
Musée de la Mode,2006,PROVENCE-ALPES-CÔTE D'AZUR,MARSEILLE,7234,5467,12701,
Musée Cévenol,2004,LANGUEDOC-ROUSSILLON,LE VIGAN,3920,2234,6154,
Musée Cantini,2006,PROVENCE-ALPES-CÔTE D'AZUR,MARSEILLE,30005,30223,60228,
Musée des Cultures Taurines (Annexe Musée du Vieux Nîmes),2004,LANGUEDOC-ROUSSILLON,NIMES,701,8367,9068,
Musée Suffren et du Vieux Saint-Cannat,2006,PROVENCE-ALPES-CÔTE D'AZUR,SAINT-CANNAT,0,5516,5516,
Musée Départemental d'Art Sacré du Gard,2004,LANGUEDOC-ROUSSILLON,PONT-SAINT-ESPRIT,2294,8058,10352,
Musée Municipal Paul Lafran,2006,PROVENCE-ALPES-CÔTE D'AZUR,SAINT-CHAMAS,0,2644,2644,
Musée du Pays Brignolais,2006,PROVENCE-ALPES-CÔTE D'AZUR,BRIGNOLES,2272,4441,6713,
Musée de l'Etang de Thau,2004,LANGUEDOC-ROUSSILLON,BOUZIGUES,18540,0,18540,
Musée de l'Artillerie,2006,PROVENCE-ALPES-CÔTE D'AZUR,DRAGUIGNAN,0,18172,18172,
Musée Archéologique Henri Prades,2004,LANGUEDOC-ROUSSILLON,LATTES,4752,0,4752,
Musée des Troupes de Marine,2006,PROVENCE-ALPES-CÔTE D'AZUR,FREJUS,0,16201,16201,
Musée Fabre,2004,LANGUEDOC-ROUSSILLON,MONTPELLIER,35682,34696,70378,
Musée Calvet (et musée Lapidaire),2006,PROVENCE-ALPES-CÔTE D'AZUR,AVIGNON,21551,16748,38299,
Musée Sobirats,2006,PROVENCE-ALPES-CÔTE D'AZUR,CARPENTRAS,155,333,488,
Musée de Cerdagne,2004,LANGUEDOC-ROUSSILLON,SAINTE-LEOCADIE,3438,0,3438,
Musée Municipal,2006,PROVENCE-ALPES-CÔTE D'AZUR,SAULT,0,1217,1217,
Musée du Cloître de Tulle André Mazeyrie,2004,LIMOUSIN,TULLE,2482,28632,31114,
Musée du Vieux Pérouges,2006,RHONE-ALPES,PEROUGES,19170,2530,21700,
Musée de l'Evêché,2004,LIMOUSIN,LIMOGES,0,53046,53046,
Musée de la Bresse - Domaine des Planons,2006,RHONE-ALPES,SAINT-CYR-SUR-MENTHON,15421,8648,24069,
Musée National Adrien Dubouché,2004,LIMOUSIN,LIMOGES,12491,11298,23789,
Muséum- Aquarium de Nancy,2004,LORRAINE,NANCY,16950,39550,56500,
Cité de Préhistoire,2006,RHONE-ALPES,ORGNAC-L'AVEN,147599,0,147599,
Musée d'Art et d'Histoire de Toul,2004,LORRAINE,TOUL,4223,4456,8679,
Château de Grignan,2006,RHONE-ALPES,GRIGNAN,79663,52876,132539,
Musée de la Céramique et de l'Ivoire,2004,LORRAINE,COMMERCY,1651,684,2335,
Musée d'Art Sacré,2006,RHONE-ALPES,MOURS SAINT-EUSEBE,502,1300,1802,
Musée Jules Bastien-Lepage - Musée de la Fortification,2004,LORRAINE,MONTMEDY,14634,507,15141,
Musée des Beaux-Arts,2006,RHONE-ALPES,VALENCE,6021,4219,10240,
Musée des Mines de fer de Lorraine,2004,LORRAINE,NEUFCHEF,20479,694,21173,
Musée de Bourgoin-Jallieu,2006,RHONE-ALPES,BOURGOIN-JALLIEU,2399,3616,6015,
Musée Militaire et Erckmann-Chatrian,2004,LORRAINE,PHALSBOURG,876,0,876,
Musée Louis Français,2004,LORRAINE,PLOMBIERES-LES-BAINS,424,243,667,
Musée Matheysin,2006,RHONE-ALPES,LA MURE,2308,967,3275,
Musée Départemental d'Archéologie Précolombienne et de Préhistoire de la Martinique,2004,MARTINIQUE,FORT-DE-FRANCE,7239,2899,10138,
Musée Hébert,2006,RHONE-ALPES,LA TRONCHE,0,16450,16450,
Musée d'Archéologie,2004,MIDI-PYRENEES,MONTSEGUR,27607,0,27607,
Musée-Cloître Saint-André-Le-Bas,2006,RHONE-ALPES,VIENNE,3180,4723,7903,
Musée Régional de Géologie Pierre Vetter,2004,MIDI-PYRENEES,DECAZEVILLE,1472,1449,2921,
Musée d'Art et d'Industrie,2006,RHONE-ALPES,SAINT-ETIENNE,21990,23872,45862,
Musée Rural,2006,RHONE-ALPES,USSON-EN-FOREZ,6880,1057,7937,
Muséum d'Histoire Naturelle,2004,MIDI-PYRENEES,BAGNERES-DE-BIGORRE,1385,1013,2398,
Musée Folklorique et Traditions Populaires Marius Audin,2006,RHONE-ALPES,BEAUJEU,2333,513,2846,
Musée Municipal - Musée Trésor,2004,MIDI-PYRENEES,LUZ-SAINT-SAUVEUR,1083,0,1083,
Musée-château Gaston Phébus,2004,MIDI-PYRENEES,MAUVEZIN,29974,0,29974,
Musée d'Art Contemporain de Lyon,2006,RHONE-ALPES,LYON,34934,31536,66470,
Musée de l'Automate,2004,MIDI-PYRENEES,SOUILLAC,25777,4724,30501,
Musée Henri Malartre,2006,RHONE-ALPES,ROCHETAILLEE-SUR-SAONE,39703,0,39703,
Musée Goya,2004,MIDI-PYRENEES,CASTRES,12566,11650,24216,
Musée archéologique et minéralogique Pierre Borrione,2006,RHONE-ALPES,AIME-EN-TARENTAISE Cedex,1155,483,1638,
Muséum d'histoire naturelle Philadelphe Thomas,2004,MIDI-PYRENEES,GAILLAC,659,2734,3393,
Musée de l'Abbaye Saint-Michel,2004,MIDI-PYRENEES,GAILLAC,3902,1164,5066,
Musée de l'Académie de La Val d'Isère,2006,RHONE-ALPES,MOÛTIERS,272,425,697,
Musée Raymond Lafage,2004,MIDI-PYRENEES,LISLE-SUR-TARN,478,1106,1584,
Maison de l'Archéologie des Vosges du Nord,2007,ALSACE,NIEDERBRONN-LES-BAINS,1437,667,2104,
Musée d'Histoire Naturelle Victor Brun,2004,MIDI-PYRENEES,MONTAUBAN,860,5663,6523,
Musée Alsacien,2007,ALSACE,STRASBOURG,177,91134,91311,
Musée Ingres,2004,MIDI-PYRENEES,MONTAUBAN,67810,0,67810,
Musée des Beaux-Arts,2007,ALSACE,STRASBOURG,12106,33186,45292,
Musée Théophile Jouglet,2004,NORD-PAS-DE-CALAIS,ANZIN,0,2815,2815,
Cabinet des Estampes et des Dessins,2007,ALSACE,STRASBOURG,0,2253,2253,
Musée d'Histoire Naturelle et d'Ethnographie de Colmar,2007,ALSACE,COLMAR,7236,5649,12885,
Musée du Mont-de-Piété,2004,NORD-PAS-DE-CALAIS,BERGUES,1445,896,2341,
Château de Bourdeilles,2007,AQUITAINE,BOURDEILLES,24192,0,24192,
Musée Fernand Desmoulin,2007,AQUITAINE,BRANTOME,15822,8813,24635,
Musée d'Art Moderne de Lille Métropole,2004,NORD-PAS-DE-CALAIS,VILLENEUVE-D'ASCQ,145175,35477,180652,
Musée Militaire - Souvenir du Périgord,2007,AQUITAINE,PERIGUEUX,1015,1300,2315,
Musée des Beaux-Arts,2004,NORD-PAS-DE-CALAIS,ARRAS,23010,29457,52467,
Musée d'Art et Traditions Populaires,2007,AQUITAINE,VILLEFRANCHE-DE-LONCHAT,0,627,627,
Château musée,2004,NORD-PAS-DE-CALAIS,BOULOGNE-SUR-MER,63695,54743,118438,
Musée de Borda,2007,AQUITAINE,DAX,3468,5737,9205,
Musée Archéologique,2007,AQUITAINE,HASTINGUES,4288,6198,10486,
Musée Quentovic,2004,NORD-PAS-DE-CALAIS,ETAPLES-SUR-MER,2040,4988,7028,
Musée Municipal du Lac,2007,AQUITAINE,SANGUINET,1174,226,1400,
Musée Jean-Charles Cazin,2004,NORD-PAS-DE-CALAIS,SAMER,0,650,650,
Musée des Beaux-Arts,2007,AQUITAINE,AGEN,8147,9502,17649,
Musée des Beaux-Arts,2004,BASSE-NORMANDIE,CAEN,8016,31328,39344,
Musée des Arts D'Afrique et D'Asie,2007,AUVERGNE,VICHY,3263,1323,4586,
Musée de Normandie,2004,BASSE-NORMANDIE,CAEN,109413,0,109413,
Musée d'Art et d'Archéologie,2007,AUVERGNE,AURILLAC,1331,21337,22668,
Musée d'Initiation à la Nature,2004,BASSE-NORMANDIE,CAEN,610,7125,7735,
Musée Départemental de la Céramique Gallo-Romaine,2007,AUVERGNE,LEZOUX,18182,6087,24269,
Musée Eugène Boudin,2004,BASSE-NORMANDIE,HONFLEUR,30523,3287,33810,
Musée Lapidaire,2007,AUVERGNE,MOZAC,332,390,722,
Musée Paléontologique,2004,BASSE-NORMANDIE,VILLERS-SUR-MER,0,30939,30939,
Musée des Peintres de l'Ecole de Murols,2007,AUVERGNE,MUROL,4814,218,5032,
Musée de la Pomme et de la Poire,2004,BASSE-NORMANDIE,BARENTON,2208,631,2839,
Musée Francisque Mandet,2007,AUVERGNE,RIOM,2852,7850,10702,
Musée du Vieux Château,2004,BASSE-NORMANDIE,BRICQUEBEC-EN-COTENTIN,370,0,370,
Musée de la Mine,2007,BOURGOGNE,LA MACHINE,5700,1746,7446,
Muséum Emmanuel Liais,2004,BASSE-NORMANDIE,CHERBOURG-EN-COTENTIN,0,20418,20418,
Musée Richard Anacréon,2004,BASSE-NORMANDIE,GRANVILLE,7023,4718,11741,
Musée du Vieux Granville,2004,BASSE-NORMANDIE,GRANVILLE,10183,0,10183,
Musée Rolin,2007,BOURGOGNE,AUTUN,15894,7319,23213,
Musée du Granit,2004,BASSE-NORMANDIE,SAINT-MICHEL-DE-MONTJOIE,1268,140,1408,
Museum d'Histoire Naturelle Jacques de La Comble,2007,BOURGOGNE,AUTUN,2157,2018,4175,
Musée Régional du Cidre et du Calvados,2004,BASSE-NORMANDIE,VALOGNES,11254,0,11254,
Musée Nicéphore Niepce,2007,BOURGOGNE,CHALON-SUR-SAONE,5642,12778,18420,
Musée Alfred Canel,2004,HAUTE-NORMANDIE,PONT-AUDEMER,585,1426,2011,
Musée des Ursulines,2007,BOURGOGNE,MACON,2142,12818,14960,
Musée Alphonse-Georges Poulain,2004,HAUTE-NORMANDIE,VERNON,2446,8371,10817,
Musée Lamartine,2007,BOURGOGNE,MACON,844,3443,4287,
Musée de l'Hôtel Dubocage de Bléville,2004,HAUTE-NORMANDIE,LE HAVRE,3053,0,3053,
Musée du Terroir,2007,BOURGOGNE,ROMENAY,206,22,228,
Musée des Sapeurs-Pompiers de France,2004,HAUTE-NORMANDIE,MONTVILLE,6119,3312,9431,
Musée Départemental de Préhistoire de Solutré,2007,BOURGOGNE,SOLUTRE-POUILLY,15080,12777,27857,
Musée Industriel de la Corderie Vallois,2004,HAUTE-NORMANDIE,NOTRE-DAME-DE-BONDEVILLE,3070,7573,10643,
MUNAE - Musée National de l'Education,2004,HAUTE-NORMANDIE,ROUEN,3010,9653,12663,
Musée du Château de Dinan,2007,BRETAGNE,DINAN,15856,7144,23000,
Musée Mathurin Meheut,2007,BRETAGNE,LAMBALLE,5354,810,6164,
Musée Victor Hugo,2004,HAUTE-NORMANDIE,VILLEQUIER,6129,6531,12660,
Musée de la Faucillonnaie,2007,BRETAGNE,MONTREUIL-SOUS-PEROUSE,1137,504,1641,
Musée International du Long-Cours Cap-Hornier,2007,BRETAGNE,SAINT-MALO,6305,2632,8937,
Maison de l'Eclusier /Parc Naturel Régional de Brière,2004,PAYS DE LA LOIRE,SAINT-MALO DE GUERSAC,5270,0,5270,
Musée Saint-Nicolas,2007,BRETAGNE,VITRE,1410,799,2209,
Musée de l'Ardoise,2004,PAYS DE LA LOIRE,TRELAZE,7658,743,8401,
Musée de Préhistoire J. Miln- Z. Le-Rouzic,2007,BRETAGNE,CARNAC,26181,6136,32317,
Musée de Tessé,2004,PAYS DE LA LOIRE,LE MANS,23588,2084,25672,
Ecomusée Industriel des Forges,2007,BRETAGNE,INZINZAC-LOCHRIST,2893,1806,4699,
Musée du Berry,2007,CENTRE,BOURGES,0,12199,12199,
Muséum des Sciences Naturelles et de Préhistoire,2007,CENTRE,CHARTRES,1427,14208,15635,
Musée Gallé-Juillet,2004,PICARDIE,CREIL,1455,2904,4359,
Musée Marcel Proust,2007,CENTRE,ILLIERS-COMBRAY,3970,263,4233,
Atelier - Musée du Papier,2004,POITOU-CHARENTES,ANGOULEME,0,7970,7970,
Musée Balzac,2007,CENTRE,SACHE,15779,4624,20403,
Cité International de la Bande Dessinée et de l'Image - Musée de la Bande Dessinée,2004,POITOU-CHARENTES,ANGOULEME,47542,3451,50993,
Musée de Vendôme,2007,CENTRE,VENDOME,1418,7249,8667,
Musée du Présidial,2004,POITOU-CHARENTES,SAINTES,593,2267,2860,
Musée Municipal de l'Hôtel de Sully,2004,POITOU-CHARENTES,CHATELLERAULT,3028,0,3028,
Musée d'Art et d'Archéologie,2007,CENTRE,CHATILLON-COLIGNY,649,176,825,
Musée Municipal de la Maison-Dieu,2004,POITOU-CHARENTES,MONTMORILLON,1500,0,1500,
Musée des Beaux-Arts,2007,CENTRE,ORLEANS,7331,46185,53516,
Musée Gassendi,2004,PROVENCE-ALPES-CÔTE D'AZUR,DIGNE-LES-BAINS,9209,0,9209,
Musée du Château-Fort,2007,CHAMPAGNE-ARDENNES,SEDAN,69464,0,69464,
Musée de Salagon,2004,PROVENCE-ALPES-CÔTE D'AZUR,MANE,28455,0,28455,
Musée archéologique,2004,PROVENCE-ALPES-CÔTE D'AZUR,VACHERES,1341,0,1341,
Musée d'Histoire et d'Archéologie,2004,PROVENCE-ALPES-CÔTE D'AZUR,ANTIBES,3371,4040,7411,
Musée d'Art Moderne,2007,CHAMPAGNE-ARDENNES,TROYES,27457,0,27457,
Musée-Château de Cagnes,2004,PROVENCE-ALPES-CÔTE D'AZUR,CAGNES-SUR-MER,13233,12842,26075,
Pharmacie Musée de l'Hôtel-Dieu,2007,CHAMPAGNE-ARDENNES,TROYES,3851,0,3851,
Musée de la Castre,2004,PROVENCE-ALPES-CÔTE D'AZUR,CANNES,7316,12391,19707,
Musée des Beaux-Arts et d'Archéologie,2007,CHAMPAGNE-ARDENNES,CHAUMONT,761,3504,4265,
Musée des Beaux-Arts,2004,PROVENCE-ALPES-CÔTE D'AZUR,MENTON,0,12224,12224,
Musée Municipal,2007,CHAMPAGNE-ARDENNES,SAINT-DIZIER,0,6897,6897,
Musée de Préhistoire Régionale,2004,PROVENCE-ALPES-CÔTE D'AZUR,MENTON,0,11888,11888,
Musée d'Art Moderne et d'Art Contemporain,2004,PROVENCE-ALPES-CÔTE D'AZUR,NICE,64318,47428,111746,
Musée de l'Alta Rocca,2007,CORSE,LEVIE,10265,0,10265,
Musée Picasso la guerre et la paix à Vallauris,2004,PROVENCE-ALPES-CÔTE D'AZUR,VALLAURIS,31000,13000,44000,
Musée Camarguais,2004,PROVENCE-ALPES-CÔTE D'AZUR,ARLES,14631,5577,20208,
Musée Ciotaden,2004,PROVENCE-ALPES-CÔTE D'AZUR,LA CIOTAT,3692,4899,8591,
Forge-Musée,2007,FRANCHE-COMTE,ETUEFFONT,1749,240,1989,
Musée de la Faïence,2004,PROVENCE-ALPES-CÔTE D'AZUR,MARSEILLE,19212,0,19212,
Musée Suffren et du Vieux Saint-Cannat,2004,PROVENCE-ALPES-CÔTE D'AZUR,SAINT-CANNAT,0,9115,9115,
Musée Précolombien Edgar Clerc,2007,GUADELOUPE,LE MOULE,0,6983,6983,
Musée des Cultures Guyanaises,2007,GUYANE,CAYENNE,1348,7799,9147,
Musée des A.T.P. de Moyenne Provence,2004,PROVENCE-ALPES-CÔTE D'AZUR,DRAGUIGNAN,9737,4071,13808,
Musée Territorial Alexandre Franconie,2007,GUYANE,CAYENNE,2359,2715,5074,
Musée Dunoyer de Segonzac,2007,ILE-DE-FRANCE,BOUSSY-SAINT-ANTOINE,0,260,260,
Musée Municipal Robert Dubois-Corneau,2007,ILE-DE-FRANCE,BRUNOY,569,3612,4181,
Musée de l'Annonciade,2004,PROVENCE-ALPES-CÔTE D'AZUR,SAINT-TROPEZ,52423,5631,58054,
Musée des Années Trente,2007,ILE-DE-FRANCE,BOULOGNE-BILLANCOURT,28005,0,28005,
Muséum d'Histoire Naturelle Esprit Requien,2004,PROVENCE-ALPES-CÔTE D'AZUR,AVIGNON,0,10908,10908,
Musée Municipal d'Art et d'Histoire,2007,ILE-DE-FRANCE,COLOMBES,0,5407,5407,
Musée Calvet (et musée Lapidaire),2004,PROVENCE-ALPES-CÔTE D'AZUR,AVIGNON,20068,20402,40470,
Musée Roybet Fould,2007,ILE-DE-FRANCE,COURBEVOIE,0,10796,10796,
Synagogue Musée Juif Comtadin,2004,PROVENCE-ALPES-CÔTE D'AZUR,CAVAILLON,5506,0,5506,
Musée de la Résistance et de la Déportation de l'Ain,2004,RHONE-ALPES,NANTUA,6364,1507,7871,
Musée National des Arts et des Traditions Populaires (MuCem),2007,ILE-DE-FRANCE,PARIS,6342,19238,25580,
Cité de Préhistoire,2004,RHONE-ALPES,ORGNAC-L'AVEN,125080,0,125080,
Musée des Arts d'Afrique et d'Océanie - Aquarium,2007,ILE-DE-FRANCE,PARIS,111515,93854,205369,
Musée du Rhône,2004,RHONE-ALPES,TOURNON-SUR-RHÔNE,6621,3293,9914,
Musée National Eugène Delacroix,2007,ILE-DE-FRANCE,PARIS,28509,9916,38425,
Château de Grignan,2004,RHONE-ALPES,GRIGNAN,99680,0,99680,
Musée de l'Orangerie,2007,ILE-DE-FRANCE,PARIS,458033,140729,598762,
Musée International de la Chaussure,2004,RHONE-ALPES,ROMANS,19454,28242,47696,
Musée Bourdelle,2007,ILE-DE-FRANCE,PARIS,17995,31815,49810,
Musée - Parc Archéologique du Lac de Paladru,2004,RHONE-ALPES,CHARAVINES,15871,0,15871,
Musée de Montmartre,2007,ILE-DE-FRANCE,PARIS,28043,2121,30164,
Musée de la Musique,2007,ILE-DE-FRANCE,PARIS,58199,27430,85629,
Musée Lucien Mainssieux,2004,RHONE-ALPES,VOIRON,683,181,864,
Musée National Picasso,2007,ILE-DE-FRANCE,PARIS,318633,151867,470500,
Musée d'Art et d'Industrie,2004,RHONE-ALPES,SAINT-ETIENNE,42746,0,42746,
Etablissement public du musée d'Orsay,2007,ILE-DE-FRANCE,PARIS,1881696,1284813,3166509,
Musée Rural,2004,RHONE-ALPES,USSON-EN-FOREZ,5337,1722,7059,
Musée d'Art Moderne de la ville de Paris,2007,ILE-DE-FRANCE,PARIS,130083,258398,388481,
Musée des Charmettes,2004,RHONE-ALPES,CHAMBERY,3868,8183,12051,
Musée National des Techniques,2007,ILE-DE-FRANCE,PARIS,152817,0,152817,
Musée d'Unterlinden,2005,ALSACE,COLMAR,173681,29813,203494,
Musée Gatien Bonnet,2007,ILE-DE-FRANCE,LAGNY-SUR-MARNE,774,3126,3900,
Musée d'Histoire Naturelle et d'Ethnographie de Colmar,2005,ALSACE,COLMAR,7234,7747,14981,
Musée Départemental de Préhistoire d'Île de France,2007,ILE-DE-FRANCE,NEMOURS,3397,30553,33950,
Musée des Beaux-Arts,2005,ALSACE,MULHOUSE,0,10432,10432,
Cité du Train,2005,ALSACE,MULHOUSE,132607,0,132607,
Musée des Pays de Seine-et-Marne,2007,ILE-DE-FRANCE,SAINT-CYR-SUR-MORIN,1280,5849,7129,
Musée National de l'Automobile - Collection Schlumpf,2005,ALSACE,MULHOUSE,150665,37247,187912,
Musée Municipal,2007,ILE-DE-FRANCE,LIVRY-GARGAN,0,12165,12165,
Ecomusée d'Alsace,2005,ALSACE,UNGERSHEIM,298332,56594,354926,
Musée d'Art et d'Histoire,2007,ILE-DE-FRANCE,SAINT-DENIS,3729,28626,32355,
Château de Bourdeilles,2005,AQUITAINE,BOURDEILLES,25291,0,25291,
Musée Fernand Desmoulin,2005,AQUITAINE,BRANTOME,13780,1486,15266,
Musée Archéologique du Val d'Oise,2007,ILE-DE-FRANCE,GUIRY-EN-VEXIN,9154,1799,10953,
Musée d'Art et d'Archéologie du Périgord (MAAP),2005,AQUITAINE,PERIGUEUX,20999,0,20999,
Musée d'Art et d'Histoire Louis Senlecq,2007,ILE-DE-FRANCE,L'ISLE-ADAM,1537,8485,10022,
Musée National de Port Royal des Champs,2007,ILE-DE-FRANCE,MAGNY-LES-HAMEAUX,7006,13274,20280,
Musée de l'Hôtel-Dieu,2007,ILE-DE-FRANCE,MANTES-LA-JOLIE,3994,0,3994,
Musée des Beaux-Arts et d'Archéologie,2005,AQUITAINE,LIBOURNE,0,4847,4847,
Musée Rambolitrain,2007,ILE-DE-FRANCE,RAMBOUILLET,14542,1453,15995,
Musée Archéologique,2005,AQUITAINE,HASTINGUES,4942,13228,18170,
Muséum Agricole et Industriel Stella Matutina,2007,LA REUNION,PITON-SAINT-LEU,31674,4482,36156,
Atelier-Musée  (Ecomusée de la Grande Landes),2005,AQUITAINE,LUXEY,4710,0,4710,
Musée Historique de Villèle,2007,LA REUNION,SAINT-GILLES-LES-HAUTS,11394,13504,24898,
Ecomusée de la Grande Lande,2005,AQUITAINE,SABRES,67001,7445,74446,
Musée des Beaux-Arts,2007,LANGUEDOC-ROUSSILLON,CARCASSONNE,0,47758,47758,
Musée Municipal du Lac,2005,AQUITAINE,SANGUINET,1639,217,1856,
Musée du Vieux Nîmes,2007,LANGUEDOC-ROUSSILLON,NIMES,0,17437,17437,
Musée des Beaux-Arts,2005,AQUITAINE,AGEN,11723,9275,20998,
Musée Départemental d'Art Sacré du Gard,2007,LANGUEDOC-ROUSSILLON,PONT-SAINT-ESPRIT,205,10798,11003,
Muséum d'Histoire Naturelle,2005,AQUITAINE,BAYONNE,4702,0,4702,
Musée de l'Etang de Thau,2007,LANGUEDOC-ROUSSILLON,BOUZIGUES,17375,0,17375,
Musée Rural de la Sologne Bourbonnaise,2005,AUVERGNE,BEAULON,235,70,305,
Musée de la Préhistoire des Matelles,2007,LANGUEDOC-ROUSSILLON,LES MATELLES,502,1125,1627,
Ecomusée de Margeride-Haute-Auvergne,2005,AUVERGNE,RUYNES-EN-MARGERIDE,15291,350,15641,
Musée du Vieux Montpellier,2007,LANGUEDOC-ROUSSILLON,MONTPELLIER,0,7500,7500,
Musée de la Dentelle,2005,AUVERGNE,ARLANC,1440,171,1611,
Musée Languedocien,2007,LANGUEDOC-ROUSSILLON,MONTPELLIER,5580,4566,10146,
Musée d'Art Roger-Quillot,2005,AUVERGNE,CLERMONT-FERRAND,3671,19559,23230,
Agropolis-Muséum,2007,LANGUEDOC-ROUSSILLON,MONTPELLIER,3610,8445,12055,
Musée Hyacinthe Rigaud,2007,LANGUEDOC-ROUSSILLON,PERPIGNAN,3333,4152,7485,
Musée des Pénitents Blancs,2005,AUVERGNE,MARSAC-EN-LIVRADOIS,225,0,225,
Musée des Monnaies et Médailles Joseph Puig,2007,LANGUEDOC-ROUSSILLON,PERPIGNAN,99,926,1025,
Musée Magnin,2005,BOURGOGNE,DIJON,6327,4714,11041,
Musée du Castillet Casa Pairal,2007,LANGUEDOC-ROUSSILLON,PERPIGNAN,6606,13157,19763,
Musée Archéologique,2005,BOURGOGNE,DIJON,0,22873,22873,
Les Sources d'Hercule,2007,LORRAINE,DENEUVRE,3403,697,4100,
Musée des Beaux-Arts,2005,BOURGOGNE,DIJON,4030,146503,150533,
Musée d'Art et d'Histoire de Toul,2007,LORRAINE,TOUL,2143,2390,4533,
Musée des Arts et Traditions des Hautes-Côtes,2005,BOURGOGNE,GEVREY-CHAMBERTIN - Reulle Vergy,4700,0,4700,
Musée d'Art Sacré de la Meuse,2007,LORRAINE,SAINT-MIHIEL,969,484,1453,
Musée Jeanne d'Arc,2007,LORRAINE,VAUCOULEURS,798,756,1554,
Musée Auguste Grasset,2005,BOURGOGNE,VARZY,1153,1988,3141,
Musée de la Princerie,2007,LORRAINE,VERDUN,2430,1561,3991,
Museum d'Histoire Naturelle Jacques de La Comble,2005,BOURGOGNE,AUTUN,800,4171,4971,
Musées de la Cour d'Or,2007,LORRAINE,METZ,9762,19704,29466,
Musée d'Art et d'Archéologie,2005,BOURGOGNE,CLUNY,81532,21338,102870,
Musée Départemental Georges de la Tour,2007,LORRAINE,VIC-SUR-SEILLE,5229,6156,11385,
Muséum - Maison de l'Eau,2005,BOURGOGNE,AUXERRE,0,16446,16446,
Musée de la Forge,2007,MIDI-PYRENEES,MONTGAILHARD,28504,3336,31840,
Musée Villeneuvien,2005,BOURGOGNE,VILLENEUVE-SUR-YONNE,0,3283,3283,
Musée des Beaux-Arts de Brest,2005,BRETAGNE,BREST,2270,14904,17174,
"Musée des Mœurs et Coutumes, Musée du Rouergue",2007,MIDI-PYRENEES,ESPALION,532,65,597,
Ecomusée d'Ouessant - Vivre sur une Ile,2005,BRETAGNE,OUESSANT,12095,0,12095,
Musée des Phares et Balises,2005,BRETAGNE,OUESSANT,20738,0,20738,
Musée Municipal de Millau,2007,MIDI-PYRENEES,MILLAU,8972,11804,20776,
Musée des Rochers-Sévigné,2005,BRETAGNE,VITRE,7680,1910,9590,
Musée Georges Labit,2007,MIDI-PYRENEES,TOULOUSE,6647,17403,24050,
Musée du Château de Vitré,2005,BRETAGNE,VITRE,23551,5565,29116,
"Musée Archéologique ""Armand-Viré""",2007,MIDI-PYRENEES,LUZECH,1485,0,1485,
Musée de Préhistoire J. Miln- Z. Le-Rouzic,2005,BRETAGNE,CARNAC,33136,0,33136,
Musée Jean Jaurès,2007,MIDI-PYRENEES,CASTRES,1646,7811,9457,
Ecomusée Industriel des Forges,2005,BRETAGNE,INZINZAC-LOCHRIST,5689,919,6608,
Muséum d'histoire naturelle Philadelphe Thomas,2007,MIDI-PYRENEES,GAILLAC,607,3350,3957,
Musée de la Compagnie des Indes,2005,BRETAGNE,PORT-LOUIS,36536,16489,53025,
Musée du Pays Rabastinois,2007,MIDI-PYRENEES,RABASTENS,952,2591,3543,
Musée du Château de Suscinio,2005,BRETAGNE,SARZEAU,101986,0,101986,
Musée Municipal de Cambrai,2007,NORD-PAS-DE-CALAIS,CAMBRAI,13312,0,13312,
Musée Estève,2005,CENTRE,BOURGES,0,18902,18902,
Musée des Beaux-Arts,2007,NORD-PAS-DE-CALAIS,DUNKERQUE,13910,0,13910,
Musée des Meilleurs Ouvriers de France,2005,CENTRE,BOURGES,0,20757,20757,
Ecomusée de la Région,2007,NORD-PAS-DE-CALAIS,FOURMIES,41492,0,41492,
Musée Municipal,2005,CENTRE,VIERZON,0,2095,2095,
Musée Départemental Matisse,2007,NORD-PAS-DE-CALAIS,LE CATEAU-CAMBRESIS,19419,50592,70011,
Musée des Beaux-Arts,2005,CENTRE,CHARTRES,7133,9669,16802,
Musée de l'Hospice Comtesse,2007,NORD-PAS-DE-CALAIS,LILLE,46450,77950,124400,
Musée des Beaux-Arts et d'Histoire Naturelle,2005,CENTRE,CHATEAUDUN,6820,0,6820,
Musée de l'Histoire du Perche,2005,CENTRE,NOGENT-LE-ROTROU,13207,7031,20238,
Musée d'Art Moderne de Lille Métropole,2007,NORD-PAS-DE-CALAIS,VILLENEUVE-D'ASCQ,10160,38186,48346,
Musée Municipal,2007,NORD-PAS-DE-CALAIS,BERCK-SUR-MER,5454,8625,14079,
Musée de l'Hospice Saint-Roch,2005,CENTRE,ISSOUDUN,0,11877,11877,
Musée Jean-Charles Cazin,2007,NORD-PAS-DE-CALAIS,SAMER,0,578,578,
Musée Ornithologique (Ecomusée de la Brenne),2005,CENTRE,LE BLANC,3334,2126,5460,
Musée Eugène Boudin,2007,BASSE-NORMANDIE,HONFLEUR,30643,1469,32112,
Musée de l'Hôtel des Communes,2005,CENTRE,AMBOISE,0,4785,4785,
Musée de la Meunerie - Moulin de Marcy,2007,BASSE-NORMANDIE,LE MOLAY-LITTRY,4416,2233,6649,
Musée du Vieux Chinon,2005,CENTRE,CHINON,2521,879,3400,
Musée et Sites archéologiques de Vieux-la-Romaine,2007,BASSE-NORMANDIE,VIEUX,5233,14037,19270,
Musée du Savignéen,2005,CENTRE,SAVIGNE-SUR-LATHAN,1593,329,1922,
Musée Paléontologique,2007,BASSE-NORMANDIE,VILLERS-SUR-MER,0,33249,33249,
Ecomusée du Véron,2005,CENTRE,SAVIGNY-EN-VERON,5684,0,5684,
Musée Municipal,2007,BASSE-NORMANDIE,VIRE NORMANDIE,1183,4377,5560,
Muséum d'Histoire Naturelle,2005,CENTRE,TOURS,5350,12182,17532,
Musée de la Pomme et de la Poire,2007,BASSE-NORMANDIE,BARENTON,866,3464,4330,
Château Musées de Blois,2005,CENTRE,BLOIS,224463,29297,253760,
Musée de la Guerre et de la Libération,2007,BASSE-NORMANDIE,CHERBOURG-EN-COTENTIN,8501,3781,12282,
Musée Archéologique,2005,CENTRE,THESEE,1364,718,2082,
Musée Richard Anacréon,2007,BASSE-NORMANDIE,GRANVILLE,7178,5938,13116,
Musée de Vendôme,2005,CENTRE,VENDOME,2216,7208,9424,
Musée Christian Dior,2007,BASSE-NORMANDIE,GRANVILLE,26304,4631,30935,
Musée Municipal Théâtre Forain et Archéologique,2005,CENTRE,ARTENAY,5289,423,5712,
Musée du Château,2007,BASSE-NORMANDIE,TORIGNI-SUR-VIRE,800,1200,2000,
Musée de la Marine de Loire,2005,CENTRE,CHATEAUNEUF-SUR-LOIRE,9423,5652,15075,
Musée du Château de Flers,2007,BASSE-NORMANDIE,FLERS,3627,2426,6053,
Musée d'Art et d'Archéologie,2005,CENTRE,CHATILLON-COLIGNY,486,301,787,
Musée Municipal d'Archéologie,2007,BASSE-NORMANDIE,L'AIGLE,771,275,1046,
Musée Gaston Couté,2005,CENTRE,MEUNG-SUR-LOIRE,0,275,275,
Musée Départemental d'Art Sacré,2007,BASSE-NORMANDIE,SEES,1213,267,1480,
Musée du Gatinais,2005,CENTRE,MONTARGIS,449,0,449,
Musée du Verre et de la Pierre,2007,HAUTE-NORMANDIE,CONCHES-EN-OUCHE,1745,1505,3250,
Musée des Beaux-Arts,2005,CENTRE,ORLEANS,6567,40619,47186,
Musée Alfred Canel,2007,HAUTE-NORMANDIE,PONT-AUDEMER,1492,2244,3736,
Château-Musée de Dieppe,2007,HAUTE-NORMANDIE,DIEPPE,31522,13058,44580,
Musée de l'Ardenne,2005,CHAMPAGNE-ARDENNES,CHARLEVILLE-MEZIERES,41633,0,41633,
Musée Louis-Philippe du Château d'Eu,2007,HAUTE-NORMANDIE,EU,9433,3258,12691,
Musée Napoléon Ier,2005,CHAMPAGNE-ARDENNES,BRIENNE-LE-CHATEAU,3527,886,4413,
Musée Paul Dubois-Alfred Boucher,2005,CHAMPAGNE-ARDENNES,NOGENT-SUR-SEINE,805,818,1623,
Musée Mathon-Durand,2007,HAUTE-NORMANDIE,NEUFCHATEL-EN-BRAY,463,1664,2127,
Ecomusée de la Basse-Seine,2007,HAUTE-NORMANDIE,NOTRE-DAME-DE-BLIQUETUIT,22795,6520,29315,
Musée Municipal,2005,CHAMPAGNE-ARDENNES,SAINT-DIZIER,0,4449,4449,
Musée-Maison Natale Pierre Corneille,2007,HAUTE-NORMANDIE,ROUEN,0,2959,2959,
Musée Le Secq des Tournelles,2007,HAUTE-NORMANDIE,ROUEN,6826,8223,15049,
Musée des Beaux-Arts de Saint-Denis,2005,CHAMPAGNE-ARDENNES,REIMS,10232,25598,35830,
MUNAE - Musée National de l'Education,2007,HAUTE-NORMANDIE,ROUEN,5901,6783,12684,
Musée Palais Fesch,2005,CORSE,AJACCIO,28251,9973,38224,
Musée Flaubert et d'Histoire de la Médecine,2007,HAUTE-NORMANDIE,ROUEN,2513,3496,6009,
Musée de la Maison Bonaparte,2005,CORSE,AJACCIO,40016,19814,59830,
Association de l'Horlogerie Aliermontaise,2007,HAUTE-NORMANDIE,SAINT-NICOLAS-D'ALIERMONT,3982,1152,5134,
"Musée de la Fève, Crèches et Traditions Populaires",2007,PAYS DE LA LOIRE,BLAIN,1614,417,2031,
Musée des Beaux-Arts et d'Archéologie,2005,FRANCHE-COMTE,BESANCON,49480,0,49480,
Musée  Départemental Dobrée,2007,PAYS DE LA LOIRE,NANTES,4821,26655,31476,
Musée du Château des Ducs de Wurtemberg,2005,FRANCHE-COMTE,MONTBELIARD,3780,5003,8783,
Musée de l'Ardoise,2007,PAYS DE LA LOIRE,TRELAZE,9500,900,10400,
Musée de Pontarlier,2005,FRANCHE-COMTE,PONTARLIER,3573,4524,8097,
Ecomusée du Pays de la Cerise,2005,FRANCHE-COMTE,FOUGEROLLES,6133,54,6187,
Musée Départemental de la Montagne Albert Demard,2005,FRANCHE-COMTE,LE HAUT-DU-THEM,5295,3110,8405,
Musée Sarret de Grozon,2005,FRANCHE-COMTE,ARBOIS,0,311,311,
Musée d'Art et d'Archéologie,2007,PICARDIE,LAON,1339,4796,6135,
Musée de la Vigne et du Vin,2005,FRANCHE-COMTE,ARBOIS,4427,1485,5912,
Musée des Beaux-Arts Antoine Lecuyer,2007,PICARDIE,SAINT-QUENTIN,5097,5156,10253,
Musée du Jouet,2005,FRANCHE-COMTE,MOIRANS-EN-MONTAGNE,32954,3774,36728,
Musée Antoine Vivenel,2007,PICARDIE,COMPIEGNE,744,14895,15639,
Musée du Noyonnais,2007,PICARDIE,NOYON,830,3081,3911,
Donation Maurice Jardot,2005,FRANCHE-COMTE,BELFORT,3970,0,3970,
Musée Archéologique de la région de Breteuil,2007,PICARDIE,VENDEUIL-CAPLY,1473,2332,3805,
Musée Départemental de l'Abbaye de Saint-Riquier,2007,PICARDIE,ABBEVILLE,0,24957,24957,
Musée Municipal Robert Dubois-Corneau,2005,ILE-DE-FRANCE,BRUNOY,420,2784,3204,
Musée du Château,2005,ILE-DE-FRANCE,DOURDAN,9050,6426,15476,
Musée Départemental Albert-Kahn,2005,ILE-DE-FRANCE,BOULOGNE-BILLANCOURT,46102,25693,71795,
Musée des Arts du Cognac (Annexe musée municipal),2007,POITOU-CHARENTES,COGNAC,7439,4886,12325,
Musée de la Maison de Pierre Loti,2007,POITOU-CHARENTES,ROCHEFORT,26920,3510,30430,
Musée d'Art et d'Histoire,2005,ILE-DE-FRANCE,MEUDON,594,8136,8730,
Musée des Tumulus de Bougon,2007,POITOU-CHARENTES,BOUGON,19442,7333,26775,
Musée - Atelier Rodin (Annexe du musée de Paris),2005,ILE-DE-FRANCE,MEUDON,4787,3269,8056,
Musée d'Art et d'Histoire Georges Turpin,2007,POITOU-CHARENTES,PARTHENAY,757,5865,6622,
Musée Henri Barré,2007,POITOU-CHARENTES,THOUARS,230,1416,1646,
Musée National des Arts et des Traditions Populaires (MuCem),2005,ILE-DE-FRANCE,PARIS,1809,44000,45809,
Musée de la Vie Romantique,2005,ILE-DE-FRANCE,PARIS,37989,23566,61555,
Musée de la Franc-Maçonnerie,2005,ILE-DE-FRANCE,PARIS,5000,0,5000,
Musée Zadkine,2005,ILE-DE-FRANCE,PARIS,5157,8121,13278,
Musée de la Castre,2007,PROVENCE-ALPES-CÔTE D'AZUR,CANNES,13317,14023,27340,
Etablissement Public du Musée des Arts Asiatiques Guimet,2005,ILE-DE-FRANCE,PARIS,189080,124369,313449,
Musée d'Art et d'Histoire de Provence,2007,PROVENCE-ALPES-CÔTE D'AZUR,GRASSE,3671,13839,17510,
Musée Galliera - Musée de la Mode de la ville de Paris,2005,ILE-DE-FRANCE,PARIS,31869,15299,47168,
Musée Jean Cocteau Collection Séverin Wunderman,2007,PROVENCE-ALPES-CÔTE D'AZUR,MENTON,11115,6470,17585,
Etablissement public du musée d'Orsay,2005,ILE-DE-FRANCE,PARIS,1832306,1096976,2929282,
Musée Départemental des Arts Asiatiques,2007,PROVENCE-ALPES-CÔTE D'AZUR,NICE,13005,23915,36920,
"Musée Cognacq-Jay, Musée du XVIIIe siècle de la ville de Paris",2005,ILE-DE-FRANCE,PARIS,0,38922,38922,
Musée d'Art Moderne et d'Art Contemporain,2007,PROVENCE-ALPES-CÔTE D'AZUR,NICE,48170,106922,155092,
"Musée Cernuschi, Musée des Arts de l'Asie de la ville de Paris",2005,ILE-DE-FRANCE,PARIS,31655,56801,88456,
Musée des Arts Décoratifs (Union Centrale des Arts Décoratifs),2005,ILE-DE-FRANCE,PARIS,131950,34682,166632,
Musée Paul Arbaud,2007,PROVENCE-ALPES-CÔTE D'AZUR,AIX-EN-PROVENCE,529,1550,2079,
Musée d'Art et d'Histoire du Judaïsme,2005,ILE-DE-FRANCE,PARIS,55413,30394,85807,
Muséon Arlaten,2007,PROVENCE-ALPES-CÔTE D'AZUR,ARLES,17066,36005,53071,
Musée National des Techniques,2005,ILE-DE-FRANCE,PARIS,203124,0,203124,
Fondation Louis Jou,2007,PROVENCE-ALPES-CÔTE D'AZUR,LES-BAUX-DE-PROVENCE,119,304,423,
Musée Gatien Bonnet,2005,ILE-DE-FRANCE,LAGNY-SUR-MARNE,0,2100,2100,
Cabinet des Monnaies et Médailles de Marseille,2007,PROVENCE-ALPES-CÔTE D'AZUR,MARSEILLE,0,14,14,
Musée de Provins et du Provinois,2005,ILE-DE-FRANCE,PROVINS,13526,2372,15898,
Musée de la Mode,2007,PROVENCE-ALPES-CÔTE D'AZUR,MARSEILLE,5017,5882,10899,
Musée de l'Air et de l'Espace,2005,ILE-DE-FRANCE,LE BOURGET,187330,47960,235290,
Musée d'Archéologie Méditerranéenne,2007,PROVENCE-ALPES-CÔTE D'AZUR,MARSEILLE,8701,10272,18973,
Musée Municipal,2005,ILE-DE-FRANCE,LIVRY-GARGAN,0,11255,11255,
Musée Suffren et du Vieux Saint-Cannat,2007,PROVENCE-ALPES-CÔTE D'AZUR,SAINT-CANNAT,0,3888,3888,
Musée des Alpilles,2007,PROVENCE-ALPES-CÔTE D'AZUR,SAINT-REMY-DE-PROVENCE,2404,5486,7890,
Musée de Nogent-Sur-Marne,2005,ILE-DE-FRANCE,NOGENT-SUR-MARNE,0,6376,6376,
Musée Estrine - Présence Van Gogh,2007,PROVENCE-ALPES-CÔTE D'AZUR,SAINT-REMY-DE-PROVENCE,7763,6047,13810,
Musée jean-Jacques Rousseau,2005,ILE-DE-FRANCE,MONTMORENCY,1297,1482,2779,
Musée de l'Empéri de Salon et de la Crau,2007,PROVENCE-ALPES-CÔTE D'AZUR,SALON-DE-PROVENCE,7750,20644,28394,
Musée de la Batellerie et des Voies Navigables,2005,ILE-DE-FRANCE,CONFLANS-SAINTE-HONORINE,11841,2413,14254,
Musée Rambolitrain,2005,ILE-DE-FRANCE,RAMBOUILLET,15017,1387,16404,
Musée Archéologique Municipal,2007,PROVENCE-ALPES-CÔTE D'AZUR,FREJUS,9162,1509,10671,
Musée des Beaux-Arts,2005,LANGUEDOC-ROUSSILLON,CARCASSONNE,0,36340,36340,
Musée Petiet,2005,LANGUEDOC-ROUSSILLON,LIMOUX,930,2378,3308,
Musée National de la Marine de Toulon,2007,PROVENCE-ALPES-CÔTE D'AZUR,TOULON,17461,21256,38717,
Musée d'Art et d'Histoire - Ensemble monumental de Narbonne,2005,LANGUEDOC-ROUSSILLON,NARBONNE,305493,0,305493,
Musée Archéologique Théo Desplans,2007,PROVENCE-ALPES-CÔTE D'AZUR,VAISON-LA-ROMAINE,58823,1808,60631,
Musée Municipal de la Vignasse,2005,LANGUEDOC-ROUSSILLON,BEAUCAIRE,626,2947,3573,
Musée Départemental du Revermont,2007,RHONE-ALPES,VAL-REVERMONT,7688,11747,19435,
Musée du Vieux Nîmes,2005,LANGUEDOC-ROUSSILLON,NIMES,0,13179,13179,
Musée Paul Raymond,2005,LANGUEDOC-ROUSSILLON,PONT-SAINT-ESPRIT,425,511,936,
Musée de la Batellerie du Rhône,2007,RHONE-ALPES,SERRIERES,928,813,1741,
Musée Départemental d'Art Sacré du Gard,2005,LANGUEDOC-ROUSSILLON,PONT-SAINT-ESPRIT,1749,5626,7375,
Musée du Château des Adhémars,2007,RHONE-ALPES,MONTELIMAR,12444,0,12444,
Musée de la Maison Romane,2005,LANGUEDOC-ROUSSILLON,SAINT-GILLES-DU-GARD,0,6605,6605,
Musée Alpin,2007,RHONE-ALPES,CHAMONIX,15246,8403,23649,
Musée Languedocien,2005,LANGUEDOC-ROUSSILLON,MONTPELLIER,4573,1775,6348,
Musée de Grenoble,2007,RHONE-ALPES,GRENOBLE,79724,112910,192634,
Musée de Vulliod Saint-Germain,2005,LANGUEDOC-ROUSSILLON,PEZENAS,1799,1943,3742,
Musée Matheysin,2007,RHONE-ALPES,LA MURE,1672,2254,3926,
Musée de la Grande Chartreuse,2007,RHONE-ALPES,SAINT-PIERRE-DE-CHARTREUSE,56694,3849,60543,
Musée du Cloître de Tulle André Mazeyrie,2005,LIMOUSIN,TULLE,2941,38933,41874,
Musée-Cloître Saint-André-Le-Bas,2007,RHONE-ALPES,VIENNE,3674,5283,8957,
Musée Départemental de la Tapisserie,2005,LIMOUSIN,AUBUSSON,14643,2619,17262,
Musée Départemental de la Révolution Française,2007,RHONE-ALPES,VIZILLE,0,49473,49473,
Les Sources d'Hercule,2005,LORRAINE,DENEUVRE,4652,0,4652,
Musée d'Archéologie,2007,RHONE-ALPES,FEURS,864,4163,5027,
Musée d'Allard,2007,RHONE-ALPES,MONTBRISON,2318,4579,6897,
Musée Municipal des Emaux et Faïences,2005,LORRAINE,LONGWY,3933,1592,5525,
Musée Folklorique du Vieux Saint-Etienne,2007,RHONE-ALPES,SAINT-ETIENNE,531,812,1343,
Palais des ducs de Lorraine - Musée Historique Lorrain,2005,LORRAINE,NANCY,37906,48639,86545,
Musée des Civilisations : Daniel Pouget,2007,RHONE-ALPES,SAINT-JUST-SAINT-RAMBERT,4280,4026,8306,
"Musée ""au Fil du Papier""",2005,LORRAINE,PONT-A-MOUSSON,3084,2161,5245,
Musée Folklorique et Traditions Populaires Marius Audin,2007,RHONE-ALPES,BEAUJEU,2568,746,3314,
Musée d'Art et d'Histoire de Toul,2005,LORRAINE,TOUL,4735,0,4735,
Musée des Beaux-Arts,2007,RHONE-ALPES,LYON,89632,152284,241916,
Musée Jules Bastien-Lepage - Musée de la Fortification,2005,LORRAINE,MONTMEDY,13318,350,13668,
Musée d'Art Contemporain de Lyon,2007,RHONE-ALPES,LYON,42741,0,42741,
Musée Départemental d'Art Ancien et Contemporain,2005,LORRAINE,EPINAL,8722,18651,27373,
Musée Paul Dini,2007,RHONE-ALPES,VILLEFRANCHE-SUR-SAONE,15507,8111,23618,
Musée Louis Français,2005,LORRAINE,PLOMBIERES-LES-BAINS,207,247,454,
Musée Charles Friry,2005,LORRAINE,REMIREMONT,356,2262,2618,
Musée de l'Académie de La Val d'Isère,2007,RHONE-ALPES,MOÛTIERS,318,416,734,
Musée Pierre Noël - Musée de la Vie dans les Hautes-Vosges,2005,LORRAINE,SAINT-DIE-DES-VOSGES,4863,12168,17031,
Musée de l'Image Populaire de Pfaffenhoffen,2008,ALSACE,PFAFFENHOFFEN,1864,987,2851,
Musée Départemental d'Archéologie Précolombienne et de Préhistoire de la Martinique,2005,MARTINIQUE,FORT-DE-FRANCE,5996,1682,7678,
Musée Historique,2008,ALSACE,STRASBOURG,21582,33492,55074,
Musée Régional d'Histoire et d'Ethnologie,2005,MARTINIQUE,FORT-DE-FRANCE,2757,1199,3956,
Musée d'Unterlinden,2008,ALSACE,COLMAR,210623,39377,250000,
Musée Historique et Militaire de Huningue,2008,ALSACE,HUNINGE,375,493,868,
Musée d'Archéologie,2005,MIDI-PYRENEES,MONTSEGUR,24346,0,24346,
Musée d'Histoire Local,2008,ALSACE,KAYSERSBERG,379,95,474,
Musée du Palais des Evêques,2005,MIDI-PYRENEES,SAINT-LIZIER,6032,1036,7068,
Musée EDF Electropolis,2008,ALSACE,MULHOUSE,30357,7650,38007,
"Musée des Mœurs et Coutumes, Musée du Rouergue",2005,MIDI-PYRENEES,ESPALION,377,49,426,
Musée National de l'Automobile - Collection Schlumpf,2008,ALSACE,MULHOUSE,142277,31912,174189,
Musée des Arts et Métiers Traditionnels,2005,MIDI-PYRENEES,SALLES-LA-SOURCE,9151,1282,10433,
Musée de l'Impression sur Etoffes,2008,ALSACE,MULHOUSE,9713,20195,29908,
Musée Archéologique,2005,MIDI-PYRENEES,EAUZE,4609,2172,6781,
Maison du Sundgau - Musée Paysan,2008,ALSACE,OLTINGUE,1286,622,1908,
Musée des Beaux-Arts et des Arts Décoratifs,2005,MIDI-PYRENEES,MIRANDE,663,613,1276,
Musée du Dolder,2008,ALSACE,RIQUEWIHR,2351,410,2761,
Château de Bourdeilles,2008,AQUITAINE,BOURDEILLES,22500,0,22500,
Musée-château Gaston Phébus,2005,MIDI-PYRENEES,MAUVEZIN,29663,0,29663,
Musée National de la Préhistoire,2008,AQUITAINE,LES EYZIES-DE-TAYAC,48024,33929,81953,
"Musée Archéologique ""Armand-Viré""",2005,MIDI-PYRENEES,LUZECH,576,172,748,
Musée Gallo-Romain d'Uxellodunum,2005,MIDI-PYRENEES,MARTEL,170,380,550,
Musée Municipal,2005,MIDI-PYRENEES,VAYRAC,223,53,276,
Musée de la Chalosse,2008,AQUITAINE,MONTFORT-EN-CHALOSSE,8921,2903,11824,
Musée Toulouse Lautrec,2005,MIDI-PYRENEES,ALBI,108389,23482,131871,
Ecomusée de la Grande Lande,2008,AQUITAINE,SABRES,80660,13304,93964,
Musée des Beaux-Arts,2005,MIDI-PYRENEES,GAILLAC,2745,3869,6614,
Musée des Beaux-Arts,2008,AQUITAINE,AGEN,7236,11538,18774,
Musée de l'Abbaye Saint-Michel,2005,MIDI-PYRENEES,GAILLAC,3440,932,4372,
Musée de Préhistoire Mésolithique Laurent Coulonges,2008,AQUITAINE,SAUVETERRE-LA-LEMANCE,1571,406,1977,
Musée d'Histoire Naturelle Victor Brun,2005,MIDI-PYRENEES,MONTAUBAN,1017,4810,5827,
Muséum d'Histoire Naturelle,2008,AQUITAINE,BAYONNE,2074,0,2074,
Musée Benoît de Puydt,2005,NORD-PAS-DE-CALAIS,BAILLEUL,4364,0,4364,
"Forum Antique de Bavay, Musée Archéologique du Département du Nord",2005,NORD-PAS-DE-CALAIS,BAVAY,9004,6318,15322,
Musée Municipal de Gannat,2008,AUVERGNE,GANNAT,553,631,1184,
Musée de l'Ostrevant,2005,NORD-PAS-DE-CALAIS,BOUCHAIN,102,721,823,
Musée Rieckotter,2008,AUVERGNE,NERIS-LES-BAINS,546,730,1276,
Musée Portuaire,2005,NORD-PAS-DE-CALAIS,DUNKERQUE,27478,20554,48032,
Musée des Arts D'Afrique et D'Asie,2008,AUVERGNE,VICHY,3161,1973,5134,
Musée d'Histoire Naturelle et de Géologie,2005,NORD-PAS-DE-CALAIS,LILLE,15384,46235,61619,
Musée des Sciences,2008,AUVERGNE,AURILLAC,4569,9004,13573,
Ecomusée de Margeride-Haute-Auvergne,2008,AUVERGNE,RUYNES-EN-MARGERIDE,8062,1988,10050,
Musée Municipal,2005,NORD-PAS-DE-CALAIS,SAINT-AMAND-LES-EAUX,6005,0,6005,
Musée de la Haute Auvergne,2008,AUVERGNE,SAINT-FLOUR,2586,2200,4786,
Musée du Verre,2005,NORD-PAS-DE-CALAIS,SARS-POTERIES,4346,4178,8524,
Musée d'art et d'histoire Alfred Douët,2008,AUVERGNE,SAINT-FLOUR,1453,2157,3610,
Musée d'Art Roger-Quillot,2008,AUVERGNE,CLERMONT-FERRAND,8909,37219,46128,
Musée du Débarquement,2005,BASSE-NORMANDIE,ARROMANCHES,317183,10793,327976,
Musée Municipal de la Coutellerie,2008,AUVERGNE,THIERS,22200,6361,28561,
Musée de la Bataille de Tilly-Sur-Seulles 1944,2005,BASSE-NORMANDIE,TILLY-SUR-SEULLES,407,0,407,
Musée d'Art et d'Histoire Romain Rolland,2008,BOURGOGNE,CLAMECY,2174,4246,6420,
Musée de Trouville - Villa Montebello,2005,BASSE-NORMANDIE,TROUVILLE-SUR-MER,9383,0,9383,
Musée du Vieux Château,2005,BASSE-NORMANDIE,BRICQUEBEC-EN-COTENTIN,531,0,531,
Musée Archéologique du Nivernais (Porte du Croux),2008,BOURGOGNE,NEVERS,0,400,400,
Musée du Vieux Granville,2005,BASSE-NORMANDIE,GRANVILLE,7802,4779,12581,
Musée du Grès de Puisaye,2008,BOURGOGNE,SAINT-AMAND-EN-PUISAYE,2244,0,2244,
Musée Christian Dior,2005,BASSE-NORMANDIE,GRANVILLE,54301,0,54301,
Musée Auguste Grasset,2008,BOURGOGNE,VARZY,1461,668,2129,
Musée de la Poeslerie,2005,BASSE-NORMANDIE,VILLEDIEU-LES-POELES-ROUFFIGNY,6440,262,6702,
Musée Rolin,2008,BOURGOGNE,AUTUN,12612,8731,21343,
Musée de l'Ancien Evêché,2005,HAUTE-NORMANDIE,EVREUX,2790,7928,10718,
Museum d'Histoire Naturelle Jacques de La Comble,2008,BOURGOGNE,AUTUN,1972,3159,5131,
Museoseine,2005,HAUTE-NORMANDIE,CAUDEBEC-EN-CAUX,4783,1887,6670,
Musée du Terroir,2008,BOURGOGNE,ROMENAY,0,803,803,
Abbaye de Graville - Musée du Prieuré de Graville,2005,HAUTE-NORMANDIE,LE HAVRE,3741,1190,4931,
Musée Muncipal,2008,BOURGOGNE,SENS,5528,33771,39299,
"Juliobona, Musée Gallo-Romain de Lillebonne",2005,HAUTE-NORMANDIE,LILLEBONNE,768,1165,1933,
Musée des Phares et Balises,2008,BRETAGNE,OUESSANT,12904,3358,16262,
Musée des Antiquités de la Seine-Maritime,2005,HAUTE-NORMANDIE,ROUEN,2101,20260,22361,
Musée de l'Ecole Rurale en Bretagne,2008,BRETAGNE,TREGARVAN,8055,1242,9297,
Musée de la Céramique,2005,HAUTE-NORMANDIE,ROUEN,4582,5871,10453,
Musée Emile Chénon,2008,CENTRE,CHATEAUMEILLANT,535,1372,1907,
Musée des Beaux-Arts,2005,HAUTE-NORMANDIE,ROUEN,36236,50931,87167,
Musée des Beaux-Arts,2008,CENTRE,CHARTRES,4842,7938,12780,
Musée du Pays de Retz,2005,PAYS DE LA LOIRE,BOURGNEUF-EN-RETZ,4215,1195,5410,
Musées de Châteauroux - Hôtel Bertrand,2008,CENTRE,CHATEAUROUX,0,20442,20442,
Musée du Pays de Guérande et de la Porte Saint Michel,2005,PAYS DE LA LOIRE,GUERANDE,17095,5151,22246,
Musée Ornithologique (Ecomusée de la Brenne),2008,CENTRE,LE BLANC,2791,1829,4620,
Musée du Chaume/Kerhinet - Pard Naturel Régional de Brière,2005,PAYS DE LA LOIRE,SAINT-LYPHARD,2844,61,2905,
Musée du Vieux Chinon,2008,CENTRE,CHINON,970,574,1544,
Musée Pincé,2005,PAYS DE LA LOIRE,ANGERS,1093,1748,2841,
Musée Lansyer,2008,CENTRE,LOCHES,1914,1924,3838,
Musée de la Vigne et du Vin d'Anjou,2005,PAYS DE LA LOIRE,SAINT LAMBERT-DU-LATTAY - VAL-DU-LAYON,4259,2077,6336,
Musée de l'Hôtel de Ville,2008,CENTRE,RICHELIEU,885,146,1031,
Musée des Tisserands Mayennais,2005,PAYS DE LA LOIRE,AMBRIERES-LES-VALLEES,657,63,720,
Ecomusée du Véron,2008,CENTRE,SAVIGNY-EN-VERON,9210,0,9210,
Musée Communal Robert Tatin,2005,PAYS DE LA LOIRE,COSSE-LE-VIVIEN,14161,2544,16705,
Maison de la Magie,2008,CENTRE,BLOIS,56362,13057,69419,
Musée de la Corbillière,2008,CENTRE,MER,0,754,754,
Ecomusée du Marais Breton Vendéen,2005,PAYS DE LA LOIRE,LA BARRE-DE-MONTS,20533,9277,29810,
Musée ornithologique Charles-Payraudeau,2005,PAYS DE LA LOIRE,LA-CHAIZE-LE-VICOMTE,0,558,558,
Musée de la Marine de Loire,2008,CENTRE,CHATEAUNEUF-SUR-LOIRE,9600,4057,13657,
Musée du Château,2005,PAYS DE LA LOIRE,NOIRMOUTIER-EN-L'ILE,41497,2923,44420,
Musée Historique et Archéologique,2008,CENTRE,ORLEANS,626,3001,3627,
Musée La Bourrine du Bois-Juquaud,2005,PAYS DE LA LOIRE,SAINT-HILAIRE-DE-RIEZ,9774,11501,21275,
Musée - Centre de Documentation Alfred Desmasures,2005,PICARDIE,HIRSON,0,1285,1285,
Musée Napoléon Ier,2008,CHAMPAGNE-ARDENNES,BRIENNE-LE-CHATEAU,3423,1317,4740,
Musée de la Figurine Historique,2005,PICARDIE,COMPIEGNE,4267,4912,9179,
Maison de l'Outil  et de la Pensée Ouvrière,2008,CHAMPAGNE-ARDENNES,TROYES,12049,2811,14860,
Musée du Noyonnais,2005,PICARDIE,NOYON,2864,0,2864,
Musée des Beaux-Arts (Musée Pic Saint-Loup),2008,CHAMPAGNE-ARDENNES,TROYES,5052,14298,19350,
Musée Municipal,2008,CHAMPAGNE-ARDENNES,SAINT-DIZIER,0,5255,5255,
Cité International de la Bande Dessinée et de l'Image - Musée de la Bande Dessinée,2005,POITOU-CHARENTES,ANGOULEME,49735,2518,52253,
Musée Municipal,2008,CHAMPAGNE-ARDENNES,CHALONS-EN-CHAMPAGNE,1693,8979,10672,
Musée des Arts du Cognac (Annexe musée municipal),2005,POITOU-CHARENTES,COGNAC,5375,5830,11205,
Musée de la Mytiliculture,2005,POITOU-CHARENTES,ESNANDES,3990,114,4104,
Musée Saint-Rémi,2008,CHAMPAGNE-ARDENNES,REIMS,5551,46112,51663,
Musée Protestant,2005,POITOU-CHARENTES,LA ROCHELLE,1500,573,2073,
Musée Palais Fesch,2008,CORSE,AJACCIO,402,1044,1446,
Musée d'Orbigny-Bernon,2005,POITOU-CHARENTES,LA ROCHELLE,5580,6561,12141,
Musée Cappon,2005,POITOU-CHARENTES,MARANS,495,23,518,
Musée de la résistance et de la Déportation,2008,FRANCHE-COMTE,BESANCON,58115,0,58115,
Musée de la Maison de Pierre Loti,2005,POITOU-CHARENTES,ROCHEFORT,31376,2296,33672,
Musée du Château des Ducs de Wurtemberg,2008,FRANCHE-COMTE,MONTBELIARD,7930,15718,23648,
Musée de Pontarlier,2008,FRANCHE-COMTE,PONTARLIER,3283,8145,11428,
Ecomusée du Pays de la Cerise,2008,FRANCHE-COMTE,FOUGEROLLES,3404,2548,5952,
Musée Georges Garret,2008,FRANCHE-COMTE,VESOUL,0,4689,4689,
Musée Charbonneau-Lassay,2005,POITOU-CHARENTES,LOUDUN,232,203,435,
Musée de la Vigne et du Vin,2008,FRANCHE-COMTE,ARBOIS,3849,641,4490,
Musée Municipal d'Archéologie,2008,FRANCHE-COMTE,CHAMPAGNOLE,221,122,343,
Musée Rupert de Chièvres,2005,POITOU-CHARENTES,POITIERS,623,2142,2765,
Musée de l'Artisanat Jurassien,2008,FRANCHE-COMTE,VOITEUR,0,7440,7440,
Donation Maurice Jardot,2008,FRANCHE-COMTE,BELFORT,1134,2378,3512,
Musée du Vieux Sisteron,2005,PROVENCE-ALPES-CÔTE D'AZUR,SISTERON,0,530,530,
Musée d'Histoire et d'Archéologie,2005,PROVENCE-ALPES-CÔTE D'AZUR,ANTIBES,2042,2970,5012,
Musée de la Castre,2005,PROVENCE-ALPES-CÔTE D'AZUR,CANNES,11629,10321,21950,
Musée Départemental des Arts Asiatiques,2005,PROVENCE-ALPES-CÔTE D'AZUR,NICE,12394,17148,29542,
Musée du Palais Lascaris,2005,PROVENCE-ALPES-CÔTE D'AZUR,NICE,0,58953,58953,
Musée d'Histoire Locale - Mémoire de la Ville (& Musée Franco Suisse),2008,ILE-DE-FRANCE,RUEIL-MALMAISON,166,3103,3269,
Musée National Eugène Delacroix,2008,ILE-DE-FRANCE,PARIS,18022,20744,38766,
Musée- Atelier de Paul Cézanne,2005,PROVENCE-ALPES-CÔTE D'AZUR,AIX-EN-PROVENCE,57144,11206,68350,
Musée National Gustave Moreau,2008,ILE-DE-FRANCE,PARIS,19344,13302,32646,
Musée Départemental de l'Arles Antique,2005,PROVENCE-ALPES-CÔTE D'AZUR,ARLES,18147,52973,71120,
Musée Carnavalet-Histoire de Paris (+ Crypte et Catacombes),2008,ILE-DE-FRANCE,PARIS,342557,765522,1108079,
Musée des Docks Romains,2005,PROVENCE-ALPES-CÔTE D'AZUR,MARSEILLE,2397,7103,9500,
Musée Zadkine,2008,ILE-DE-FRANCE,PARIS,1833,19537,21370,
Musée de la Musique,2008,ILE-DE-FRANCE,PARIS,87263,37419,124682,
Musée d'Histoire de Marseille,2005,PROVENCE-ALPES-CÔTE D'AZUR,MARSEILLE,10981,24578,35559,
Musée Galliera - Musée de la Mode de la ville de Paris,2008,ILE-DE-FRANCE,PARIS,62939,17176,80115,
Musée de la Mode,2005,PROVENCE-ALPES-CÔTE D'AZUR,MARSEILLE,4552,5045,9597,
Musée des Arts d'Afrique et d'Océanie - Aquarium,2008,ILE-DE-FRANCE,PARIS,116426,73954,190380,
Musée Cantini,2005,PROVENCE-ALPES-CÔTE D'AZUR,MARSEILLE,10952,16889,27841,
Musée du Service de Santé des Armées du Val-de-Grâce,2008,ILE-DE-FRANCE,PARIS,6320,5389,11709,
Musée de la Société d’Etudes Scientifiques et Achéologiques,2005,PROVENCE-ALPES-CÔTE D'AZUR,DRAGUIGNAN,0,2470,2470,
Maison Natale de Louis Braille,2008,ILE-DE-FRANCE,COUPVRAY,2691,762,3453,
Musée d'Art et d'Histoire Militaire,2008,ILE-DE-FRANCE,FONTAINEBLEAU,1201,1927,3128,
Musée de l'Annonciade,2005,PROVENCE-ALPES-CÔTE D'AZUR,SAINT-TROPEZ,47984,5908,53892,
Musée du Château de Fontainebleau,2008,ILE-DE-FRANCE,FONTAINEBLEAU,241641,142398,384039,
Musée National de la Marine de Toulon,2005,PROVENCE-ALPES-CÔTE D'AZUR,TOULON,15333,12768,28101,
Musée de Provins et du Provinois,2008,ILE-DE-FRANCE,PROVINS,17497,4694,22191,
Musée des Pays de Seine-et-Marne,2008,ILE-DE-FRANCE,SAINT-CYR-SUR-MORIN,2696,6428,9124,
Musée de l'Air et de l'Espace,2008,ILE-DE-FRANCE,LE BOURGET,0,274678,274678,
Musée Municipal,2005,PROVENCE-ALPES-CÔTE D'AZUR,ORANGE,51755,0,51755,
Musée Municipal,2008,ILE-DE-FRANCE,LIVRY-GARGAN,0,11000,11000,
Musée du Brou,2005,RHONE-ALPES,BOURG-EN-BRESSE,56189,12771,68960,
Musée de Nogent-Sur-Marne,2008,ILE-DE-FRANCE,NOGENT-SUR-MARNE,297,6936,7233,
Musée du Vieux Pérouges,2005,RHONE-ALPES,PEROUGES,12560,1255,13815,
Musée du Vieil Argenteuil,2008,ILE-DE-FRANCE,ARGENTEUIL,666,490,1156,
Musée National de Port Royal des Champs,2008,ILE-DE-FRANCE,MAGNY-LES-HAMEAUX,10142,12500,22642,
Musée du Rhône,2005,RHONE-ALPES,TOURNON-SUR-RHÔNE,5635,3436,9071,
Musée Victor Aubert,2008,ILE-DE-FRANCE,MAULE,0,1532,1532,
Musée du Chablais,2005,RHONE-ALPES,THONON-LES-BAINS,1757,2387,4144,
Musée Lambinet,2008,ILE-DE-FRANCE,VERSAILLES,8509,3219,11728,
Musée Gallo-Romain,2005,RHONE-ALPES,AOSTE,2964,2444,5408,
Muséum d'Histoire Naturelle,2008,LA REUNION,SAINT-DENIS DE LA REUNION,2339,20676,23015,
Musée de Bourgoin-Jallieu,2005,RHONE-ALPES,BOURGOIN-JALLIEU,5130,5634,10764,
Musée Albert André,2008,LANGUEDOC-ROUSSILLON,BAGNOLS-SUR-CEZE,416,3464,3880,
Carré d'Art Musée d'Art Contemporain de Nîmes,2008,LANGUEDOC-ROUSSILLON,NIMES,12620,25738,38358,
Musée d'Histoire Naturelle et de Préhistoire,2008,LANGUEDOC-ROUSSILLON,NIMES,0,50329,50329,
Muséum d'Histoire Naturelle de Grenoble,2005,RHONE-ALPES,GRENOBLE,13165,66511,79676,
Musée Municipal Georges Borias,2008,LANGUEDOC-ROUSSILLON,UZES,1244,1140,2384,
Conservatoire - Musée des Industries Hydroélectriques,2005,RHONE-ALPES,VAUJANY,0,12297,12297,
Musée du Biterrois,2008,LANGUEDOC-ROUSSILLON,BEZIERS,8238,11778,20016,
Musée-Cloître Saint-André-Le-Bas,2005,RHONE-ALPES,VIENNE,3181,3995,7176,
Musée Municipal,2008,LANGUEDOC-ROUSSILLON,FRONTIGNAN-LA-PEYRADE,0,6726,6726,
Musée Hospitalier,2005,RHONE-ALPES,CHARLIEU,3286,675,3961,
Musée de la Préhistoire des Matelles,2008,LANGUEDOC-ROUSSILLON,LES MATELLES,1042,2470,3512,
Musée d'Histoire du  20ème Siècle - Résistance et Déportation,2005,RHONE-ALPES,ESTIVAREILLES,2489,868,3357,
Musée Paul Valéry,2008,LANGUEDOC-ROUSSILLON,SETE,5716,9833,15549,
Musée de la Mine / Site Couriot,2005,RHONE-ALPES,SAINT-ETIENNE,29132,21867,50999,
Ecomusée du Mont Lozère,2008,LANGUEDOC-ROUSSILLON,LE PONT DE MONTVERT,2813,1782,4595,
Musée Barthélemy-Thimonnier,2005,RHONE-ALPES,AMPLEPUIS,3541,278,3819,
Musée départemental d'Art Moderne,2008,LANGUEDOC-ROUSSILLON,CERET,78710,21615,100325,
Musée des Sapeurs-Pompiers de Lyon,2005,RHONE-ALPES,LYON,0,6238,6238,
Ecomusée du Haut Beaujolais,2005,RHONE-ALPES,THIZY-LES-BOURGS,3534,279,3813,
Musée du Pays d'Ussel,2008,LIMOUSIN,USSEL,0,2912,2912,
Musée Municipal d'Albertville-Conflans,2005,RHONE-ALPES,ALBERTVILLE,2146,2439,4585,
Musée Départemental de la Tapisserie,2008,LIMOUSIN,AUBUSSON,15445,3035,18480,
Musée Municipal,2005,ST PIERRE ET MIQUELON,SAINT-PIERRE ET MIQUELON,1571,133,1704,
Musée Municipal des Emaux et Faïences,2008,LORRAINE,LONGWY,4207,2586,6793,
Musée d'Art Moderne et Contemporain de Strasbourg,2006,ALSACE,STRASBOURG,63413,71892,135305,
Musée de l'Ecole de Nancy,2008,LORRAINE,NANCY,25329,24775,50104,
Musée des Beaux-Arts,2006,ALSACE,STRASBOURG,19560,41724,61284,
Musée d'Art Sacré de la Meuse,2008,LORRAINE,SAINT-MIHIEL,1451,823,2274,
Musée d'Unterlinden,2006,ALSACE,COLMAR,167365,25725,193090,
Musée Jeanne d'Arc,2008,LORRAINE,VAUCOULEURS,1167,550,1717,
Musée d'Histoire Naturelle et d'Ethnographie de Colmar,2006,ALSACE,COLMAR,3828,5016,8844,
Musée Historique et Militaire de Huningue,2006,ALSACE,HUNINGE,163,1753,1916,
Musée Régional d'Histoire et d'Ethnologie,2008,MARTINIQUE,FORT-DE-FRANCE,1435,2183,3618,
Musée des Beaux-Arts,2006,ALSACE,MULHOUSE,0,13085,13085,
Musée Volcanologique Franck Arnold Perret,2008,MARTINIQUE,SAINT-PIERRE,24686,94,24780,
Musée de l'Impression sur Etoffes,2006,ALSACE,MULHOUSE,10585,20852,31437,
Musée de la Préhistoire,2008,MIDI-PYRENEES,LE MAS D'AZIL,10193,128,10321,
Musée du Papier Peint,2006,ALSACE,RIXHEIM,6818,2417,9235,
Musée de la Forge,2008,MIDI-PYRENEES,MONTGAILHARD,26692,2948,29640,
Musée des Amis de Thann,2006,ALSACE,THANN,701,7224,7925,
Musée Fernand Desmoulin,2006,AQUITAINE,BRANTOME,13717,4276,17993,
Musée des Arts et Métiers Traditionnels,2008,MIDI-PYRENEES,SALLES-LA-SOURCE,8538,1188,9726,
Musée Paul Reclus,2006,AQUITAINE,DOMME,0,14300,14300,
Musée d'Archéologie,2008,MIDI-PYRENEES,LECTOURE,1553,620,2173,
Musée Campanaire,2008,MIDI-PYRENEES,L'ISLE JOURDAIN,6807,5237,12044,
Musée des Augustins,2008,MIDI-PYRENEES,TOULOUSE,47043,57100,104143,
Musée Départemental de Cuzals,2008,MIDI-PYRENEES,SAULIAC-SUR-CELE,7203,3011,10214,
Musée Despiau-Wlérick,2006,AQUITAINE,MONT-DE-MARSAN,1542,6219,7761,
Musée de l'Automate,2008,MIDI-PYRENEES,SOUILLAC,21908,3880,25788,
Ecomusée de la Grande Lande,2006,AQUITAINE,SABRES,74649,7000,81649,
Musée Goya,2008,MIDI-PYRENEES,CASTRES,13229,12042,25271,
Musée National du Château,2006,AQUITAINE,PAU,62148,43823,105971,
Musée des Beaux-Arts,2008,MIDI-PYRENEES,GAILLAC,2712,3104,5816,
Musée Charles-Louis Philippe,2006,AUVERGNE,CERILLY,270,0,270,
Muséum d'histoire naturelle Philadelphe Thomas,2008,MIDI-PYRENEES,GAILLAC,868,4152,5020,
Musée Rieckotter,2006,AUVERGNE,NERIS-LES-BAINS,433,170,603,
Musée du Vieil Auvillar,2008,MIDI-PYRENEES,AUVILLAR,2516,454,2970,
Ecomusée de Margeride-Haute-Auvergne,2006,AUVERGNE,RUYNES-EN-MARGERIDE,17512,0,17512,
Musée Ingres,2008,MIDI-PYRENEES,MONTAUBAN,16896,22754,39650,
Muséum d'Histoire Naturelle Henri-Lecoq,2006,AUVERGNE,CLERMONT-FERRAND,16551,12178,28729,
Musée Benoît de Puydt,2008,NORD-PAS-DE-CALAIS,BAILLEUL,1986,4682,6668,
Musée des Pénitents Blancs,2006,AUVERGNE,MARSAC-EN-LIVRADOIS,168,0,168,
Musée du Mont-de-Piété,2008,NORD-PAS-DE-CALAIS,BERGUES,1422,951,2373,
Musée des Peintres de l'Ecole de Murols,2006,AUVERGNE,MUROL,3633,101,3734,
Musée Municipal de Cambrai,2008,NORD-PAS-DE-CALAIS,CAMBRAI,5274,8875,14149,
Musée Municipal de la Coutellerie,2006,AUVERGNE,THIERS,25003,5157,30160,
Musée des Beaux-Arts,2008,NORD-PAS-DE-CALAIS,DUNKERQUE,10378,0,10378,
Musée des Beaux-Arts,2006,BOURGOGNE,BEAUNE,4755,1247,6002,
Musée d'Histoire Naturelle et de Géologie,2008,NORD-PAS-DE-CALAIS,LILLE,45484,7707,53191,
Musée Magnin,2006,BOURGOGNE,DIJON,6031,7990,14021,
Musée d'Art et d'Industrie,2008,NORD-PAS-DE-CALAIS,TOURCOING,0,18356,18356,
Musée des Beaux-Arts,2006,BOURGOGNE,DIJON,8699,130721,139420,
Château musée,2008,NORD-PAS-DE-CALAIS,BOULOGNE-SUR-MER,34520,0,34520,
Musée Noisot,2006,BOURGOGNE,FIXIN,319,455,774,
Musée Municipal,2006,BOURGOGNE,LA CHARITE-SUR-LOIRE,439,253,692,
Musée des Beaux-Arts et de la Dentelle,2008,NORD-PAS-DE-CALAIS,CALAIS,1010,15007,16017,
Musée du Prieuré de Charolles,2006,BOURGOGNE,CHAROLLES,2228,100,2328,
Musée Quentovic,2008,NORD-PAS-DE-CALAIS,ETAPLES-SUR-MER,3552,1072,4624,
Musée d'Art et d'Archéologie,2006,BOURGOGNE,CLUNY,85115,21918,107033,
Musée d'Art et d'Histoire Roger Rodière,2008,NORD-PAS-DE-CALAIS,MONTREUIL-SUR-MER,64,7787,7851,
Musée Départemental de Préhistoire de Solutré,2006,BOURGOGNE,SOLUTRE-POUILLY,14306,9273,23579,
Musée Municipal Bruno Danvin,2008,NORD-PAS-DE-CALAIS,SAINT-POL-SUR-TERNOISE,0,2943,2943,
Maison du Blé et du Pain,2006,BOURGOGNE,VERDUN-SUR-LE-DOUBS,3996,642,4638,
Musée Jean-Charles Cazin,2008,NORD-PAS-DE-CALAIS,SAMER,0,672,672,
Musée des Arts Naïfs et Populaires de Noyers sur Serein,2006,BOURGOGNE,NOYERS-SUR-SEREIN,1788,1060,2848,
Musée du Débarquement,2008,BASSE-NORMANDIE,ARROMANCHES,295081,14542,309623,
Musée Colette,2006,BOURGOGNE,SAINT-SAUVEUR-EN-PUISAYE,9480,0,9480,
Musée de Normandie,2008,BASSE-NORMANDIE,CAEN,10190,108900,119090,
Ecomusée des Monts d'Arrée - Moulins de Kerouat & Maison Cornec de Rivoal,2006,BRETAGNE,COMMANA,17632,5887,23519,
Musée de la Meunerie - Moulin de Marcy,2008,BASSE-NORMANDIE,LE MOLAY-LITTRY,3905,2496,6401,
Ecomusée d'Ouessant - Vivre sur une Ile,2006,BRETAGNE,OUESSANT,13318,0,13318,
Musée de la Bataille de Tilly-Sur-Seulles 1944,2008,BASSE-NORMANDIE,TILLY-SUR-SEULLES,1239,0,1239,
Musée Départemental Breton,2006,BRETAGNE,QUIMPER,22976,18177,41153,
Musée de la Pomme et de la Poire,2008,BASSE-NORMANDIE,BARENTON,738,3658,4396,
Musée des Rochers-Sévigné,2006,BRETAGNE,VITRE,5921,3075,8996,
Musée du Vieux Granville,2008,BASSE-NORMANDIE,GRANVILLE,5082,7222,12304,
Ecomusée de Saint-Dégan,2006,BRETAGNE,BREC'H,11923,1046,12969,
Musée Christian Dior,2008,BASSE-NORMANDIE,GRANVILLE,22417,3318,25735,
Musée de Préhistoire J. Miln- Z. Le-Rouzic,2006,BRETAGNE,CARNAC,26945,5328,32273,
Musée des Beaux-Arts,2008,BASSE-NORMANDIE,SAINT-LO,874,5327,6201,
Ecomusée Industriel des Forges,2006,BRETAGNE,INZINZAC-LOCHRIST,4144,1328,5472,
Musée Régional du Cidre et du Calvados,2008,BASSE-NORMANDIE,VALOGNES,3137,858,3995,
Musée National de la Marine,2006,BRETAGNE,PORT-LOUIS,37746,22970,60716,
Musée Départemental des Arts et Traditions Populaires du Perche,2008,BASSE-NORMANDIE,SAINT-CYR LA ROSIERE,13621,11223,24844,
Conservatoire du Machinisme et des Pratiques Agricoles,2006,CENTRE,CHARTRES-MAINVILLIERS,13822,34178,48000,
Musée du Verre et de la Pierre,2008,HAUTE-NORMANDIE,CONCHES-EN-OUCHE,1625,3459,5084,
Musée Marcel Proust,2006,CENTRE,ILLIERS-COMBRAY,3579,528,4107,
Château-Musée de Dieppe,2008,HAUTE-NORMANDIE,DIEPPE,26355,9778,36133,
Musée de la Chemiserie et de l'Elégance Masculine,2006,CENTRE,ARGENTON-SUR-CREUSE,4091,4628,8719,
Musée d'Elbeuf,2008,HAUTE-NORMANDIE,ELBEUF,0,4071,4071,
Musée de l'Hôtel des Communes,2006,CENTRE,AMBOISE,0,4070,4070,
La Maison de l'Armateur,2008,HAUTE-NORMANDIE,LE HAVRE,6533,8339,14872,
Musée Départemental Pierre Corneille,2008,HAUTE-NORMANDIE,LE PETIT-COURONNE,645,2804,3449,
Musée Lansyer,2006,CENTRE,LOCHES,1759,1673,3432,
Musée des Sapeurs-Pompiers de France,2008,HAUTE-NORMANDIE,MONTVILLE,5011,2248,7259,
Musée François Rabelais,2006,CENTRE,SEUILLY,13155,0,13155,
Musée Industriel de la Corderie Vallois,2008,HAUTE-NORMANDIE,NOTRE-DAME-DE-BONDEVILLE,2505,6167,8672,
Musée des Vins de Touraine,2006,CENTRE,TOURS,1737,1215,2952,
Musée des Antiquités de la Seine-Maritime,2008,HAUTE-NORMANDIE,ROUEN,2839,21330,24169,
Musée des Beaux-Arts,2006,CENTRE,TOURS,18700,28243,46943,
Musée Flaubert et d'Histoire de la Médecine,2008,HAUTE-NORMANDIE,ROUEN,4689,7048,11737,
Château Musées de Blois,2006,CENTRE,BLOIS,215809,25252,241061,
Musée des Beaux-Arts,2008,HAUTE-NORMANDIE,ROUEN,37104,58687,95791,
Musée Victor Hugo,2008,HAUTE-NORMANDIE,VILLEQUIER,4643,9130,13773,
Musée du Château des Ducs de Bretagne,2008,PAYS DE LA LOIRE,NANTES,87059,85987,173046,
Musées du Parc Naturel Régional de Brière,2008,PAYS DE LA LOIRE,SAINT-JOACHIM,3512,175,3687,
Musée d'Art et d'Archéologie,2006,CENTRE,CHATILLON-COLIGNY,603,574,1177,
Musée de la Vigne et du Vin d'Anjou,2008,PAYS DE LA LOIRE,SAINT LAMBERT-DU-LATTAY - VAL-DU-LAYON,4706,1918,6624,
Musée Gaston Couté,2006,CENTRE,MEUNG-SUR-LOIRE,0,2950,2950,
Musée de l'Ardoise,2008,PAYS DE LA LOIRE,TRELAZE,9050,4500,13550,
Musée Municipal,2008,PAYS DE LA LOIRE,ERNEE,0,995,995,
Musée Napoléon Ier,2006,CHAMPAGNE-ARDENNES,BRIENNE-LE-CHATEAU,3411,1133,4544,
Musée du Vieux Château,2008,PAYS DE LA LOIRE,LAVAL,10871,19446,30317,
Musée Vert Véron-de-Forbonnais,2008,PAYS DE LA LOIRE,LE MANS,7240,9308,16548,
Musée Vauluisant - Musée de la Bonneterie,2006,CHAMPAGNE-ARDENNES,TROYES,3594,3261,6855,
Musée Clemenceau et de Lattre-de-Tassigny,2008,PAYS DE LA LOIRE,MOUILLERON-EN-PAREDS,1714,4011,5725,
Musée Municipal,2006,CHAMPAGNE-ARDENNES,BOURBONNE-LES-BAINS,0,1419,1419,
Musée Milcendeau Jean-Yole,2008,PAYS DE LA LOIRE,SOULLANS,1458,1782,3240,
Musée de la Coutellerie,2006,CHAMPAGNE-ARDENNES,NOGENT,4041,1197,5238,
Musée Monseigneur Pigneau de Behaine,2008,PICARDIE,ORIGNY-EN-THIERACHE,0,240,240,
Planétarium/Musée de l'Ancien Collège des Jésuites,2006,CHAMPAGNE-ARDENNES,REIMS,2235,25139,27374,
Musée de la Résistance et de la Déportation,2008,PICARDIE,TERGNIER,5071,8849,13920,
Musée Palais Fesch,2006,CORSE,AJACCIO,24956,9068,34024,
Musée de la Maison Bonaparte,2006,CORSE,AJACCIO,40113,21344,61457,
Musée Départemental de l'Oise,2008,PICARDIE,BEAUVAIS,0,22224,22224,
Musée Pillon,2008,PICARDIE,CHAUMONT-EN-VEXIN,0,132,132,
Musée-Maison Natale Gustave Courbet,2006,FRANCHE-COMTE,ORNANS,15899,1982,17881,
Musée de Pontarlier,2006,FRANCHE-COMTE,PONTARLIER,4160,5990,10150,
Musée de la Figurine Historique,2008,PICARDIE,COMPIEGNE,3528,5842,9370,
Musée Baron Martin,2006,FRANCHE-COMTE,GRAY,2214,2641,4855,
Musée Archéologique de la région de Breteuil,2008,PICARDIE,VENDEUIL-CAPLY,3089,0,3089,
Musée Boucher-de-Perthes,2008,PICARDIE,ABBEVILLE,11742,0,11742,
Musée Lombart,2008,PICARDIE,DOULLENS,205,6554,6759,
Musée Dunoyer de Segonzac,2006,ILE-DE-FRANCE,BOUSSY-SAINT-ANTOINE,0,208,208,
Musée-Historial de la Grande Guerre,2008,PICARDIE,PERONNE,80641,0,80641,
Musée Départemental Albert-Kahn,2006,ILE-DE-FRANCE,BOULOGNE-BILLANCOURT,43268,26879,70147,
Musée des Arts du Cognac (Annexe musée municipal),2008,POITOU-CHARENTES,COGNAC,7725,5330,13055,
Musée des Années Trente,2006,ILE-DE-FRANCE,BOULOGNE-BILLANCOURT,56012,0,56012,
Musée Régional de Fouras,2008,POITOU-CHARENTES,FOURAS,5834,745,6579,
Musée Roybet Fould,2006,ILE-DE-FRANCE,COURBEVOIE,0,8996,8996,
Musée Protestant,2008,POITOU-CHARENTES,LA ROCHELLE,1367,447,1814,
Musée d'Orbigny-Bernon,2008,POITOU-CHARENTES,LA ROCHELLE,1673,5207,6880,
Musée d'Histoire Locale - Mémoire de la Ville,2006,ILE-DE-FRANCE,RUEIL-MALMAISON,0,3769,3769,
Musée Archéologique,2008,POITOU-CHARENTES,SAINTES,1647,35018,36665,
Galerie de Minéralogie et de Géologie (Muséum d'Histoire Naturelle),2006,ILE-DE-FRANCE,PARIS,17495,5712,23207,
Musée ethnographique et archéologique du Donjon,2008,POITOU-CHARENTES,NIORT,2922,3204,6126,
Musée Sainte-Croix,2008,POITOU-CHARENTES,POITIERS,3639,17390,21029,
Musée du Moyen Age-Thermes et Hôtel de Cluny,2006,ILE-DE-FRANCE,PARIS,165910,124048,289958,
Musée de l'Assistance Publique - Hôpitaux de Paris,2006,ILE-DE-FRANCE,PARIS,9426,6492,15918,
Musée Renoir,2008,PROVENCE-ALPES-CÔTE D'AZUR,CAGNES-SUR-MER,30621,9109,39730,
Etablissement public du musée d'Orsay et de l'Orangerie - Musée de l'Orangerie,2006,ILE-DE-FRANCE,PARIS,293676,153417,447093,
Musée de la Castre,2008,PROVENCE-ALPES-CÔTE D'AZUR,CANNES,14272,17878,32150,
Musée Bourdelle,2006,ILE-DE-FRANCE,PARIS,16782,27277,44059,
Musée de la Mer,2008,PROVENCE-ALPES-CÔTE D'AZUR,CANNES,47942,39239,87181,
Musée de la Franc-Maçonnerie,2006,ILE-DE-FRANCE,PARIS,7000,3000,10000,
Musée de Préhistoire Régionale,2008,PROVENCE-ALPES-CÔTE D'AZUR,MENTON,0,11240,11240,
Musée Zadkine,2006,ILE-DE-FRANCE,PARIS,4187,2528,6715,
Muséum d'Histoire Naturelle,2008,PROVENCE-ALPES-CÔTE D'AZUR,NICE,0,69350,69350,
Musée Galliera - Musée de la Mode de la ville de Paris,2006,ILE-DE-FRANCE,PARIS,24066,18010,42076,
Musée d'Art et d'Histoire,2008,PROVENCE-ALPES-CÔTE D'AZUR,NICE,14285,64048,78333,
Musée d'Art Moderne de la ville de Paris,2006,ILE-DE-FRANCE,PARIS,321511,456472,777983,
Musée Picasso la guerre et la paix à Vallauris,2008,PROVENCE-ALPES-CÔTE D'AZUR,VALLAURIS,26574,10668,37242,
Musée d'Art et d'Histoire du Judaïsme,2006,ILE-DE-FRANCE,PARIS,66989,37051,104040,
"Musée Cernuschi, Musée des Arts de l'Asie de la ville de Paris",2006,ILE-DE-FRANCE,PARIS,55556,49281,104837,
Musée du Pavillon de Vendôme,2008,PROVENCE-ALPES-CÔTE D'AZUR,AIX-EN-PROVENCE,3417,10782,14199,
Musée Tavet Delacour,2006,ILE-DE-FRANCE,PONTOISE,2080,3667,5747,
Musée- Atelier de Paul Cézanne,2008,PROVENCE-ALPES-CÔTE D'AZUR,AIX-EN-PROVENCE,59515,10000,69515,
Musée Camille Pissarro,2006,ILE-DE-FRANCE,PONTOISE,15,4534,4549,
Musée Municipal Méditerranéen de Cassis A.T.P.,2008,PROVENCE-ALPES-CÔTE D'AZUR,CASSIS,108,6090,6198,
Musée de la Toile de Jouy,2006,ILE-DE-FRANCE,JOUY-EN-JOSAS,9850,0,9850,
Musée d'Histoire de Marseille,2008,PROVENCE-ALPES-CÔTE D'AZUR,MARSEILLE,13422,33305,46727,
Musée Rambolitrain,2006,ILE-DE-FRANCE,RAMBOUILLET,13042,1436,14478,
Musée du Vieux Marseille,2008,PROVENCE-ALPES-CÔTE D'AZUR,MARSEILLE,1996,11627,13623,
Musée Municipal Paul Lafran,2008,PROVENCE-ALPES-CÔTE D'AZUR,SAINT-CHAMAS,0,2441,2441,
Collections de la Fondation de Coubertin,2006,ILE-DE-FRANCE,SAINT-REMY-LES-CHEVREUSE,4666,2640,7306,
Musée Lambinet,2006,ILE-DE-FRANCE,VERSAILLES,9996,3210,13206,
Musée du Pays Brignolais,2008,PROVENCE-ALPES-CÔTE D'AZUR,BRIGNOLES,1843,1763,3606,
Muséum Agricole et Industriel Stella Matutina,2006,LA REUNION,PITON-SAINT-LEU,26328,12029,38357,
Musée des A.T.P. de Moyenne Provence,2008,PROVENCE-ALPES-CÔTE D'AZUR,DRAGUIGNAN,4894,8035,12929,
Musée des Troupes de Marine,2008,PROVENCE-ALPES-CÔTE D'AZUR,FREJUS,0,14541,14541,
Musée d'Art et d'Histoire - Ensemble monumental de Narbonne,2006,LANGUEDOC-ROUSSILLON,NARBONNE,307537,0,307537,
Musée Municipal,2008,PROVENCE-ALPES-CÔTE D'AZUR,HYERES,0,45557,45557,
Musée Jean Aicard,2008,PROVENCE-ALPES-CÔTE D'AZUR,LE POUVEREL LA GARDE,0,2827,2827,
Musée Archéologique,2006,LANGUEDOC-ROUSSILLON,MINERVE,5532,0,5532,
Musée d'Art et d'Archéologie,2008,PROVENCE-ALPES-CÔTE D'AZUR,TOULON,0,6397,6397,
Musée National de la Marine de Toulon,2008,PROVENCE-ALPES-CÔTE D'AZUR,TOULON,9889,50226,60115,
Musée de Vulliod Saint-Germain,2006,LANGUEDOC-ROUSSILLON,PEZENAS,1732,2252,3984,
Musée du Castillet Casa Pairal,2006,LANGUEDOC-ROUSSILLON,PERPIGNAN,6327,12351,18678,
Musée Départemental du Cartonnage et de l'Imprimerie,2008,PROVENCE-ALPES-CÔTE D'AZUR,VALREAS,2790,2055,4845,
Musée de Tautavel,2006,LANGUEDOC-ROUSSILLON,TAUTAVEL,73887,12344,86231,
Musée du Bugey-Valmorey,2008,RHONE-ALPES,LOCHIEU,2101,3289,5390,
Musée du Président Jacques Chirac,2006,LIMOUSIN,SARRAN,21299,7143,28442,
Musée du Peigne et de la Plasturgie,2008,RHONE-ALPES,OYONNAX,1701,1697,3398,
Musée du Pays d'Ussel,2006,LIMOUSIN,USSEL,0,2448,2448,
Musée de l'Histoire du Fer,2006,LORRAINE,JARVILLE-LA-MALGRANGE,4865,1841,6706,
Musée des Beaux-Arts de Nancy,2006,LORRAINE,NANCY,57389,52745,110134,
Musée Départemental du Revermont,2008,RHONE-ALPES,VAL-REVERMONT,4416,14358,18774,
Musée d'Art et d'Histoire de Toul,2006,LORRAINE,TOUL,1100,2485,3585,
Musée des Vans,2008,RHONE-ALPES,LES VANS,500,200,700,
Musée Barrois,2006,LORRAINE,BAR-LE-DUC,4060,6945,11005,
Musée de la Batellerie du Rhône,2008,RHONE-ALPES,SERRIERES,456,272,728,
Musée Départemental Raymond Poincaré,2006,LORRAINE,SAMPIGNY,280,1128,1408,
Musée Alpin,2008,RHONE-ALPES,CHAMONIX,9709,6864,16573,
Musée de la Princerie,2006,LORRAINE,VERDUN,3799,1762,5561,
"Notre histoire, Musée de Rumilly",2008,RHONE-ALPES,RUMILLY,0,480,480,
Musée des Mines de fer de Lorraine,2006,LORRAINE,NEUFCHEF,20139,953,21092,
Musée d'Huez et de l'Oisans,2008,RHONE-ALPES,ALPE D'HUEZ,1383,681,2064,
Musée du Pays de Sarrebourg,2006,LORRAINE,SARREBOURG,4697,5752,10449,
Musée Géo-Charles,2008,RHONE-ALPES,ECHIROLLES,0,6504,6504,
Musée de la Lutherie et de l'Archèterie Française,2006,LORRAINE,MIRECOURT,6256,3301,9557,
Musée de la Résistance de la Déportation de l'Isère,2008,RHONE-ALPES,GRENOBLE,0,21545,21545,
Musée Pierre Noël - Musée de la Vie dans les Hautes-Vosges,2006,LORRAINE,SAINT-DIE-DES-VOSGES,4904,10318,15222,
Muséum d'Histoire Naturelle de Grenoble,2008,RHONE-ALPES,GRENOBLE,23351,66773,90124,
Musée de la Préhistoire,2006,MIDI-PYRENEES,LE MAS D'AZIL,10886,0,10886,
Musée Lapidaire Saint-Pierre,2008,RHONE-ALPES,VIENNE,2080,4712,6792,
Musée Municipal Urbain Cabrol,2006,MIDI-PYRENEES,VILLEFRANCHE-DE-ROUERGUE,0,3561,3561,
Musée-Cloître Saint-André-Le-Bas,2008,RHONE-ALPES,VIENNE,3112,7365,10477,
Musée-Bibliothèque Pierre-André Benoît,2006,MIDI-PYRENEES,ALES,0,21113,21113,
Musée Départemental de la Révolution Française,2008,RHONE-ALPES,VIZILLE,4999,47977,52976,
Musée du Colombier,2006,MIDI-PYRENEES,ALES,0,10137,10137,
Musée d'Histoire du  20ème Siècle - Résistance et Déportation,2008,RHONE-ALPES,ESTIVAREILLES,2342,555,2897,
Musée Léon Alègre,2006,MIDI-PYRENEES,BAGNOLS-SUR-CEZE,196,217,413,
Musée d'Art et d'Industrie,2008,RHONE-ALPES,SAINT-ETIENNE,24456,25217,49673,
Musée des Cultures Taurines (Annexe Musée du Vieux Nîmes),2006,MIDI-PYRENEES,NIMES,1320,5761,7081,
Musée Rural,2008,RHONE-ALPES,USSON-EN-FOREZ,5165,848,6013,
Musée des Vallées Cévenoles,2006,MIDI-PYRENEES,SAINT-JEAN DU GARD,9822,5391,15213,
Musée Henri Malartre,2008,RHONE-ALPES,ROCHETAILLEE-SUR-SAONE,19421,17718,37139,
Musée des Jacobins,2006,MIDI-PYRENEES,AUCH,3229,5143,8372,
Musée Archéologique,2008,RHONE-ALPES,SAINT-ROMAIN-EN-GAL,20126,46309,66435,
Musée d'Archéologie,2006,MIDI-PYRENEES,LECTOURE,2445,350,2795,
Musée archéologique et minéralogique Pierre Borrione,2008,RHONE-ALPES,AIME-EN-TARENTAISE,426,337,763,
Musée Campanaire,2006,MIDI-PYRENEES,L'ISLE JOURDAIN,6714,4955,11669,
Musée des Charmettes,2008,RHONE-ALPES,CHAMBERY,0,12522,12522,
Musée Joseph Abeilhé,2006,MIDI-PYRENEES,MARCIAC,41,0,41,
Musée de l'Académie de La Val d'Isère,2008,RHONE-ALPES,MOÛTIERS,288,239,527,
Musée de Bouxwiller et du pays de hanau,2009,ALSACE,BOUXWILLER,1431,473,1904,
Musée des Transports et des Communications,2006,MIDI-PYRENEES,TOULOUSE,0,2502,2502,
Musée Alsacien,2009,ALSACE,HAGUENAU,1456,1666,3122,
Musée des Augustins,2006,MIDI-PYRENEES,TOULOUSE,40747,60062,100809,
Musée du Fer,2009,ALSACE,REICHSHOFFEN,828,603,1431,
Musée du Vieux Figeac,2006,MIDI-PYRENEES,FIGEAC,786,362,1148,
Musée d'Art Moderne et Contemporain de Strasbourg,2009,ALSACE,STRASBOURG,36854,97708,134562,
Musée de l'Automate,2006,MIDI-PYRENEES,SOUILLAC,22524,5054,27578,
Musée Archéologique,2009,ALSACE,STRASBOURG,3728,32363,36091,
Musée du Pays Vaurais,2006,MIDI-PYRENEES,LAVAUR,4000,1300,5300,
Musée de l'Œuvre Notre-Dame,2009,ALSACE,STRASBOURG,10353,24018,34371,
Musée Raymond Lafage,2006,MIDI-PYRENEES,LISLE-SUR-TARN,487,2287,2774,
Cité du Train,2009,ALSACE,MULHOUSE,70099,13853,83952,
Musée du Vieil Auvillar,2006,MIDI-PYRENEES,AUVILLAR,2186,266,2452,
Musée des Amis de Thann,2009,ALSACE,THANN,547,1467,2014,
Musée des arts et traditions populaires,2006,MIDI-PYRENEES,MOISSAC,5308,0,5308,
Muséum d'Histoire Naturelle de Bordeaux,2009,AQUITAINE,BORDEAUX,0,14541,14541,
Musée des Beaux-Arts,2009,AQUITAINE,BORDEAUX,31345,79049,110394,
"Forum Antique de Bavay, Musée Archéologique du Département du Nord",2006,NORD-PAS-DE-CALAIS,BAVAY,3612,13546,17158,
Musée de la Voiture à Cheval,2009,AQUITAINE,BOURG-SUR-GIRONDE,2298,1231,3529,
Musée Municipal de Cambrai,2006,NORD-PAS-DE-CALAIS,CAMBRAI,5554,13695,19249,
Musée du Dessin et de l'Estampe Originale,2006,NORD-PAS-DE-CALAIS,GRAVELINES,1170,9117,10287,
Musée Historique de l'Hydravion,2009,AQUITAINE,BISCARROSSE,15050,1066,16116,
Musée Municipal d'Hazebrouck,2006,NORD-PAS-DE-CALAIS,HAZEBROUCK,4090,839,4929,
Atelier-Musée  (Ecomusée de la Grande Landes),2009,AQUITAINE,LUXEY,935,72,1007,
"Musée de la Mine, Centre Historique Minier",2006,NORD-PAS-DE-CALAIS,LEWARDE,136879,13027,149906,
Musée Municipal (Moulin de Gajac),2009,AQUITAINE,VILLENEUVE-SUR-LOT,4089,4676,8765,
Musée de l'Hospice Comtesse,2006,NORD-PAS-DE-CALAIS,LILLE,17305,7680,24985,
Musée National du Château,2009,AQUITAINE,PAU,53802,44545,98347,
Musée Municipal,2006,NORD-PAS-DE-CALAIS,SAINT-AMAND-LES-EAUX,2124,3624,5748,
Musée Charles-Louis Philippe,2009,AUVERGNE,CERILLY,329,145,474,
Château musée,2006,NORD-PAS-DE-CALAIS,BOULOGNE-SUR-MER,22217,11109,33326,
Musée Municipal de Gannat,2009,AUVERGNE,GANNAT,2121,0,2121,
Musée Baron Gérard,2006,BASSE-NORMANDIE,BAYEUX,6634,11794,18428,
Musée Municipal de Souvigny,2009,AUVERGNE,SOUVIGNY,6649,1890,8539,
Musée des Beaux-Arts,2006,BASSE-NORMANDIE,CAEN,18406,52936,71342,
Musée des Sciences,2009,AUVERGNE,AURILLAC,4047,9098,13145,
Musée d'Art et d'Archéologie,2009,AUVERGNE,AURILLAC,1451,17303,18754,
Musée de Normandie,2006,BASSE-NORMANDIE,CAEN,9954,115439,125393,
Musée d'Archéologie Bargoin,2009,AUVERGNE,CLERMONT-FERRAND,3456,12796,16252,
Musée Eugène Boudin,2006,BASSE-NORMANDIE,HONFLEUR,28783,1314,30097,
Musée Municipal de la Coutellerie,2009,AUVERGNE,THIERS,22911,5169,28080,
Musée d'Art et d'Histoire de Lisieux,2006,BASSE-NORMANDIE,LISIEUX,854,1181,2035,
Musée Buffon,2009,BOURGOGNE,MONTBARD,0,11213,11213,
Château de Saint-Germain de Livet,2006,BASSE-NORMANDIE,SAINT-GERMAIN DE LIVET,9008,12298,21306,
Musée Auguste Grasset,2009,BOURGOGNE,VARZY,1751,620,2371,
Musée des Techniques Fromagères,2006,BASSE-NORMANDIE,SAINT-PIERRE-SUR-DIVES,37,78,115,
Musée Rolin,2009,BOURGOGNE,AUTUN,13921,8437,22358,
Musée Paléontologique,2006,BASSE-NORMANDIE,VILLERS-SUR-MER,0,29888,29888,
Museum d'Histoire Naturelle Jacques de La Comble,2009,BOURGOGNE,AUTUN,2157,2881,5038,
Musée de la Guerre et de la Libération,2006,BASSE-NORMANDIE,CHERBOURG-EN-COTENTIN,3971,3081,7052,
Ecomusée de la Bresse Bourguignonne,2009,BOURGOGNE,PIERRE-DE-BRESSE,21312,18470,39782,
Musée Richard Anacréon,2006,BASSE-NORMANDIE,GRANVILLE,4431,4787,9218,
Musée du Terroir,2009,BOURGOGNE,ROMENAY,0,563,563,
Musée du Château,2006,BASSE-NORMANDIE,TORIGNI-SUR-VIRE,1330,70,1400,
Musée Muncipal,2009,BOURGOGNE,SENS,5519,38397,43916,
Musée de la Poeslerie,2006,BASSE-NORMANDIE,VILLEDIEU-LES-POELES-ROUFFIGNY,5462,336,5798,
Musée Zervos - Maison Romain Rolland,2009,BOURGOGNE,VEZELAY,6220,2653,8873,
Musée des Beaux-Arts et de la Dentelle,2006,BASSE-NORMANDIE,ALENCON,12204,8226,20430,
Musée du Château de Dinan,2009,BRETAGNE,DINAN,15338,8368,23706,
Musée Municipal d'Archéologie,2006,BASSE-NORMANDIE,L'AIGLE,864,0,864,
Musée Mathurin Meheut,2009,BRETAGNE,LAMBALLE,4073,1008,5081,
Musée du Percheron,2006,BASSE-NORMANDIE,MORTAGNE-AU-PERCHE,0,880,880,
Ecomusée des Monts d'Arrée - Maison Cornec,2009,BRETAGNE,RIVOAL,4124,3218,7342,
Musée du Verre et de la Pierre,2006,HAUTE-NORMANDIE,CONCHES-EN-OUCHE,1263,2623,3886,
Musée de la Pêche,2009,BRETAGNE,CONCARNEAU,28079,4475,32554,
Musée Artisanal et Industriel d'Instruments à Vent,2006,HAUTE-NORMANDIE,LA COUTURE-BOUSSEY,2436,852,3288,
Musée de l'Ecole Rurale en Bretagne,2009,BRETAGNE,TREGARVAN,10155,1857,12012,
Musée Municipal Nicolas Poussin,2006,HAUTE-NORMANDIE,LES ANDELYS,993,1655,2648,
Ecomusée du Pays de Rennes,2009,BRETAGNE,RENNES,12467,33535,46002,
Musée International du Long-Cours Cap-Hornier,2009,BRETAGNE,SAINT-MALO,7033,2621,9654,
Museoseine,2006,HAUTE-NORMANDIE,CAUDEBEC-EN-CAUX,3142,1146,4288,
Ecomusée Industriel des Forges,2009,BRETAGNE,INZINZAC-LOCHRIST,2845,1996,4841,
Musée Louis-Philippe du Château d'Eu,2006,HAUTE-NORMANDIE,EU,8172,4456,12628,
Musée des Arts Décoratifs,2009,CENTRE,BOURGES,0,17609,17609,
Musée du Prieuré,2006,HAUTE-NORMANDIE,HARFLEUR,155,3645,3800,
Musée du Berry,2009,CENTRE,BOURGES,0,11479,11479,
Musée Départemental Pierre Corneille,2006,HAUTE-NORMANDIE,LE PETIT-COURONNE,1467,4643,6110,
Musée Saint-Vic,2009,CENTRE,SAINT-AMAND-MONTROND,814,3136,3950,
Musée Mathon-Durand,2006,HAUTE-NORMANDIE,NEUFCHATEL-EN-BRAY,449,2072,2521,
Musée Municipal,2009,CENTRE,VIERZON,0,2007,2007,
Ecomusée de la Basse-Seine,2006,HAUTE-NORMANDIE,NOTRE-DAME-DE-BLIQUETUIT,25559,0,25559,
Muséum des Sciences Naturelles et de Préhistoire,2009,CENTRE,CHARTRES,1310,15562,16872,
Musée Industriel de la Corderie Vallois,2006,HAUTE-NORMANDIE,NOTRE-DAME-DE-BONDEVILLE,4745,5193,9938,
Musée Marcel Proust,2009,CENTRE,ILLIERS-COMBRAY,4644,498,5142,
Musée des Beaux-Arts,2006,HAUTE-NORMANDIE,ROUEN,88491,64708,153199,
Musée Archéologique d'Argentomagus,2009,CENTRE,SAINT-MARCEL,8952,8575,17527,
Musée Flaubert et d'Histoire de la Médecine,2006,HAUTE-NORMANDIE,ROUEN,2149,5619,7768,
Musée du Vignoble Nantais,2006,PAYS DE LA LOIRE,LE PALLET,4611,2196,6807,
Musée de Préhistoire du Grand Pressigny,2009,CENTRE,LE GRAND PRESSIGNY,3293,6283,9576,
Muséum des Sciences Naturelles,2006,PAYS DE LA LOIRE,ANGERS,2465,8830,11295,
Musée Joseph Denais,2006,PAYS DE LA LOIRE,BEAUFORT-EN-VALLEE,1151,2280,3431,
Musée de l'Hôtel de Ville,2009,CENTRE,RICHELIEU,1485,0,1485,
Musée d'Art et d'Histoire,2006,PAYS DE LA LOIRE,CHOLET,1933,13155,15088,
Musée Balzac,2009,CENTRE,SACHE,14429,9346,23775,
Musée du Textile,2006,PAYS DE LA LOIRE,CHOLET,4793,5404,10197,
Musée du Compagnonnage,2009,CENTRE,TOURS,30256,18428,48684,
Château Musées de Blois,2009,CENTRE,BLOIS,234557,31210,265767,
Musée Vendéen,2006,PAYS DE LA LOIRE,FONTENAY-LE-COMTE,1294,4594,5888,
Musée de la Corbillière,2009,CENTRE,MER,0,998,998,
Atelier Musée Louis Leygue,2009,CENTRE,NAVEIL,0,207,207,
Musée Jeanne d'Aboville,2006,PICARDIE,LA FERE,321,188,509,
Musée de la Marine de Loire,2009,CENTRE,CHATEAUNEUF-SUR-LOIRE,8030,8247,16277,
Musée Départemental de l'Oise,2006,PICARDIE,BEAUVAIS,3773,10775,14548,
Musée du Gatinais,2009,CENTRE,MONTARGIS,28,198,226,
Musée Historique et Archéologique,2009,CENTRE,ORLEANS,847,2783,3630,
Musée Gallé-Juillet,2006,PICARDIE,CREIL,2402,3196,5598,
Musée d'Art et d'Archéologie,2006,PICARDIE,SENLIS,3118,1336,4454,
Musée de la Maison de la Dernière Cartouche,2009,CHAMPAGNE-ARDENNES,BAZEILLES,1501,1219,2720,
Musée Départemental de l'Abbaye de Saint-Riquier,2006,PICARDIE,ABBEVILLE,2729,25474,28203,
Musée Arthur Rimbaud,2009,CHAMPAGNE-ARDENNES,CHARLEVILLE-MEZIERES,4246,16970,21216,
Atelier - Musée du Papier,2006,POITOU-CHARENTES,ANGOULEME,0,9018,9018,
Musée des Arts du Cognac (Annexe musée municipal),2006,POITOU-CHARENTES,COGNAC,7160,5499,12659,
Musée Protestant,2006,POITOU-CHARENTES,LA ROCHELLE,1506,862,2368,
Musée des Beaux-Arts (Musée Pic Saint-Loup),2009,CHAMPAGNE-ARDENNES,TROYES,5512,12683,18195,
Musée Municipal des Cordeliers,2006,POITOU-CHARENTES,SAINT-JEAN-D'ANGELY,1061,2483,3544,
Musée d'Art Moderne,2009,CHAMPAGNE-ARDENNES,TROYES,21249,22198,43447,
Musée de Bressuire,2006,POITOU-CHARENTES,BRESSUIRE,0,4118,4118,
Pharmacie Musée de l'Hôtel-Dieu,2009,CHAMPAGNE-ARDENNES,TROYES,3444,5474,8918,
Musée d'Art et d'Histoire,2009,CHAMPAGNE-ARDENNES,LANGRES,2358,3120,5478,
Musée de Salagon,2006,PROVENCE-ALPES-CÔTE D'AZUR,MANE,30308,0,30308,
Musée Garinet,2009,CHAMPAGNE-ARDENNES,CHALONS-EN-CHAMPAGNE,725,0,725,
Musée Napoléonien,2009,CORSE,AJACCIO,7410,3073,10483,
Musée-Château de Cagnes,2006,PROVENCE-ALPES-CÔTE D'AZUR,CAGNES-SUR-MER,15927,16194,32121,
Musée Renoir,2006,PROVENCE-ALPES-CÔTE D'AZUR,CAGNES-SUR-MER,26843,9093,35936,
Ecomusée du Pays de la Cerise,2009,FRANCHE-COMTE,FOUGEROLLES,6484,446,6930,
Musée de la Mer,2006,PROVENCE-ALPES-CÔTE D'AZUR,CANNES,42511,34022,76533,
Musée Baron Martin,2009,FRANCHE-COMTE,GRAY,3539,5169,8708,
Musée Départemental de la Montagne Albert Demard,2009,FRANCHE-COMTE,LE HAUT-DU-THEM,3832,3164,6996,
Musée des Beaux-Arts,2006,PROVENCE-ALPES-CÔTE D'AZUR,MENTON,0,18011,18011,
Musée Georges Garret,2009,FRANCHE-COMTE,VESOUL,0,5653,5653,
Muséum d'Histoire Naturelle,2006,PROVENCE-ALPES-CÔTE D'AZUR,NICE,0,75181,75181,
Musée Municipal d'Archéologie,2009,FRANCHE-COMTE,CHAMPAGNOLE,218,217,435,
Musée du Vieux-Logis de Nice,2006,PROVENCE-ALPES-CÔTE D'AZUR,NICE,0,427,427,
Musée Picasso la guerre et la paix à Vallauris,2006,PROVENCE-ALPES-CÔTE D'AZUR,VALLAURIS,28005,13305,41310,
Musée de l'Artisanat Jurassien,2009,FRANCHE-COMTE,VOITEUR,0,14906,14906,
Musées de la Citadelle,2006,PROVENCE-ALPES-CÔTE D'AZUR,VILLEFRANCHE-SUR-MER,0,28350,28350,
Musée Frédéric Japy,2009,FRANCHE-COMTE,BEAUCOURT,808,1469,2277,
Musée du Parlement de Provence et du Vieil Aix,2006,PROVENCE-ALPES-CÔTE D'AZUR,AIX-EN-PROVENCE,12297,7072,19369,
Musée Municipal Saint-John Perse,2009,GUADELOUPE,POINTE-A-PITRE,3515,292,3807,
Musée- Atelier de Paul Cézanne,2006,PROVENCE-ALPES-CÔTE D'AZUR,AIX-EN-PROVENCE,111811,0,111811,
Musée des Cultures Guyanaises,2009,GUYANE,CAYENNE,1443,5329,6772,
Musée Archéologique d'Istres René Beaucaire,2006,PROVENCE-ALPES-CÔTE D'AZUR,ISTRES,2162,1976,4138,
Musée Ciotaden,2006,PROVENCE-ALPES-CÔTE D'AZUR,LA CIOTAT,4128,2298,6426,
Musée Municipal d'Art et d'Histoire,2009,ILE-DE-FRANCE,COLOMBES,0,5536,5536,
Musée Grobet-Labadié,2006,PROVENCE-ALPES-CÔTE D'AZUR,MARSEILLE,2568,5141,7709,
Musée d'Histoire de Marseille,2006,PROVENCE-ALPES-CÔTE D'AZUR,MARSEILLE,12576,25061,37637,
Musée National des Arts et des Traditions Populaires (MuCem),2009,ILE-DE-FRANCE,PARIS,0,21281,21281,
Maison de Victor Hugo,2009,ILE-DE-FRANCE,PARIS,9388,138372,147760,
Musée de l'Empéri de Salon et de la Crau,2006,PROVENCE-ALPES-CÔTE D'AZUR,SALON-DE-PROVENCE,6995,16707,23702,
Musée Carnavalet-Histoire de Paris (+ Crypte et les Catacombes),2009,ILE-DE-FRANCE,PARIS,303869,698940,1002809,
Musée de la Vie Romantique,2009,ILE-DE-FRANCE,PARIS,28408,53421,81829,
Musée Départemental des Hautes-Alpes,2006,PROVENCE-ALPES-CÔTE D'AZUR,GAP,1567,13988,15555,
Musée de la Musique,2009,ILE-DE-FRANCE,PARIS,148491,47580,196071,
Musée des A.T.P. de Moyenne Provence,2006,PROVENCE-ALPES-CÔTE D'AZUR,DRAGUIGNAN,10081,4767,14848,
Musée d'Art et d'Histoire du Judaïsme,2009,ILE-DE-FRANCE,PARIS,61139,30121,91260,
Musée du Vêtement Provençal (Jean Aicard),2006,PROVENCE-ALPES-CÔTE D'AZUR,SOLLIES-VILLE,0,3791,3791,
Musée National du Sport,2009,ILE-DE-FRANCE,PARIS,5718,6282,12000,
Muséum d'Histoire Naturelle de Toulon,2006,PROVENCE-ALPES-CÔTE D'AZUR,TOULON,0,29159,29159,
Musée du Service de Santé des Armées du Val-de-Grâce,2009,ILE-DE-FRANCE,PARIS,7437,10267,17704,
Musée d'Art et d'Archéologie,2006,PROVENCE-ALPES-CÔTE D'AZUR,TOULON,0,19726,19726,
Musée Municipal de Chelles Alfred Bonno,2009,ILE-DE-FRANCE,CHELLES,0,3434,3434,
Muséum d'Histoire Naturelle Esprit Requien,2006,PROVENCE-ALPES-CÔTE D'AZUR,AVIGNON,0,14011,14011,
Musée Municipal,2009,ILE-DE-FRANCE,MORET-SUR-LOING,0,5736,5736,
Musée du Petit Palais,2006,PROVENCE-ALPES-CÔTE D'AZUR,AVIGNON,20915,14148,35063,
Musée Municipal Camille Pautet,2006,PROVENCE-ALPES-CÔTE D'AZUR,MAZAN,0,2072,2072,
Musée de l'Histoire Vivante,2009,ILE-DE-FRANCE,MONTREUIL-SOUS-BOIS,1992,2142,4134,
Musée Départemental du Cartonnage et de l'Imprimerie,2006,PROVENCE-ALPES-CÔTE D'AZUR,VALREAS,2959,2261,5220,
Musée de Nogent-Sur-Marne,2009,ILE-DE-FRANCE,NOGENT-SUR-MARNE,0,6528,6528,
Musée de la Résistance et de la Déportation de l'Ain,2006,RHONE-ALPES,NANTUA,6368,1968,8336,
Musée Intercommunal d'Histoire et d'Archéologie de Louvres,2009,ILE-DE-FRANCE,ROISSY-EN-FRANCE,79,2183,2262,
Musée de la Batellerie et des Voies Navigables,2009,ILE-DE-FRANCE,CONFLANS-SAINTE-HONORINE,7707,1679,9386,
Musée de la Batellerie du Rhône,2006,RHONE-ALPES,SERRIERES,803,554,1357,
Musée de la Toile de Jouy,2009,ILE-DE-FRANCE,JOUY-EN-JOSAS,8774,1540,10314,
Musée d'Archéologie Tricastine,2006,RHONE-ALPES,SAINT-PAUL-TROIS-CHATEAUX,2335,928,3263,
Musée-Maison Maurice Ravel,2009,ILE-DE-FRANCE,MONTFORT-L'AMAURY,2280,139,2419,
Musée du site Préhistorique,2006,RHONE-ALPES,VASSIEUX-EN-VERCORS,15548,0,15548,
Musée Lambinet,2009,ILE-DE-FRANCE,VERSAILLES,7494,2510,10004,
Musée Léon Marès,2006,RHONE-ALPES,LOVAGNY,17304,0,17304,
"Notre histoire, Musée de Rumilly",2006,RHONE-ALPES,RUMILLY,0,2752,2752,
Musée Municipal de la Vignasse,2009,LANGUEDOC-ROUSSILLON,BEAUCAIRE,736,2227,2963,
Musée Hector Berlioz,2006,RHONE-ALPES,LA-COTE-SAINT-ANDRE,0,12311,12311,
Musée des Cultures Taurines (Annexe du Vieux Nîmes),2009,LANGUEDOC-ROUSSILLON,NIMES,331,6565,6896,
Musée de la Grande Chartreuse,2006,RHONE-ALPES,SAINT-PIERRE-DE-CHARTREUSE,49485,3585,53070,
Musée des Beaux-Arts,2009,LANGUEDOC-ROUSSILLON,NIMES,2212,14647,16859,
Musée de la Soierie,2006,RHONE-ALPES,CHARLIEU,4909,514,5423,
Musée Pierre de Luxembourg,2009,LANGUEDOC-ROUSSILLON,VILLENEUVE-LES-AVIGNON,3504,2168,5672,
Musée Folklorique du Vieux Saint-Etienne,2006,RHONE-ALPES,SAINT-ETIENNE,496,653,1149,
Musée Agathois,2009,LANGUEDOC-ROUSSILLON,AGDE,3600,2446,6046,
Musée des Civilisations : Daniel Pouget,2006,RHONE-ALPES,SAINT-JUST-SAINT-RAMBERT,4343,878,5221,
Musée Fleury,2009,LANGUEDOC-ROUSSILLON,LODEVE,62263,9879,72142,
Musée Fabre,2009,LANGUEDOC-ROUSSILLON,MONTPELLIER,176786,77874,254660,
Lugdunum - Musée et Théâtres Romains,2006,RHONE-ALPES,LYON,38031,69054,107085,
Musée de Préhistoire Régionale et du Mégalithisme,2009,LANGUEDOC-ROUSSILLON,SAINT-PONS-DE-THOMIERES,2410,970,3380,
Muséum d'Histoire Naturelle,2006,RHONE-ALPES,LYON,23354,48673,72027,
Muséum d'Histoire Naturelle,2009,LANGUEDOC-ROUSSILLON,PERPIGNAN,982,7605,8587,
Centre d'Histoire de la Résistance et de la Déportation,2006,RHONE-ALPES,LYON,18949,41889,60838,
Musée des Monnaies et Médailles Joseph Puig,2009,LANGUEDOC-ROUSSILLON,PERPIGNAN,97,1235,1332,
Musée des Beaux-Arts,2006,RHONE-ALPES,LYON,104271,149019,253290,
Musée du Castillet Casa Pairal,2009,LANGUEDOC-ROUSSILLON,PERPIGNAN,6626,17769,24395,
Musée Paul Dini,2006,RHONE-ALPES,VILLEFRANCHE-SUR-SAONE,22658,4546,27204,
Musée du Cloître de Tulle André Mazeyrie,2009,LIMOUSIN,TULLE,4685,24117,28802,
Muséum d'histoire naturelle,2006,RHONE-ALPES,CHAMBERY CEDEX,673,2301,2974,
Musée René Baubérot,2009,LIMOUSIN,CHATEAUPONSAC,3277,771,4048,
Musée de la Chartreuse,2007,ALSACE,MOLSHEIM,3799,1236,5035,
Musée Gallo-Romain,2007,ALSACE,BIESHEIM,777,1611,2388,
Musée d'Unterlinden,2007,ALSACE,COLMAR,168252,24128,192380,
Musée Départemental Raymond Poincaré,2009,LORRAINE,SAMPIGNY,494,416,910,
Musée du Florival,2007,ALSACE,GUEBWILLER,2956,2041,4997,
Musée d'Argonne,2009,LORRAINE,VARENNES-EN-ARGONNE,2010,0,2010,
Musée Historique et Militaire de Huningue,2007,ALSACE,HUNINGE,634,24,658,
Musée Jeanne d'Arc,2009,LORRAINE,VAUCOULEURS,1282,1130,2412,
Musée National de l'Automobile - Collection Schlumpf,2007,ALSACE,MULHOUSE,150091,31618,181709,
Musée Militaire et Erckmann-Chatrian,2009,LORRAINE,PHALSBOURG,926,142,1068,
Musée de l'Impression sur Etoffes,2007,ALSACE,MULHOUSE,9719,14164,23883,
Musée de l'Image,2009,LORRAINE,EPINAL,21887,5663,27550,
Musée du Tabac,2007,AQUITAINE,BERGERAC,3257,1717,4974,
Musée Départemental d'Art Ancien et Contemporain,2009,LORRAINE,EPINAL,19604,0,19604,
Musée Paul Reclus,2007,AQUITAINE,DOMME,7448,9444,16892,
Musée Pierre Noël - Musée de la Vie dans les Hautes-Vosges,2009,LORRAINE,SAINT-DIE-DES-VOSGES,3490,8186,11676,
Musée des Arts Décoratifs,2007,AQUITAINE,BORDEAUX,11972,33119,45091,
Musée Régional d'Histoire et d'Ethnologie,2009,MARTINIQUE,FORT-DE-FRANCE,1833,2250,4083,
Centre National Jean Moulin,2007,AQUITAINE,BORDEAUX,0,18184,18184,
Musée de la Voiture à Cheval,2007,AQUITAINE,BOURG-SUR-GIRONDE,2140,574,2714,
Musée de La Canne,2009,MARTINIQUE,LES TROIS ILETS,9395,1721,11116,
Musée d'Art et d'Histoire du Cap de Gascogne,2007,AQUITAINE,SAINT-SEVER,0,1600,1600,
Musée Départemental de l'Ariège,2009,MIDI-PYRENEES,FOIX,82793,6393,89186,
Musée de la Faïence et des arts de la table,2007,AQUITAINE,SAMADET,4199,3409,7608,
Musée du Textile et du Peigne en Corne,2009,MIDI-PYRENEES,LAVELANET,1313,74,1387,
Musée du Liège et du Bouchon,2007,AQUITAINE,MEZIN,5850,1130,6980,
Musée de la Préhistoire,2009,MIDI-PYRENEES,LE MAS D'AZIL,10732,813,11545,
Musée de Préhistoire Mésolithique Laurent Coulonges,2007,AQUITAINE,SAUVETERRE-LA-LEMANCE,2050,817,2867,
Musée des Beaux-Arts Denys Puech,2009,MIDI-PYRENEES,RODEZ,1654,9387,11041,
Muséum d'Histoire Naturelle,2007,AQUITAINE,BAYONNE,11815,0,11815,
Musée du Charroi Rural et de l'Artisanat Traditionnel,2009,MIDI-PYRENEES,SALMIECH,0,2360,2360,
Musée Basque et de l'Histoire de Bayonne,2007,AQUITAINE,BAYONNE,25615,15446,41061,
Musée Champollion - Les Ecriture du Monde,2009,MIDI-PYRENEES,FIGEAC,32019,8787,40806,
Musée Edmond Rostand,2007,AQUITAINE,CAMBO-LES-BAINS,67254,2557,69811,
"Musée Archéologique ""Armand-Viré""",2009,MIDI-PYRENEES,LUZECH,830,1063,1893,
Musée Municipal des Beaux-Arts,2007,AQUITAINE,PAU,10811,11847,22658,
Musée Municipal de Gannat,2007,AUVERGNE,GANNAT,871,835,1706,
Musée Départemental de Cuzals,2009,MIDI-PYRENEES,SAULIAC-SUR-CELE,8563,0,8563,
Musée d'art et d'histoire Alfred Douët,2007,AUVERGNE,SAINT-FLOUR,1568,1623,3191,
Musée Municipal,2009,MIDI-PYRENEES,VAYRAC,187,0,187,
Musée d'Archéologie Bargoin,2007,AUVERGNE,CLERMONT-FERRAND,3048,9413,12461,
Musée Goya,2009,MIDI-PYRENEES,CASTRES,12554,10631,23185,
Musée d'Art Roger-Quillot,2007,AUVERGNE,CLERMONT-FERRAND,6177,29259,35436,
Musée Charles Portal - Histoire et Patrimoine,2009,MIDI-PYRENEES,CORDES-SUR-CIEL,561,315,876,
Muséum d'Histoire Naturelle Henri-Lecoq,2007,AUVERGNE,CLERMONT-FERRAND,3319,23770,27089,
Musée de Salagon,2017,PROVENCE-ALPES-CÔTE D'AZUR,MANE,26520,6588,33108,
Musée du Vin de Bourgogne,2007,BOURGOGNE,BEAUNE,25371,3957,29328,
Musée Fernand Léger,2017,PROVENCE-ALPES-CÔTE D'AZUR,BIOT,13267,15427,28694,
Musée Magnin,2007,BOURGOGNE,DIJON,6982,7059,14041,
Villa-Musée Jean-Honoré Fragonard,2017,PROVENCE-ALPES-CÔTE D'AZUR,GRASSE,0,1901,1901,
Musée Noisot,2007,BOURGOGNE,FIXIN,414,463,877,
Musée de Préhistoire Régionale,2017,PROVENCE-ALPES-CÔTE D'AZUR,MENTON,1966,5468,7434,
Musée Municipal,2007,BOURGOGNE,SEMUR-EN-AUXOIS,1568,3868,5436,
Musée d'Art Naïf Anatole Jakovsky,2017,PROVENCE-ALPES-CÔTE D'AZUR,NICE,2671,4841,7512,
Ecomusée des Monts d'Arrée - Moulins de Kerouat,2007,BRETAGNE,COMMANA,11151,2049,13200,
Musée Archéologique - Site de Terra Amata,2017,PROVENCE-ALPES-CÔTE D'AZUR,NICE,4206,14544,18750,
Ecomusée des Monts d'Arrée - Maison Cornec,2007,BRETAGNE,RIVOAL,4501,2601,7102,
Musée National du Sport,2017,PROVENCE-ALPES-CÔTE D'AZUR,NICE,31205,25763,56968,
Ecomusée d'Ouessant - Vivre sur une Ile,2007,BRETAGNE,OUESSANT,6382,4799,11181,
Ecomusée du Pays de la Roudoule,2017,PROVENCE-ALPES-CÔTE D'AZUR,PUGET-ROSTANG,1613,4591,6204,
Musée des Phares et Balises,2007,BRETAGNE,OUESSANT,16089,4711,20800,
Muséon Arlaten,2017,PROVENCE-ALPES-CÔTE D'AZUR,ARLES,0,3129,3129,
Musée d'Histoire de la Ville de Saint-Malo,2007,BRETAGNE,SAINT-MALO,30679,14142,44821,
Musée National de la Marine,2007,BRETAGNE,PORT-LOUIS,41465,20625,62090,
Musée des Beaux-Arts de Marseille,2017,PROVENCE-ALPES-CÔTE D'AZUR,MARSEILLE,15384,31163,46547,
Musée des Arts Décoratifs,2007,CENTRE,BOURGES,0,16008,16008,
Musée d'Art Contemporain - Galeries Contemporaines,2017,PROVENCE-ALPES-CÔTE D'AZUR,MARSEILLE,12188,35248,47436,
Musée du Château Charles VII,2007,CENTRE,MEHUN-SUR-YEVRE,10603,0,10603,
Muséum d'Histoire Naturelle,2017,PROVENCE-ALPES-CÔTE D'AZUR,MARSEILLE,14179,53339,67518,
Musée Saint-Vic,2007,CENTRE,SAINT-AMAND-MONTROND,880,2431,3311,
Musée Ziem,2017,PROVENCE-ALPES-CÔTE D'AZUR,MARTIGUES,0,14348,14348,
Musée Municipal,2007,CENTRE,VIERZON,23,1652,1675,
Musée des Alpilles,2017,PROVENCE-ALPES-CÔTE D'AZUR,SAINT-REMY-DE-PROVENCE,2898,5773,8671,
Musée d'Art et d'Histoire de Dreux,2007,CENTRE,DREUX,2856,4228,7084,
Musée de l'Empéri de Salon et de la Crau,2017,PROVENCE-ALPES-CÔTE D'AZUR,SALON-DE-PROVENCE,5983,23817,29800,
Musée George Sand et de la Vallée Noire,2007,CENTRE,LA CHATRE,2849,1692,4541,
Musée des Beaux-Arts,2017,PROVENCE-ALPES-CÔTE D'AZUR,DRAGUIGNAN,0,1159,1159,
Musée de l'Hôtel des Communes,2007,CENTRE,AMBOISE,0,5449,5449,
Musée de l'Artillerie,2017,PROVENCE-ALPES-CÔTE D'AZUR,DRAGUIGNAN,0,13546,13546,
Musée Jean Aicard,2017,PROVENCE-ALPES-CÔTE D'AZUR,LE POUVEREL LA GARDE,0,1825,1825,
Muséum d'Histoire Naturelle,2007,CENTRE,TOURS,6770,10900,17670,
Musée Calvet (et musée Lapidaire),2017,PROVENCE-ALPES-CÔTE D'AZUR,AVIGNON,6678,19200,25878,
Musée de Minerve,2007,CENTRE,YZEURES-SUR-CREUSE,0,1020,1020,
Musée Sobirats,2017,PROVENCE-ALPES-CÔTE D'AZUR,CARPENTRAS,0,351,351,
Muséum d'Histoire Naturelle,2007,CENTRE,BLOIS,3411,5766,9177,
Château Musées de Blois,2007,CENTRE,BLOIS,228717,43430,272147,
Musée-Bibliothèque François Pétrarque,2017,PROVENCE-ALPES-CÔTE D'AZUR,FONTAINE-DE-VAUCLUSE,1342,2091,3433,
Musée Archéologique,2007,CENTRE,THESEE,1485,244,1729,
Musée Archéologique Théo Desplans,2017,PROVENCE-ALPES-CÔTE D'AZUR,VAISON-LA-ROMAINE,57924,10320,68244,
Musée Municipal Théâtre Forain et Archéologique,2007,CENTRE,ARTENAY,2894,4375,7269,
Musée de la Marine de Loire,2007,CENTRE,CHATEAUNEUF-SUR-LOIRE,8912,4337,13249,
Musée Archéologique,2018,AUVERGNE-RHONE-ALPES,IZERNORE,1077,2764,3841,
Musée Napoléon Ier,2007,CHAMPAGNE-ARDENNES,BRIENNE-LE-CHATEAU,3652,853,4505,
Musée du Peigne et de la Plasturgie,2018,AUVERGNE-RHONE-ALPES,OYONNAX,1503,2748,4251,
Musée Vauluisant - Musée de la Bonneterie,2007,CHAMPAGNE-ARDENNES,TROYES,5340,0,5340,
Musée du Vieux Pérouges,2018,AUVERGNE-RHONE-ALPES,PEROUGES,8652,56,8708,
Musée Municipal,2007,CHAMPAGNE-ARDENNES,BOURBONNE-LES-BAINS,0,1597,1597,
Musée des Arts D'Afrique et D'Asie,2018,AUVERGNE-RHONE-ALPES,VICHY,3397,1555,4952,
Musée d'Art et d'Histoire,2007,CHAMPAGNE-ARDENNES,LANGRES,0,12789,12789,
Musée d'Art et d'Archéologie,2018,AUVERGNE-RHONE-ALPES,AURILLAC,1291,10947,12238,
Ecomusée de Margeride-Haute-Auvergne,2018,AUVERGNE-RHONE-ALPES,RUYNES-EN-MARGERIDE,5967,8342,14309,
Musée Garinet,2007,CHAMPAGNE-ARDENNES,CHALONS-EN-CHAMPAGNE,180,376,556,
Musée du Château des Adhémars,2018,AUVERGNE-RHONE-ALPES,MONTELIMAR,11491,11955,23446,
Muséum de Besançon,2007,FRANCHE-COMTE,BESANCON,274538,0,274538,
Musée International de la Chaussure,2018,AUVERGNE-RHONE-ALPES,ROMANS,13228,9734,22962,
Musée des Beaux-Arts,2007,FRANCHE-COMTE,DOLE,0,19542,19542,
Musée Léon Marès,2018,AUVERGNE-RHONE-ALPES,LOVAGNY,29538,288,29826,
Musée du Jouet,2007,FRANCHE-COMTE,MOIRANS-EN-MONTAGNE,24421,1276,25697,
Musée Archéologique Grenoble Saint-Laurent,2018,AUVERGNE-RHONE-ALPES,GRENOBLE,0,47563,47563,
Ecomusée de Marie-Galante,2007,GUADELOUPE,GRAND-BOURG de MARIE-GALANTE,6000,0,6000,
Musée Dauphinois,2018,AUVERGNE-RHONE-ALPES,GRENOBLE,0,84194,84194,
Ecomusée Municipal d'Approuague-Kaw,2007,GUYANE,REGINA,24,504,528,
Maison du Patrimoine de Hières-sur-Amby,2018,AUVERGNE-RHONE-ALPES,HIERES SUR AMBY,7598,1122,8720,
Fondation Arp,2007,ILE-DE-FRANCE,CLAMART,1438,462,1900,
Musée-Cloître Saint-André-Le-Bas,2018,AUVERGNE-RHONE-ALPES,VIENNE,4369,5620,9989,
Musée Lucien Mainssieux,2018,AUVERGNE-RHONE-ALPES,VOIRON,0,4768,4768,
Musée de l'Homme (Muséum National d'Histoire Naturelle),2007,ILE-DE-FRANCE,PARIS,124282,29991,154273,
Château de la Bastie d'Urfé,2018,AUVERGNE-RHONE-ALPES,SAINT-ETIENNE-LE-MOLARD,7278,20199,27477,
Musée National de la Marine,2007,ILE-DE-FRANCE,PARIS,131233,32317,163550,
Musée Rural,2018,AUVERGNE-RHONE-ALPES,USSON-EN-FOREZ,2985,1444,4429,
"Petit Palais, Musée des Beaux-Arts de la ville de Paris",2007,ILE-DE-FRANCE,PARIS,128858,453043,581901,
Musée des Pénitents Blancs,2018,AUVERGNE-RHONE-ALPES,MARSAC-EN-LIVRADOIS,129,0,129,
Etablissement Public du Musée des Arts Asiatiques Guimet,2007,ILE-DE-FRANCE,PARIS,205983,103526,309509,
Musée des Monuments Français,2007,ILE-DE-FRANCE,PARIS,119465,44341,163806,
Musée Municipal Marcel Sahut,2018,AUVERGNE-RHONE-ALPES,VOLVIC,860,296,1156,
"Musée Cognacq-Jay, Musée du XVIIIe siècle de la ville de Paris",2007,ILE-DE-FRANCE,PARIS,472,24314,24786,
Musée Barthélemy-Thimonnier,2018,AUVERGNE-RHONE-ALPES,AMPLEPUIS,1604,1679,3283,
Musée de l'Air et de l'Espace,2007,ILE-DE-FRANCE,LE BOURGET,93492,107497,200989,
Musée Adrien Mentienne,2007,ILE-DE-FRANCE,BRY-SUR-MARNE,0,2000,2000,
Musée jean-Jacques Rousseau,2007,ILE-DE-FRANCE,MONTMORENCY,1060,1678,2738,
Musée Tavet Delacour,2007,ILE-DE-FRANCE,PONTOISE,2526,4682,7208,
Musée des Beaux-Arts,2018,AUVERGNE-RHONE-ALPES,CHAMBERY,6089,22544,28633,
Musée Camille Pissarro,2007,ILE-DE-FRANCE,PONTOISE,0,4317,4317,
Musée des Beaux-Arts,2018,BOURGOGNE-FRANCHE-COMTE,MONTBARD,0,150,150,
Musée Municipal,2018,BOURGOGNE-FRANCHE-COMTE,NUITS-SAINT-GEORGES,390,5124,5514,
Musée Lambinet,2007,ILE-DE-FRANCE,VERSAILLES,9993,4753,14746,
Musée Beurnier-Rossel,2018,BOURGOGNE-FRANCHE-COMTE,MONTBELIARD,456,2009,2465,
Musée Départemental Albert-et-Félicie Demard - ATP,2018,BOURGOGNE-FRANCHE-COMTE,CHAMPLITTE,4962,7205,12167,
Musée Archéologique du Lauragais,2007,LANGUEDOC-ROUSSILLON,CASTELNAUDARY,934,1522,2456,
Ecomusée du Pays de la Cerise,2018,BOURGOGNE-FRANCHE-COMTE,FOUGEROLLES,6182,4150,10332,
Musée Petiet,2007,LANGUEDOC-ROUSSILLON,LIMOUX,1103,1344,2447,
Musée Départemental de la Montagne Albert Demard,2018,BOURGOGNE-FRANCHE-COMTE,LE HAUT-DU-THEM,4463,3564,8027,
Musée des Beaux-Arts,2007,LANGUEDOC-ROUSSILLON,NIMES,2382,11343,13725,
Musée de la Tour des Echevins,2018,BOURGOGNE-FRANCHE-COMTE,LUXEUIL-LES-BAINS,582,2740,3322,
Musée de la Maison Romane,2007,LANGUEDOC-ROUSSILLON,SAINT-GILLES-DU-GARD,0,6100,6100,
Musée Municipal d'Archéologie,2018,BOURGOGNE-FRANCHE-COMTE,CHAMPAGNOLE,399,285,684,
Musée des Vallées Cévenoles,2007,LANGUEDOC-ROUSSILLON,SAINT-JEAN DU GARD,9292,7397,16689,
Musée du Jouet,2018,BOURGOGNE-FRANCHE-COMTE,MOIRANS-EN-MONTAGNE,39240,12208,51448,
Musée d'Art et d'Histoire Romain Rolland,2018,BOURGOGNE-FRANCHE-COMTE,CLAMECY,1934,1822,3756,
Site Archéologique Lattara - Musée Henri Prades de Montpellier Agglomération,2007,LANGUEDOC-ROUSSILLON,LATTES,5658,2747,8405,
Musée du Grès de Puisaye,2018,BOURGOGNE-FRANCHE-COMTE,SAINT-AMAND-EN-PUISAYE,2110,0,2110,
Musée Archéologique Paul Soyris,2007,LANGUEDOC-ROUSSILLON,MURVIEL-LES-MONTPELLIER,0,520,520,
Muséum - Maison de l'Eau,2018,BOURGOGNE-FRANCHE-COMTE,AUXERRE,0,17994,17994,
Musée Zervos - Maison Romain Rolland,2018,BOURGOGNE-FRANCHE-COMTE,VEZELAY,4903,2912,7815,
Musée Villeneuvien,2018,BOURGOGNE-FRANCHE-COMTE,VILLENEUVE-SUR-YONNE,0,1237,1237,
Musée d'Art et d'Archéologie,2007,LIMOUSIN,GUERET,6476,5006,11482,
Musée Mathurin Meheut,2018,BRETAGNE,LAMBALLE,6417,917,7334,
Musée National Adrien Dubouché,2007,LIMOUSIN,LIMOGES,11771,7257,19028,
Musée des Beaux-Arts de Brest,2018,BRETAGNE,BREST,4617,12407,17024,
Musée Départemental d'Art Contemporain,2007,LIMOUSIN,ROCHECHOUART,6663,5467,12130,
Musée National de la Marine,2018,BRETAGNE,BREST,37252,36823,74075,
Musée de l'Histoire du Fer,2007,LORRAINE,JARVILLE-LA-MALGRANGE,1834,4588,6422,
Muséum- Aquarium de Nancy,2007,LORRAINE,NANCY,27202,46865,74067,
Le Port-Musée,2018,BRETAGNE,DOUARNENEZ,31134,10405,41539,
Musée de la Céramique et de l'Ivoire,2007,LORRAINE,COMMERCY,1519,835,2354,
Musée Bigouden,2018,BRETAGNE,PONT-L'ABBE,10075,3611,13686,
Musée Jules Bastien-Lepage - Musée de la Fortification,2007,LORRAINE,MONTMEDY,12439,1111,13550,
Musée des Beaux-Arts,2018,BRETAGNE,QUIMPER,34982,21122,56104,
Musée d'Argonne,2007,LORRAINE,VARENNES-EN-ARGONNE,1839,0,1839,
Musée de Bretagne,2018,BRETAGNE,RENNES,19088,48247,67335,
Musée Départemental du Sel,2007,LORRAINE,MARSAL,18204,0,18204,
Musée d'Histoire de la Ville de Saint-Malo,2018,BRETAGNE,SAINT-MALO,20387,11560,31947,
Maison du Verre et du Cristal,2007,LORRAINE,MEISENTHAL,16726,912,17638,
Musée du Faouët,2018,BRETAGNE,LE FAOUET,17299,4087,21386,
Musée de la Mine - Carreau Wendel,2007,LORRAINE,PETITE-ROSSELLE,43725,0,43725,
Musée d'Histoire et d'Archéologie de Vannes,2018,BRETAGNE,VANNES,3034,7228,10262,
Musée Militaire et Erckmann-Chatrian,2007,LORRAINE,PHALSBOURG,803,159,962,
Musée Estève,2018,CENTRE-VAL DE LOIRE,BOURGES,6337,950,7287,
Musée de l'Image,2007,LORRAINE,EPINAL,24786,9284,34070,
Musée des Beaux-Arts,2018,CENTRE-VAL DE LOIRE,CHARTRES,0,22047,22047,
Musée Louis Français,2007,LORRAINE,PLOMBIERES-LES-BAINS,244,233,477,
Musée de l'Hospice Saint-Roch,2018,CENTRE-VAL DE LOIRE,ISSOUDUN,0,18531,18531,
Musée Pierre Noël - Musée de la Vie dans les Hautes-Vosges,2007,LORRAINE,SAINT-DIE-DES-VOSGES,5699,12016,17715,
Musée - Hôtel Morin,2018,CENTRE-VAL DE LOIRE,AMBOISE,0,8676,8676,
Musée Régional d'Histoire et d'Ethnologie,2007,MARTINIQUE,FORT-DE-FRANCE,2849,2049,4898,
Musée Balzac,2018,CENTRE-VAL DE LOIRE,SACHE,12578,6352,18930,
Ecomusée du Véron,2018,CENTRE-VAL DE LOIRE,SAVIGNY-EN-VERON,3608,5109,8717,
Musée Régional de Géologie Pierre Vetter,2007,MIDI-PYRENEES,DECAZEVILLE,2083,2147,4230,
Musée Fenaille,2007,MIDI-PYRENEES,RODEZ,8599,13876,22475,
Musée du Compagnonnage,2018,CENTRE-VAL DE LOIRE,TOURS,23214,18980,42194,
Musée Municipal Urbain Cabrol,2007,MIDI-PYRENEES,VILLEFRANCHE-DE-ROUERGUE,0,3738,3738,
Musée d'Archéologie,2007,MIDI-PYRENEES,LECTOURE,2250,660,2910,
Maison de la Magie,2018,CENTRE-VAL DE LOIRE,BLOIS,75288,23325,98613,
"Les Abattoirs, Musée d'Art Moderne et Contemporain",2007,MIDI-PYRENEES,TOULOUSE,39310,80574,119884,
Château Musées de Blois,2018,CENTRE-VAL DE LOIRE,BLOIS,284535,47990,332525,
Musée Saint-Raymond,2007,MIDI-PYRENEES,TOULOUSE,24743,60214,84957,
Musée de Vendôme,2018,CENTRE-VAL DE LOIRE,VENDOME,0,13142,13142,
Musée-château Gaston Phébus,2007,MIDI-PYRENEES,MAUVEZIN,29660,0,29660,
Musée Champollion - Les Ecriture du Monde,2007,MIDI-PYRENEES,FIGEAC,22538,6477,29015,
Musée Gaston Couté,2018,CENTRE-VAL DE LOIRE,MEUNG-SUR-LOIRE,0,2572,2572,
Musée Eugénie et Maurice Guérin,2007,MIDI-PYRENEES,ANDILLAC,2235,2218,4453,
Musée de l'Abbaye Saint-Michel,2007,MIDI-PYRENEES,GAILLAC,2619,1583,4202,
Musée Palais Fesch,2018,CORSE,AJACCIO,27554,20343,47897,
Musée Départemental du Textile,2007,MIDI-PYRENEES,LA-BASTIDE-ROUAIROUX,0,2209,2209,
Musée Départemental Pascal Paoli,2018,CORSE,MOROSAGLIA,3699,1381,5080,
Musée des arts et traditions populaires,2007,MIDI-PYRENEES,MOISSAC,3980,892,4872,
Musée de la Maison de la Dernière Cartouche,2018,GRAND EST,BAZEILLES,1175,1388,2563,
Lieu d'Art et Action Contemporaine de Dunkerque - LAAC,2007,NORD-PAS-DE-CALAIS,DUNKERQUE,34306,0,34306,
Maison des Ailleurs - Arthur Rimbaud (Annexe musée Arthur Rimbaud),2018,GRAND EST,CHARLEVILLE-MEZIERES,4882,3308,8190,
Musée du Dessin et de l'Estampe Originale,2007,NORD-PAS-DE-CALAIS,GRAVELINES,2078,9713,11791,
Pharmacie Musée de l'Hôtel-Dieu,2018,GRAND EST,TROYES,1196,4869,6065,
Palais des Beaux-Arts de Lille,2007,NORD-PAS-DE-CALAIS,LILLE,204480,35495,239975,
Musée Historique,2018,GRAND EST,HAGUENAU,4586,754,5340,
Mémorial de Caen,2007,BASSE-NORMANDIE,CAEN,380595,0,380595,
Musée de l'Image Populaire de Pfaffenhoffen,2018,GRAND EST,PFAFFENHOFFEN,1172,862,2034,
Musée d'Initiation à la Nature,2007,BASSE-NORMANDIE,CAEN,0,4360,4360,
Musée Lalique,2018,GRAND EST,WINGEN-SUR-MODER,36413,12153,48566,
Musée d'Ethnographie et d'Arts Populaires et Musée de la Marine,2007,BASSE-NORMANDIE,HONFLEUR,17258,1581,18839,
Musée Westercamp,2018,GRAND EST,WISSEMBOURG,0,461,461,
Musée de la Mine,2007,BASSE-NORMANDIE,LE MOLAY-LITTRY,5598,633,6231,
Musée de la Bataille du 6 Août 1870,2018,GRAND EST,WOERTH,1452,940,2392,
Musée de la Bataille de Tilly-Sur-Seulles 1944,2007,BASSE-NORMANDIE,TILLY-SUR-SEULLES,700,0,700,
Musée de la Coutellerie,2018,GRAND EST,NOGENT,3896,881,4777,
Musée Municipal d'Avranches,2007,BASSE-NORMANDIE,AVRANCHES,648,907,1555,
Musée de la Porte de Thann,2018,GRAND EST,CERNAY,40,111,151,
Musée du Granit,2007,BASSE-NORMANDIE,SAINT-MICHEL-DE-MONTJOIE,838,400,1238,
Musée des Beaux-Arts,2018,GRAND EST,MULHOUSE,0,19341,19341,
Musée de la Poeslerie,2007,BASSE-NORMANDIE,VILLEDIEU-LES-POELES-ROUFFIGNY,5854,339,6193,
Musée du Dolder,2018,GRAND EST,RIQUEWIHR,4203,1169,5372,
Musée Artisanal et Industriel d'Instruments à Vent,2007,HAUTE-NORMANDIE,LA COUTURE-BOUSSEY,3197,1020,4217,
Musée du Papier Peint,2018,GRAND EST,RIXHEIM,6334,5928,12262,
Musée Alphonse-Georges Poulain,2007,HAUTE-NORMANDIE,VERNON,2021,7256,9277,
Musée Municipal d'Epernay,2018,GRAND EST,EPERNAY,0,720,720,
Maison des Templiers,2007,HAUTE-NORMANDIE,CAUDEBEC-EN-CAUX,726,779,1505,
Musée des Beaux-Arts de Saint-Denis,2018,GRAND EST,REIMS,47031,0,47031,
Musée d'Elbeuf,2007,HAUTE-NORMANDIE,ELBEUF,0,5526,5526,
Musée de l'Argonne Viard-Morel,2018,GRAND EST,SAINTE-MENEHOULD,1355,1110,2465,
Musée d'Art Moderne André Malraux - MuMa,2007,HAUTE-NORMANDIE,LE HAVRE,41479,18558,60037,
Musée de l'Histoire du Fer,2018,GRAND EST,JARVILLE-LA-MALGRANGE,6125,13634,19759,
Musée du Château de Lunéville,2018,GRAND EST,LUNEVILLE,37242,114559,151801,
Musée des Traditions et Arts Normands,2007,HAUTE-NORMANDIE,MARTAINVILLE-EPREVILLE,7606,9002,16608,
"Musée ""au Fil du Papier""",2018,GRAND EST,PONT-A-MOUSSON,1452,2249,3701,
Musée des Sapeurs-Pompiers de France,2007,HAUTE-NORMANDIE,MONTVILLE,5848,1944,7792,
Musée des Beaux-Arts,2007,HAUTE-NORMANDIE,ROUEN,39739,53596,93335,
Musée de la Mine - Carreau Wendel,2018,GRAND EST,PETITE-ROSSELLE,34315,12000,46315,
Musée Victor Hugo,2007,HAUTE-NORMANDIE,VILLEQUIER,4998,7923,12921,
Musée Militaire et Erckmann-Chatrian,2018,GRAND EST,PHALSBOURG,578,242,820,
Musée du Pays de Retz,2007,PAYS DE LA LOIRE,BOURGNEUF-EN-RETZ,4779,1670,6449,
Musée du Pays de Sarrebourg,2018,GRAND EST,SARREBOURG,8233,8391,16624,
"Moulin de la Blies - Musée des Techniques Faïencières (+ Jardin d'Hiver, Musée de La Faïence)",2018,GRAND EST,SARREGUEMINES,12279,20014,32293,
Muséum d'Histoire Naturelle de Nantes,2007,PAYS DE LA LOIRE,NANTES,9689,30679,40368,
Musée Départemental d'Art Ancien et Contemporain,2018,GRAND EST,EPINAL,3297,14838,18135,
Musée des Beaux-Arts de Nantes,2007,PAYS DE LA LOIRE,NANTES,24474,78940,103414,
Musée Charles Friry,2018,GRAND EST,REMIREMONT,495,1145,1640,
Maison de l'Eclusier /Parc Naturel Régional de Brière,2007,PAYS DE LA LOIRE,SAINT-MALO DE GUERSAC,4008,351,4359,
Musée Précolombien Edgar Clerc,2018,GUADELOUPE,LE MOULE,0,11030,11030,
Familistère de Guise,2018,HAUTS-DE-FRANCE,GUISE,62963,2933,65896,
Musée des Beaux-Arts Antoine Lecuyer,2018,HAUTS-DE-FRANCE,SAINT-QUENTIN,2597,9789,12386,
Musée des Sciences - CCSTI,2007,PAYS DE LA LOIRE,LAVAL,5157,28657,33814,
Musée Municipal de Soissons,2018,HAUTS-DE-FRANCE,SOISSONS,7447,8000,15447,
Musée de Tessé,2007,PAYS DE LA LOIRE,LE MANS,19374,7657,27031,
Musée du Mont-de-Piété,2018,HAUTS-DE-FRANCE,BERGUES,458,2205,2663,
Musée des Traditions de l'Île,2007,PAYS DE LA LOIRE,LA GUERINIERE,5060,348,5408,
Musée Diocésain d'Art Sacré,2018,HAUTS-DE-FRANCE,CAMBRAI,0,250,250,
Musée ornithologique Charles-Payraudeau,2007,PAYS DE LA LOIRE,LA-CHAIZE-LE-VICOMTE,12,469,481,
Musée des Dentelles et Broderies,2018,HAUTS-DE-FRANCE,CAUDRY,9641,4648,14289,
Musée de l'Abbaye de Sainte-Croix,2007,PAYS DE LA LOIRE,LES SABLES D'OLONNE,4552,16173,20725,
Musée d'Archéologie et d'Histoire Locale,2018,HAUTS-DE-FRANCE,DENAIN,0,958,958,
Musée Jean de la Fontaine,2007,PICARDIE,CHATEAU-THIERRY,6547,3632,10179,
Lieu d'Art et Action Contemporaine de Dunkerque - LAAC,2018,HAUTS-DE-FRANCE,DUNKERQUE,6121,21219,27340,
Musée - Centre de Documentation Alfred Desmasures,2007,PICARDIE,HIRSON,0,1458,1458,
Musée Portuaire,2018,HAUTS-DE-FRANCE,DUNKERQUE,30153,31744,61897,
Musée Jeanne d'Aboville,2007,PICARDIE,LA FERE,158,67,225,
Musée Municipal d'Hazebrouck,2018,HAUTS-DE-FRANCE,HAZEBROUCK,621,4638,5259,
Musée de la Résistance et de la Déportation,2007,PICARDIE,TERGNIER,3683,8332,12015,
Musée de l'Hospice Comtesse,2018,HAUTS-DE-FRANCE,LILLE,21140,34654,55794,
Musée Alexandre Dumas,2007,PICARDIE,VILLERS COTTERETS,1787,0,1787,
"LAM - Lille Métropole Musée d'Art Moderne, d'Art Contemporain et d'Art Brut",2018,HAUTS-DE-FRANCE,VILLENEUVE-D'ASCQ,86815,44957,131772,
Musée de la Vénerie,2007,PICARDIE,SENLIS,7065,0,7065,
Musée Antoine Vivenel,2018,HAUTS-DE-FRANCE,COMPIEGNE,901,13836,14737,
Musée de la Figurine Historique,2018,HAUTS-DE-FRANCE,COMPIEGNE,4431,3589,8020,
Musée de Picardie,2007,PICARDIE,AMIENS,12502,34009,46511,
Musée de la Nacre et de la Tabletterie,2018,HAUTS-DE-FRANCE,MERU,12389,4619,17008,
Musée-Historial de la Grande Guerre,2007,PICARDIE,PERONNE,6497,67533,74030,
Musée des Beaux-Arts,2018,HAUTS-DE-FRANCE,ARRAS,50902,27467,78369,
Atelier - Musée du Papier,2007,POITOU-CHARENTES,ANGOULEME,0,9718,9718,
Musée Municipal Bruno Danvin,2018,HAUTS-DE-FRANCE,SAINT-POL-SUR-TERNOISE,0,3415,3415,
Cité International de la Bande Dessinée et de l'Image - Musée de la Bande Dessinée,2007,POITOU-CHARENTES,ANGOULEME,9417,18485,27902,
Musée-Historial de la Grande Guerre,2018,HAUTS-DE-FRANCE,PERONNE,118114,13347,131461,
Musée Ernest Cognacq,2007,POITOU-CHARENTES,SAINT-MARTIN-DE-RE,10820,4741,15561,
Fondation Arp,2018,ILE-DE-FRANCE,CLAMART,1821,1185,3006,
Musée de Bressuire,2007,POITOU-CHARENTES,BRESSUIRE,0,4203,4203,
Musée Français de la Carte à Jouer,2018,ILE-DE-FRANCE,ISSY-LES-MOULINEAUX,4506,20653,25159,
Musée des Ruralies- Conservatoire du Machinisme et des Pratiques Agricoles,2007,POITOU-CHARENTES,PRAHECQ,7454,555,8009,
MUS - Musée d'Histoire Urbaine et Sociale,2018,ILE-DE-FRANCE,SURESNES,4589,6721,11310,
Musée Charbonneau-Lassay,2007,POITOU-CHARENTES,LOUDUN,178,125,303,
Musée Carnavalet-Histoire de Paris,2018,ILE-DE-FRANCE,PARIS,0,8800,8800,
Musée du Vieux Sisteron,2007,PROVENCE-ALPES-CÔTE D'AZUR,SISTERON,0,347,347,
Les Catacombes,2018,ILE-DE-FRANCE,PARIS,398400,81600,480000,
Musée archéologique,2007,PROVENCE-ALPES-CÔTE D'AZUR,VACHERES,705,0,705,
Etablissement public du musée national J.J. Henner et du musée national G. Moreau / Musée National Gustave Moreau,2018,ILE-DE-FRANCE,PARIS,20170,21557,41727,
Musée d'Histoire et d'Archéologie,2007,PROVENCE-ALPES-CÔTE D'AZUR,ANTIBES,3206,4896,8102,
Etablissement public du musée national J.J. Henner et du musée national G. Moreau/ Musée National Jean-Jacques Henner,2018,ILE-DE-FRANCE,PARIS,6549,6104,12653,
Villa-Musée Jean-Honoré Fragonard,2007,PROVENCE-ALPES-CÔTE D'AZUR,GRASSE,2725,2400,5125,
Musée de Montmartre,2018,ILE-DE-FRANCE,PARIS,94596,12524,107120,
Musée des Monuments Français,2018,ILE-DE-FRANCE,PARIS,87399,100417,187816,
Musée Archéologique - Site de Terra Amata,2007,PROVENCE-ALPES-CÔTE D'AZUR,NICE,2985,11722,14707,
Musée National Picasso,2018,ILE-DE-FRANCE,PARIS,403745,220808,624553,
Musée Départemental des Merveilles,2007,PROVENCE-ALPES-CÔTE D'AZUR,TENDE,13300,9691,22991,
Musée du Service de Santé des Armées du Val-de-Grâce,2018,ILE-DE-FRANCE,PARIS,6014,16975,22989,
Musée Picasso la guerre et la paix à Vallauris,2007,PROVENCE-ALPES-CÔTE D'AZUR,VALLAURIS,28586,11811,40397,
Musée du 11 Conti - Monnaie de Paris,2018,ILE-DE-FRANCE,PARIS,125800,44200,170000,
Musée du Parlement de Provence et du Vieil Aix,2007,PROVENCE-ALPES-CÔTE D'AZUR,AIX-EN-PROVENCE,5430,6252,11682,
Musée de l'Ecole de Barbizon - Auberge Ganne,2018,ILE-DE-FRANCE,BARBIZON,10297,9606,19903,
Musée Camarguais,2007,PROVENCE-ALPES-CÔTE D'AZUR,ARLES,15449,7304,22753,
Musée de la Gendarmerie Nationale,2018,ILE-DE-FRANCE,MELUN,10938,8392,19330,
Musée Réattu,2007,PROVENCE-ALPES-CÔTE D'AZUR,ARLES,14425,10708,25133,
Musée Départemental de Préhistoire d'Île de France,2018,ILE-DE-FRANCE,NEMOURS,1409,8143,9552,
Musée Archéologique d'Istres René Beaucaire,2007,PROVENCE-ALPES-CÔTE D'AZUR,ISTRES,3674,2755,6429,
Musée des Pays de Seine-et-Marne,2018,ILE-DE-FRANCE,SAINT-CYR-SUR-MORIN,925,9959,10884,
Musée d'Histoire et d'Archéologie des Baux-de-Provence,2007,PROVENCE-ALPES-CÔTE D'AZUR,LES BAUX DE PROVENCE,241570,26059,267629,
Musée départemental Stéphane Mallarmé,2018,ILE-DE-FRANCE,VULAINES-SUR-SEINE,861,2818,3679,
Musée Frédéric Mistral,2007,PROVENCE-ALPES-CÔTE D'AZUR,MAILLANE,2415,609,3024,
Musée d'Art et d'Histoire,2018,ILE-DE-FRANCE,SAINT-DENIS,3276,12819,16095,
"MAC VAL, Musée d'Art Contemporain du Val-de-Marne",2018,ILE-DE-FRANCE,VITRY SUR SEINE,6802,53960,60762,
Musée Cantini,2007,PROVENCE-ALPES-CÔTE D'AZUR,MARSEILLE,16724,19607,36331,
Musée Archéologique du Val d'Oise,2018,ILE-DE-FRANCE,GUIRY-EN-VEXIN,0,20612,20612,
Muséum d'Histoire Naturelle,2007,PROVENCE-ALPES-CÔTE D'AZUR,MARSEILLE,7622,36058,43680,
Musée Tavet Delacour,2018,ILE-DE-FRANCE,PONTOISE,1025,3403,4428,
Musée National de Port Royal des Champs,2018,ILE-DE-FRANCE,MAGNY-LES-HAMEAUX,4938,28871,33809,
Musée Départemental des Hautes-Alpes,2007,PROVENCE-ALPES-CÔTE D'AZUR,GAP,1723,13362,15085,
Musée Municipal,2007,PROVENCE-ALPES-CÔTE D'AZUR,DRAGUIGNAN,0,10500,10500,
Musée du Petit Palais,2007,PROVENCE-ALPES-CÔTE D'AZUR,AVIGNON,26213,7694,33907,
Musée-Maison Maurice Ravel,2018,ILE-DE-FRANCE,MONTFORT-L'AMAURY,1661,199,1860,
Musée Sobirats,2007,PROVENCE-ALPES-CÔTE D'AZUR,CARPENTRAS,276,107,383,
Musée d'Archéologie Nationale (des origines à l'an mille) - Château de st-Germain-en-Laye,2018,ILE-DE-FRANCE,SAINT-GERMAIN-EN-LAYE,20604,79805,100409,
Musée Marc Deydier,2007,PROVENCE-ALPES-CÔTE D'AZUR,CUCURON,0,4620,4620,
Collections de la Fondation de Coubertin,2018,ILE-DE-FRANCE,SAINT-REMY-LES-CHEVREUSE,1258,453,1711,
Musée-Bibliothèque François Pétrarque,2007,PROVENCE-ALPES-CÔTE D'AZUR,FONTAINE-DE-VAUCLUSE,3088,1181,4269,
Musée Régional d'Histoire et d'Ethnologie,2018,MARTINIQUE,FORT-DE-FRANCE,2412,912,3324,
Musée Municipal Camille Pautet,2007,PROVENCE-ALPES-CÔTE D'AZUR,MAZAN,0,1632,1632,
Musée des Beaux-Arts,2018,NORMANDIE,CAEN,16775,50333,67108,
Musée du Bugey-Valmorey,2007,RHONE-ALPES,LOCHIEU,3390,3130,6520,
Musée de Normandie,2018,NORMANDIE,CAEN,18726,31886,50612,
Musée du Peigne et de la Plasturgie,2007,RHONE-ALPES,OYONNAX,1872,1854,3726,
Musée Municipal Nicolas Poussin,2018,NORMANDIE,LES ANDELYS,1809,1612,3421,
Musée du Vieux Pérouges,2007,RHONE-ALPES,PEROUGES,14400,3100,17500,
Musée Municipal d'Avranches,2018,NORMANDIE,AVRANCHES,1584,2280,3864,
Musée Chintreuil,2007,RHONE-ALPES,PONT-DE-VAUX,5987,1206,7193,
Muséum Emmanuel Liais,2018,NORMANDIE,CHERBOURG-EN-COTENTIN,2215,6077,8292,
Musée Vivarois César Filhol,2007,RHONE-ALPES,ANNONAY,603,1012,1615,
Musée Municipal,2018,NORMANDIE,EQUEURDREVILLLE-HAINNEVILLE,0,2610,2610,
Musée du Rhône,2007,RHONE-ALPES,TOURNON-SUR-RHÔNE,5440,3492,8932,
Musée d'Art et d'Histoire de Granville,2018,NORMANDIE,GRANVILLE,0,36,36,
Musée Barbey d'Aurevilly,2018,NORMANDIE,SAINT-SAUVEUR-LE-VICOMTE,686,451,1137,
Musée Léon Marès,2007,RHONE-ALPES,LOVAGNY,18302,0,18302,
Musée Gallo-Romain,2007,RHONE-ALPES,AOSTE,6571,1496,8067,
Musée d'Elbeuf,2018,NORMANDIE,ELBEUF,6223,16869,23092,
Musée Hector Berlioz,2007,RHONE-ALPES,LA-COTE-SAINT-ANDRE,0,11991,11991,
Musée des Sapeurs-Pompiers de France,2018,NORMANDIE,MONTVILLE,5826,4038,9864,
Conservatoire - Musée des Industries Hydroélectriques,2007,RHONE-ALPES,VAUJANY,0,10199,10199,
Musée Le Secq des Tournelles,2018,NORMANDIE,ROUEN,90830,0,90830,
Musée Lucien Mainssieux,2007,RHONE-ALPES,VOIRON,0,1356,1356,
Musée Flaubert et d'Histoire de la Médecine,2018,NORMANDIE,ROUEN,2747,4618,7365,
Atelier - Musée du Chapeau,2007,RHONE-ALPES,CHAZELLES-SUR-LYON,10927,5025,15952,
Muséum d'Histoire Naturelle,2018,NORMANDIE,ROUEN,3052,44666,47718,
Musée National de la Marine,2018,NOUVELLE-AQUITAINE,ROCHEFORT,18859,11293,30152,
Château de la Bastie d'Urfé,2007,RHONE-ALPES,SAINT-ETIENNE-LE-MOLARD,12582,1796,14378,
Musée de Bressuire,2018,NOUVELLE-AQUITAINE,BRESSUIRE,0,3810,3810,
Musée Rural,2007,RHONE-ALPES,USSON-EN-FOREZ,5956,1080,7036,
Musée d'Art et d'Histoire Georges Turpin,2018,NOUVELLE-AQUITAINE,PARTHENAY,0,7250,7250,
Musée Barthélemy-Thimonnier,2007,RHONE-ALPES,AMPLEPUIS,2550,4649,7199,
Musée Paul Reclus,2018,NOUVELLE-AQUITAINE,DOMME,473,6746,7219,
Musée de l'Imprimerie et de la Communication Graphique,2007,RHONE-ALPES,LYON,4710,12109,16819,
Musée d'Art et d'Archéologie du Périgord (MAAP),2018,NOUVELLE-AQUITAINE,PERIGUEUX,8547,14479,23026,
Musée des Hospices Civils de Lyon,2007,RHONE-ALPES,LYON,7274,3274,10548,
Musée Gallo-Romain de Vesunna,2018,NOUVELLE-AQUITAINE,PERIGUEUX,22195,11458,33653,
Musées Gadagne,2007,RHONE-ALPES,LYON,13087,7888,20975,
Musée des Arts Décoratifs et du Design,2018,NOUVELLE-AQUITAINE,BORDEAUX,16371,40528,56899,
Musée des Sapeurs-Pompiers de Lyon,2007,RHONE-ALPES,LYON,0,5832,5832,
Musée Archéologique,2007,RHONE-ALPES,SAINT-ROMAIN-EN-GAL,17801,47664,65465,
Musée Municipal des Beaux-Arts de Limoges - Palais de l'Evêché,2018,NOUVELLE-AQUITAINE,LIMOGES,8139,20477,28616,
Musée Municipal d'Albertville-Conflans,2007,RHONE-ALPES,ALBERTVILLE,2487,1754,4241,
Musée Départemental d'Art Contemporain,2018,NOUVELLE-AQUITAINE,ROCHECHOUART,10394,5701,16095,
Muséum d'histoire naturelle,2007,RHONE-ALPES,CHAMBERY,359,579,938,
Musée de Borda,2018,NOUVELLE-AQUITAINE,DAX,5102,6921,12023,
Musée de la Poterie,2008,ALSACE,BETSCHDORF,2828,538,3366,
Musée de la Chalosse,2018,NOUVELLE-AQUITAINE,MONTFORT-EN-CHALOSSE,5852,2498,8350,
Musée de Bouxwiller et du pays de hanau,2008,ALSACE,BOUXWILLER,1442,447,1889,
Musée Municipal du Lac,2018,NOUVELLE-AQUITAINE,SANGUINET,2035,1314,3349,
Musée Alsacien,2008,ALSACE,HAGUENAU,1418,1329,2747,
Musée de Préhistoire Mésolithique Laurent Coulonges,2018,NOUVELLE-AQUITAINE,SAUVETERRE-LA-LEMANCE,2350,372,2722,
Musée Historique,2008,ALSACE,HAGUENAU,1853,3305,5158,
Musée Municipal,2018,NOUVELLE-AQUITAINE,ARUDY,997,435,1432,
Maison de l'Archéologie des Vosges du Nord,2008,ALSACE,NIEDERBRONN-LES-BAINS,1962,723,2685,
Musée National du Château,2018,NOUVELLE-AQUITAINE,PAU,56347,73046,129393,
Musée du Fer,2008,ALSACE,REICHSHOFFEN,1152,273,1425,
Musée Charbonneau-Lassay,2018,NOUVELLE-AQUITAINE,LOUDUN,0,2019,2019,
Musée du Château des Rohan,2008,ALSACE,SAVERNE,8431,5370,13801,
Collection d'Histoire Naturelle,2018,NOUVELLE-AQUITAINE,POITIERS,22000,49000,71000,
Musée des Beaux-Arts,2008,ALSACE,STRASBOURG,11950,34533,46483,
Musée du Textile et du Peigne en Corne,2018,OCCITANIE,LAVELANET,1743,711,2454,
Cabinet des Estampes et des Dessins,2008,ALSACE,STRASBOURG,2720,5969,8689,
Musée de la Préhistoire,2018,OCCITANIE,LE MAS D'AZIL,32526,2914,35440,
Musée d'Archéologie,2018,OCCITANIE,MONTSEGUR,15029,0,15029,
Musée de la Bataille du 6 Août 1870,2008,ALSACE,WOERTH,2646,817,3463,
Musée Fenaille,2018,OCCITANIE,RODEZ,22436,8462,30898,
Musée du Tabac,2008,AQUITAINE,BERGERAC,2774,1590,4364,
Musée Soulages,2018,OCCITANIE,RODEZ,83164,28322,111486,
Musée des Arts et Métiers Traditionnels,2018,OCCITANIE,SALLES-LA-SOURCE,4029,2410,6439,
Musée-Bibliothèque Pierre-André Benoît,2018,OCCITANIE,ALES,3138,9569,12707,
Musée Léon Alègre,2018,OCCITANIE,BAGNOLS-SUR-CEZE,0,1324,1324,
Musée d'Aquitaine,2008,AQUITAINE,BORDEAUX,8975,102249,111224,
Musée du Vieux Nîmes,2018,OCCITANIE,NIMES,7527,4185,11712,
Muséum d'Histoire Naturelle de Bordeaux,2008,AQUITAINE,BORDEAUX,2486,37250,39736,
Musée de la Romanité,2018,OCCITANIE,NIMES,144297,25773,170070,
Musée des Arts Décoratifs,2008,AQUITAINE,BORDEAUX,7544,28897,36441,
Carré d'Art Musée d'Art Contemporain de Nîmes,2018,OCCITANIE,NIMES,15086,15323,30409,
CAPC Musée d'Art Contemporain de Bordeaux,2008,AQUITAINE,BORDEAUX,27090,83050,110140,
Musée Municipal Georges Borias,2018,OCCITANIE,UZES,1394,1996,3390,
Centre National Jean Moulin,2008,AQUITAINE,BORDEAUX,0,22484,22484,
Musée des Amériques,2018,OCCITANIE,AUCH,580,1015,1595,
Musée de l'Armagnac,2018,OCCITANIE,CONDOM,1264,437,1701,
Musée Historique de l'Hydravion,2008,AQUITAINE,BISCARROSSE,21021,1689,22710,
Musée Archéologique,2018,OCCITANIE,EAUZE,6823,2437,9260,
Musée de Borda,2008,AQUITAINE,DAX,2763,7139,9902,
Musée des Beaux-Arts et des Arts Décoratifs,2018,OCCITANIE,MIRANDE,0,2171,2171,
Musée du Pays de Luchon,2018,OCCITANIE,BAGNERES-DE-LUCHON,718,345,1063,
Musée du Liège et du Bouchon,2008,AQUITAINE,MEZIN,7733,154,7887,
Musée Municipal,2018,OCCITANIE,MARTRES-TOLOSANE,0,2696,2696,
Musée Basque et de l'Histoire de Bayonne,2008,AQUITAINE,BAYONNE,21050,12336,33386,
Musée Archéologique Départemental,2018,OCCITANIE,SAINT-BERTRAND-DE-COMMINGES,0,9237,9237,
Musée Charles-Louis Philippe,2008,AUVERGNE,CERILLY,363,17,380,
Le Musée - Arts et Figures des Pyrénées Centrales,2018,OCCITANIE,SAINT-GAUDENS,211,887,1098,
Musée Municipal de Souvigny,2008,AUVERGNE,SOUVIGNY,5862,2103,7965,
Musée du Vieux Toulouse,2018,OCCITANIE,TOULOUSE,6068,1004,7072,
Musée d'Art et d'Archéologie,2008,AUVERGNE,AURILLAC,1227,15127,16354,
Musée du Biterrois,2018,OCCITANIE,BEZIERS,416,1196,1612,
Musée des Manufactures de Dentelles,2008,AUVERGNE,RETOURNAC,5201,2398,7599,
Site Archéologique Lattara - Musée Henri Prades de Montpellier Agglomération,2018,OCCITANIE,LATTES,10968,10618,21586,
Musée Départemental de la Céramique Gallo-Romaine,2008,AUVERGNE,LEZOUX,12110,7062,19172,
Maison des Consuls - Musée d’Arts et d’Archéologie,2018,OCCITANIE,LES MATELLES,1918,1633,3551,
Musée des Pénitents Blancs,2008,AUVERGNE,MARSAC-EN-LIVRADOIS,145,20,165,
Musée de Lodève - Hôtel du cardinal de Fleury,2018,OCCITANIE,LODEVE,24121,5166,29287,
Musée Paléontologique,2008,AUVERGNE,MENAT,765,95,860,
Musée Louis Médard,2018,OCCITANIE,LUNEL,0,6929,6929,
Musée des Beaux-Arts,2008,BOURGOGNE,BEAUNE,7040,2440,9480,
Musée du Pays Châtillonnais - Trésor de Vix,2008,BOURGOGNE,CHATILLON-SUR-SEINE,11191,2957,14148,
Musée Paul Valéry,2018,OCCITANIE,SETE,42844,7444,50288,
Musée d'Art Sacré,2008,BOURGOGNE,DIJON,0,7137,7137,
Muséum - Jardin des Sciences,2008,BOURGOGNE,DIJON,8752,111045,119797,
Musée d'Histoire de Figeac,2018,OCCITANIE,FIGEAC,347,608,955,
Musée Magnin,2008,BOURGOGNE,DIJON,2485,14146,16631,
"Musée Archéologique ""Armand-Viré""",2018,OCCITANIE,LUZECH,319,203,522,
Musée Noisot,2008,BOURGOGNE,FIXIN,328,275,603,
Musée Gallo-Romain d'Uxellodunum,2018,OCCITANIE,MARTEL,310,305,615,
Musée des Arts et Traditions des Hautes-Côtes,2008,BOURGOGNE,GEVREY-CHAMBERTIN - Reulle Vergy,80,2550,2630,
Musée de l'Automate,2018,OCCITANIE,SOUILLAC,10780,2021,12801,
Muséum d'Histoire Naturelle,2018,OCCITANIE,PERPIGNAN,0,17786,17786,
Musée Municipal,2008,BOURGOGNE,NUITS-SAINT-GEORGES,394,2097,2491,
Musée du Castillet Casa Pairal,2018,OCCITANIE,PERPIGNAN,11333,16998,28331,
Musée de Tautavel,2018,OCCITANIE,TAUTAVEL,44548,8500,53048,
Musée Jean Jaurès,2018,OCCITANIE,CASTRES,2550,12677,15227,
Musée Denon,2008,BOURGOGNE,CHALON-SUR-SAONE,1082,12380,13462,
Musée Goya,2018,OCCITANIE,CASTRES,18729,6259,24988,
Musée d'Art et d'Archéologie,2008,BOURGOGNE,CLUNY,81246,19521,100767,
Musée Charles Portal - Histoire et Patrimoine,2018,OCCITANIE,CORDES-SUR-CIEL,690,366,1056,
Musée des Ursulines,2008,BOURGOGNE,MACON,2248,13947,16195,
Muséum d'histoire naturelle Philadelphe Thomas,2018,OCCITANIE,GAILLAC,1098,2314,3412,
Musée de la Tour du Moulin,2008,BOURGOGNE,MARCIGNY,647,652,1299,
Musée de l'Abbaye Saint-Michel,2018,OCCITANIE,GAILLAC,1640,685,2325,
Musée Départemental de Préhistoire de Solutré,2008,BOURGOGNE,SOLUTRE-POUILLY,15283,13329,28612,
Musée Joseph Denais,2018,PAYS DE LA LOIRE,BEAUFORT-EN-VALLEE,6008,2827,8835,
Hôtel Dieu - Musée Greuze,2008,BOURGOGNE,TOURNUS,7354,2323,9677,
Musée de la Vigne et du Vin d'Anjou,2018,PAYS DE LA LOIRE,SAINT LAMBERT-DU-LATTAY - VAL-DU-LAYON,3230,877,4107,
Musée d'Art et d'Histoire,2008,BOURGOGNE,AUXERRE,9134,20741,29875,
Musée du Château de Mayenne,2018,PAYS DE LA LOIRE,MAYENNE,7852,12769,20621,
Musée de l'Avallonnais Jean Després,2008,BOURGOGNE,AVALLON,0,8263,8263,
Musée Vert Véron-de-Forbonnais,2018,PAYS DE LA LOIRE,LE MANS,16148,10765,26913,
Musée Colette,2008,BOURGOGNE,SAINT-SAUVEUR-EN-PUISAYE,7130,427,7557,
Musée Clémenceau et de Lattre de Tassigny,2018,PAYS DE LA LOIRE,MOUILLERON-EN-PAREDS,4372,4969,9341,
Musée d'Art et d'Histoire du Puisaye,2008,BOURGOGNE,VILLIERS-SAINT-BENOIT,1527,423,1950,
Musée Milcendeau Jean-Yole,2018,PAYS DE LA LOIRE,SOULLANS,2290,517,2807,
Musée Mathurin Meheut,2008,BRETAGNE,LAMBALLE,7352,1305,8657,
Musée départemental de préhistoire,2018,PROVENCE-ALPES-CÔTE D'AZUR,QUINSON,62629,11994,74623,
Ecomusée des Monts d'Arrée - Maison Cornec,2008,BRETAGNE,RIVOAL,4749,2297,7046,
Musée Gallo-Romain Sisteron,2018,PROVENCE-ALPES-CÔTE D'AZUR,SISTERON,0,11989,11989,
Musée de Morlaix,2008,BRETAGNE,MORLAIX,17036,17374,34410,
Musée Renoir,2018,PROVENCE-ALPES-CÔTE D'AZUR,CAGNES-SUR-MER,22922,13968,36890,
Ecomusée d'Ouessant - Vivre sur une Ile,2008,BRETAGNE,OUESSANT,6783,3931,10714,
Musée d'Art et d'Histoire de Provence,2018,PROVENCE-ALPES-CÔTE D'AZUR,GRASSE,3697,6434,10131,
Musée de Pont-Aven,2008,BRETAGNE,PONT-AVEN,34116,9459,43575,
Musée Départemental Breton,2008,BRETAGNE,QUIMPER,24903,20208,45111,
Musée de Préhistoire Régionale,2018,PROVENCE-ALPES-CÔTE D'AZUR,MENTON,1974,7842,9816,
Musée d'Histoire de la Ville de Saint-Malo,2008,BRETAGNE,SAINT-MALO,19657,7698,27355,
Musée Départemental des Arts Asiatiques,2018,PROVENCE-ALPES-CÔTE D'AZUR,NICE,3186,47035,50221,
Musée International du Long-Cours Cap-Hornier,2008,BRETAGNE,SAINT-MALO,7250,3462,10712,
Musée d'Art Naïf Anatole Jakovsky,2018,PROVENCE-ALPES-CÔTE D'AZUR,NICE,1824,5756,7580,
Musée Saint-Nicolas,2008,BRETAGNE,VITRE,1395,565,1960,
Musée des Beaux-Arts Jules Chéret,2018,PROVENCE-ALPES-CÔTE D'AZUR,NICE,12493,11679,24172,
Ecomusée de Saint-Dégan,2008,BRETAGNE,BREC'H,11790,2937,14727,
Musée du Palais Lascaris,2018,PROVENCE-ALPES-CÔTE D'AZUR,NICE,20078,32797,52875,
Musée de la Compagnie des Indes,2008,BRETAGNE,PORT-LOUIS,39118,19194,58312,
Musée Archéologique - Site de Terra Amata,2018,PROVENCE-ALPES-CÔTE D'AZUR,NICE,15770,2657,18427,
Musée National du Sport,2018,PROVENCE-ALPES-CÔTE D'AZUR,NICE,25840,35808,61648,
Musée des Arts Décoratifs,2008,CENTRE,BOURGES,0,14480,14480,
Musée du Parlement de Provence et du Vieil Aix,2018,PROVENCE-ALPES-CÔTE D'AZUR,AIX-EN-PROVENCE,4734,8653,13387,
Musée des Meilleurs Ouvriers de France,2008,CENTRE,BOURGES,0,22818,22818,
Musée- Atelier de Paul Cézanne,2018,PROVENCE-ALPES-CÔTE D'AZUR,AIX-EN-PROVENCE,72881,6239,79120,
Musée d'Histoire Naturelle Gabriel Foucher,2008,CENTRE,BOURGES,12397,24870,37267,
Muséon Arlaten,2018,PROVENCE-ALPES-CÔTE D'AZUR,ARLES,0,1893,1893,
Musée Saint-Vic,2008,CENTRE,SAINT-AMAND-MONTROND,564,1390,1954,
Musée d'Histoire et d'Archéologie des Baux-de-Provence,2018,PROVENCE-ALPES-CÔTE D'AZUR,LES BAUX DE PROVENCE,0,100000,100000,
Musée Municipal,2008,CENTRE,VIERZON,0,2176,2176,
Fondation Louis Jou,2018,PROVENCE-ALPES-CÔTE D'AZUR,LES-BAUX-DE-PROVENCE,0,1100,1100,
Conservatoire du Machinisme et des Pratiques Agricoles,2008,CENTRE,CHARTRES-MAINVILLIERS,11327,38783,50110,
Musée d'Histoire de Marseille,2018,PROVENCE-ALPES-CÔTE D'AZUR,MARSEILLE,25790,41839,67629,
Musée des Civilisations de l'Europe et de la Méditerranée - MuCem,2018,PROVENCE-ALPES-CÔTE D'AZUR,MARSEILLE,306123,243787,549910,
"Musée des Arts décoratifs, de la Faïence et de la Mode",2018,PROVENCE-ALPES-CÔTE D'AZUR,MARSEILLE,10405,22127,32532,
Musée François Rabelais,2008,CENTRE,SEUILLY,8253,4970,13223,
Muséum d'Histoire Naturelle,2008,CENTRE,TOURS,9641,14650,24291,
Musée des A.T.P. de Moyenne Provence,2018,PROVENCE-ALPES-CÔTE D'AZUR,DRAGUIGNAN,1713,9930,11643,
Musée du Gatinais,2008,CENTRE,MONTARGIS,213,132,345,
Musée des Troupes de Marine,2018,PROVENCE-ALPES-CÔTE D'AZUR,FREJUS,0,17600,17600,
Musée Comtadin-Duplessis,2018,PROVENCE-ALPES-CÔTE D'AZUR,CARPENTRAS,0,3764,3764,
Musée Municipal,2008,CHAMPAGNE-ARDENNES,BOURBONNE-LES-BAINS,0,2409,2409,
Musée d'Art et d'Histoire,2008,CHAMPAGNE-ARDENNES,LANGRES,8318,0,8318,
Musée de l'Hôtel Dieu,2018,PROVENCE-ALPES-CÔTE D'AZUR,CAVAILLON,232,963,1195,
Musée Hôtel le Vergeur,2008,CHAMPAGNE-ARDENNES,REIMS,6202,4720,10922,
Musée Municipal,2018,PROVENCE-ALPES-CÔTE D'AZUR,ORANGE,50679,998,51677,
Musée des Beaux-Arts de Saint-Denis,2008,CHAMPAGNE-ARDENNES,REIMS,9684,28181,37865,
Musée Départemental du Cartonnage et de l'Imprimerie,2018,PROVENCE-ALPES-CÔTE D'AZUR,VALREAS,2367,1822,4189,
Musée du Peigne et de la Plasturgie,2019,AUVERGNE-RHONE-ALPES,OYONNAX,1596,2086,3682,M0969
Musée de l'Alta Rocca,2008,CORSE,LEVIE,9286,5480,14766,
Cité de Préhistoire,2019,AUVERGNE-RHONE-ALPES,ORGNAC-L'AVEN,127753,12392,140145,M0978
Musée d'archéologie d'Aleria - Jérôme Carcopino,2008,CORSE,ALERIA,27025,19812,46837,
Musée du Rhône,2019,AUVERGNE-RHONE-ALPES,TOURNON-SUR-RHÔNE,20081,8769,28850,M0981
Musée de la Corse,2008,CORSE,CORTE,52711,8814,61525,
Musée de Paléontologie,2019,AUVERGNE-RHONE-ALPES,CHILHAC,1732,0,1732,M7031
Musée Départemental Albert-et-Félicie Demard - ATP,2008,FRANCHE-COMTE,CHAMPLITTE,6100,7308,13408,
Musée Sarret de Grozon,2008,FRANCHE-COMTE,ARBOIS,0,1315,1315,
Musée-château d'Annecy,2019,AUVERGNE-RHONE-ALPES,ANNECY,83920,75306,159226,M1052
Musée des Beaux-Arts,2008,FRANCHE-COMTE,LONS-LE-SAUNIER,1222,4503,5725,
"Notre histoire, Musée de Rumilly",2019,AUVERGNE-RHONE-ALPES,RUMILLY,2142,1295,3437,M1055
Musée des Salines,2008,FRANCHE-COMTE,SALINS-LES-BAINS,39321,5268,44589,
Musée de la Grande Chartreuse,2019,AUVERGNE-RHONE-ALPES,SAINT-PIERRE-DE-CHARTREUSE,34458,2306,36764,M1004
Musée Frédéric Japy,2008,FRANCHE-COMTE,BEAUCOURT,1365,1740,3105,
Atelier - Musée du Chapeau,2019,AUVERGNE-RHONE-ALPES,CHAZELLES-SUR-LYON,17610,2427,20037,M1012
Musée d'Art et d'Histoire,2008,FRANCHE-COMTE,BELFORT,3090,15228,18318,
Musée de Feurs,2019,AUVERGNE-RHONE-ALPES,FEURS,546,574,1120,M1014
Musée des Beaux-Arts et d'Archéologie J. Dechelette,2019,AUVERGNE-RHONE-ALPES,ROANNE,9588,6029,15617,M1020
Musée Précolombien Edgar Clerc,2008,GUADELOUPE,LE MOULE,0,8092,8092,
Musée Barthélemy-Thimonnier,2019,AUVERGNE-RHONE-ALPES,AMPLEPUIS,2369,1202,3571,M1140
Musée Municipal Saint-John Perse,2008,GUADELOUPE,POINTE-A-PITRE,3515,202,3717,
Musée des Sapeurs-Pompiers de Lyon,2019,AUVERGNE-RHONE-ALPES,LYON,5030,6453,11483,M1128
Musée des Cultures Guyanaises,2008,GUYANE,CAYENNE,1382,6118,7500,
Musée des Beaux-Arts,2019,BOURGOGNE-FRANCHE-COMTE,BEAUNE,5898,3932,9830,M0134
Musée des Automates,2008,ILE-DE-FRANCE,NEUILLY-SUR-SEINE,346,1971,2317,
Muséum d'Histoire Naturelle - Jardin des Sciences,2019,BOURGOGNE-FRANCHE-COMTE,DIJON,12617,119308,131925,M7035
Musée Archéologique,2019,BOURGOGNE-FRANCHE-COMTE,DIJON,0,24824,24824,M0138
Grande Galerie de l'Evolution (Muséum National d'Histoire Naturelle),2008,ILE-DE-FRANCE,PARIS,492296,196867,689163,
Musée Municipal,2019,BOURGOGNE-FRANCHE-COMTE,NUITS-SAINT-GEORGES,47,4420,4467,M0144
Galerie d'Anatomie Comparée et de Paléontologie (Muséum d'Histoire Naturelle),2008,ILE-DE-FRANCE,PARIS,224304,56137,280441,
Musée des Beaux-Arts et d'Archéologie,2019,BOURGOGNE-FRANCHE-COMTE,BESANCON,29834,75625,105459,M0332
Musée de Plein Air des Maisons Comtoises,2019,BOURGOGNE-FRANCHE-COMTE,NANCRAY,28848,14021,42869,M0338
Musée National des Arts et des Traditions Populaires (MuCem),2008,ILE-DE-FRANCE,PARIS,10734,0,10734,
Ecomusée du Pays de la Cerise,2019,BOURGOGNE-FRANCHE-COMTE,FOUGEROLLES-SAINT-VALBERT,6930,3670,10600,M0356
Musée National de la Marine,2008,ILE-DE-FRANCE,PARIS,174541,68742,243283,
Musée Sarret de Grozon,2019,BOURGOGNE-FRANCHE-COMTE,ARBOIS,422,1120,1542,M0341
Musée Bourdelle,2008,ILE-DE-FRANCE,PARIS,29834,32574,62408,
Musée Municipal d'Archéologie,2019,BOURGOGNE-FRANCHE-COMTE,CHAMPAGNOLE,943,222,1165,M0344
Musée de la Franc-Maçonnerie,2008,ILE-DE-FRANCE,PARIS,900,2600,3500,
Musée des Beaux-Arts et d'Archéologie,2019,BOURGOGNE-FRANCHE-COMTE,DOLE,0,21206,21206,M0347
Musée National Auguste Rodin,2008,ILE-DE-FRANCE,PARIS,519032,235931,754963,
Musée du Septennat,2019,BOURGOGNE-FRANCHE-COMTE,CHATEAU-CHINON (Ville),5241,1229,6470,M0149
"Musée Cognacq-Jay, Musée du XVIIIe siècle de la ville de Paris",2008,ILE-DE-FRANCE,PARIS,9034,32269,41303,
"Musée Cernuschi, Musée des Arts de l'Asie de la ville de Paris",2008,ILE-DE-FRANCE,PARIS,28812,43825,72637,
Musée du Grès de Puisaye,2019,BOURGOGNE-FRANCHE-COMTE,SAINT-AMAND-EN-PUISAYE,2313,0,2313,M0158
Musée National Picasso,2008,ILE-DE-FRANCE,PARIS,229337,113413,342750,
Musée Rolin,2019,BOURGOGNE-FRANCHE-COMTE,AUTUN,11502,9392,20894,M0161
Musée René Davoine,2019,BOURGOGNE-FRANCHE-COMTE,CHAROLLES,0,133,133,M0167
Musée National du Sport,2008,ILE-DE-FRANCE,PARIS,1548,1539,3087,
Musée du Prieuré de Charolles,2019,BOURGOGNE-FRANCHE-COMTE,CHAROLLES,1382,2046,3428,M0168
Musée National des Techniques,2008,ILE-DE-FRANCE,PARIS,52074,180384,232458,
Musée d'Art et d'Archéologie,2019,BOURGOGNE-FRANCHE-COMTE,CLUNY,31714,0,31714,M0169
Musée du Quai Branly,2008,ILE-DE-FRANCE,PARIS,767130,622360,1389490,
Musée du Terroir,2019,BOURGOGNE-FRANCHE-COMTE,ROMENAY,1881,0,1881,M0179
Musée Municipal de Chelles Alfred Bonno,2008,ILE-DE-FRANCE,CHELLES,0,3089,3089,
Musée Greuze - Hôtel Dieu,2019,BOURGOGNE-FRANCHE-COMTE,TOURNUS,6033,2623,8656,M0181
Musée Bossuet,2008,ILE-DE-FRANCE,MEAUX,2706,7231,9937,
Musée d'Art et d'Histoire,2019,BOURGOGNE-FRANCHE-COMTE,BELFORT,3896,19968,23864,M0361
Musée d'Art et d'Histoire de Melun,2008,ILE-DE-FRANCE,MELUN,1100,4700,5800,
Cabinet d'un Amateur - Donation Maurice Jardot,2019,BOURGOGNE-FRANCHE-COMTE,BELFORT,1250,8385,9635,M1075
Musée d'Art et d'Histoire,2008,ILE-DE-FRANCE,SAINT-DENIS,2698,29155,31853,
Musée de l'Avallonnais Jean Després,2019,BOURGOGNE-FRANCHE-COMTE,AVALLON,1786,2686,4472,M0186
Musée de l'Aventure du Son,2019,BOURGOGNE-FRANCHE-COMTE,SAINT-FARGEAU,2998,0,2998,M1189
Musée Tavet Delacour,2008,ILE-DE-FRANCE,PONTOISE,2783,4902,7685,
Musée Colette,2019,BOURGOGNE-FRANCHE-COMTE,SAINT-SAUVEUR-EN-PUISAYE,5660,1204,6864,M0188
Musée Rambolitrain,2008,ILE-DE-FRANCE,RAMBOUILLET,14515,1634,16149,
Musée d'Art et d'Histoire - Ensemble monumental de Narbonne,2008,LANGUEDOC-ROUSSILLON,NARBONNE,372773,0,372773,
Musée National de la Marine,2019,BRETAGNE,BREST,40204,40096,80300,M5026
Musée de l'Ancienne Abbaye de Landévennec,2019,BRETAGNE,LANDEVENNEC,24353,3276,27629,M1200
Musée du Colombier,2008,LANGUEDOC-ROUSSILLON,ALES,0,13572,13572,
Musée de Morlaix,2019,BRETAGNE,MORLAIX,9048,2910,11958,M0202
Musée Cévenol,2008,LANGUEDOC-ROUSSILLON,LE VIGAN,2374,2083,4457,
Musée Départemental Breton,2019,BRETAGNE,QUIMPER,18819,40998,59817,M0208
Musée du Vieux Nîmes,2008,LANGUEDOC-ROUSSILLON,NIMES,0,24534,24534,
Musée des Beaux-Arts,2019,BRETAGNE,RENNES,26175,82887,109062,M0211
Musée des Beaux-Arts de Béziers,2008,LANGUEDOC-ROUSSILLON,BEZIERS,6334,8994,15328,
Ecomusée de Saint-Dégan,2019,BRETAGNE,BRECH,8276,3046,11322,M0220
Musée Estève,2019,CENTRE-VAL DE LOIRE,BOURGES,7290,1878,9168,M0231
Musée de l'Ephèbe,2008,LANGUEDOC-ROUSSILLON,LE CAP D'AGDE,11024,1924,12948,
Musée des Arts Décoratifs,2019,CENTRE-VAL DE LOIRE,BOURGES,7488,3758,11246,M0229
Musée Archéologique,2008,LANGUEDOC-ROUSSILLON,MINERVE,4107,0,4107,
Musée d'Histoire Naturelle Gabriel Foucher,2019,CENTRE-VAL DE LOIRE,BOURGES,20184,15370,35554,M7028
Musée Fabre,2008,LANGUEDOC-ROUSSILLON,MONTPELLIER,171618,131553,303171,
Château Musée,2019,CENTRE-VAL DE LOIRE,AZAY-LE-FERRON,13300,1090,14390,M0246
Musées de Châteauroux - Hôtel Bertrand,2019,CENTRE-VAL DE LOIRE,CHATEAUROUX,1995,8884,10879,M0247
Musée d'Art Moderne - Fonds Peskè,2008,LANGUEDOC-ROUSSILLON,COLLIOURE,7396,1673,9069,
Musée Lansyer,2019,CENTRE-VAL DE LOIRE,LOCHES,4114,2183,6297,M0260
Ecomusée du Véron,2019,CENTRE-VAL DE LOIRE,SAVIGNY-EN-VERON,4958,6846,11804,M1088
Musée du Castillet Casa Pairal,2008,LANGUEDOC-ROUSSILLON,PERPIGNAN,6553,19406,25959,
Musée du Président Jacques Chirac,2008,LIMOUSIN,SARRAN,35661,5385,41046,
Musée Gaston Couté,2019,CENTRE-VAL DE LOIRE,MEUNG-SUR-LOIRE,0,2439,2439,M0283
Musée d'Art et d'Archéologie,2008,LIMOUSIN,GUERET,4799,5318,10117,
Musée d'archéologie d'Aleria - Jérôme Carcopino,2019,CORSE,ALERIA,29803,9277,39080,M0328
Musée René Baubérot,2008,LIMOUSIN,CHATEAUPONSAC,3067,613,3680,
Musée de la Maison de la Dernière Cartouche,2019,GRAND EST,BAZEILLES,1449,1716,3165,M0290
Musée de l'Evêché,2008,LIMOUSIN,LIMOGES,0,7291,7291,
Musée Départemental d'Art Contemporain,2008,LIMOUSIN,ROCHECHOUART,6205,5330,11535,
Musée de la Folie Marco,2019,GRAND EST,BARR,1104,2100,3204,M0001
Les Sources d'Hercule,2008,LORRAINE,DENEUVRE,3047,952,3999,
Musée Historique,2019,GRAND EST,HAGUENAU,3133,1697,4830,M0005
Musée de la Chartreuse,2019,GRAND EST,MOLSHEIM,5521,1238,6759,M0006
Palais des ducs de Lorraine - Musée Historique Lorrain,2008,LORRAINE,NANCY,23769,33405,57174,
Maison de l'Archéologie des Vosges du Nord,2019,GRAND EST,NIEDERBRONN-LES-BAINS,1732,699,2431,M0008
"Musée ""au Fil du Papier""",2008,LORRAINE,PONT-A-MOUSSON,3103,2258,5361,
Musée de l'Image Populaire de Pfaffenhoffen,2019,GRAND EST,PFAFFENHOFFEN,1041,2519,3560,M0010
Musée de la Princerie,2008,LORRAINE,VERDUN,2302,1998,4300,
Musée des Beaux-Arts et d'Archéologie,2019,GRAND EST,CHAUMONT,2496,3204,5700,M0319
Musées de la Cour d'Or,2008,LORRAINE,METZ,10567,26825,37392,
Musée Gallo-Romain,2019,GRAND EST,BIESHEIM,610,1713,2323,M0025
Moulin de la Blies - Musée des Techniques Faïencières,2008,LORRAINE,SARREGUEMINES,3930,5569,9499,
Musée Bartholdi,2019,GRAND EST,COLMAR,17766,9567,27333,M0027
Musée de l'Image,2008,LORRAINE,EPINAL,22258,7003,29261,
Muséum d'Histoire Naturelle et d'Ethnographie de Colmar,2019,GRAND EST,COLMAR,10793,7432,18225,M7033
Musée Pierre Noël - Musée de la Vie dans les Hautes-Vosges,2008,LORRAINE,SAINT-DIE-DES-VOSGES,4870,11266,16136,
Musée Théodore Deck et des Pays du Florival,2019,GRAND EST,GUEBWILLER,1334,2386,3720,M0029
Ecomusée de la Martinique,2008,MARTINIQUE,RIVIERE-PILOTE,6327,2716,9043,
Musée Historique et Militaire de Huningue,2019,GRAND EST,HUNINGUE,310,210,520,M0030
Musée Départemental de l'Ariège,2008,MIDI-PYRENEES,FOIX,77902,6195,84097,
Musée d'Histoire Local,2019,GRAND EST,KAYSERSBERG VIGNOBLE,0,2065,2065,M0031
Musée Régional de Géologie Pierre Vetter,2008,MIDI-PYRENEES,DECAZEVILLE,1601,2888,4489,
Musée National de l'Automobile - Collection Schlumpf,2019,GRAND EST,MULHOUSE,181924,24157,206081,M0035
Musée du Charroi Rural et de l'Artisanat Traditionnel,2008,MIDI-PYRENEES,SALMIECH,0,2812,2812,
Musée du Papier Peint,2019,GRAND EST,RIXHEIM,7793,6407,14200,M0044
Musée Municipal Urbain Cabrol,2008,MIDI-PYRENEES,VILLEFRANCHE-DE-ROUERGUE,0,4459,4459,
Ecomusée d'Alsace,2019,GRAND EST,UNGERSHEIM,149685,30247,179932,M0048
Musée de l'Armagnac,2008,MIDI-PYRENEES,CONDOM,3703,365,4068,
Musée Municipal,2019,GRAND EST,CHÂLONS-EN-CHAMPAGNE,1412,9392,10804,M0307
Muséum d'Histoire Naturelle,2008,MIDI-PYRENEES,TOULOUSE,187888,141325,329213,
Musée Garinet,2019,GRAND EST,CHÂLONS-EN-CHAMPAGNE,406,707,1113,M0308
Musée des Transports et des Communications,2008,MIDI-PYRENEES,TOULOUSE,0,840,840,
"Les Abattoirs, Musée d'Art Moderne et Contemporain",2008,MIDI-PYRENEES,TOULOUSE,35100,79819,114919,
Musée des Beaux-Arts de Saint-Denis,2019,GRAND EST,REIMS,42423,0,42423,M0311
Musée Champollion - Les Ecriture du Monde,2008,MIDI-PYRENEES,FIGEAC,34199,11990,46189,
Musée de l'Argonne Viard-Morel,2019,GRAND EST,SAINTE-MENEHOULD,1810,947,2757,M0315
Musée du Château de Lunéville,2019,GRAND EST,LUNEVILLE,15868,153469,169337,M0511
Musée des arts et traditions populaires,2008,MIDI-PYRENEES,MOISSAC,3715,940,4655,
Musée Barrois,2019,GRAND EST,BAR-LE-DUC,2552,6383,8935,M0517
"Forum Antique de Bavay, Musée Archéologique du Département du Nord",2008,NORD-PAS-DE-CALAIS,BAVAY,5017,23160,28177,
Musée de la Céramique et de l'Ivoire,2019,GRAND EST,COMMERCY,2110,500,2610,M0518
Musée Jules Bastien-Lepage - Musée de la Fortification,2019,GRAND EST,MONTMEDY,9137,2519,11656,M0519
Musée Départemental Matisse,2008,NORD-PAS-DE-CALAIS,LE CATEAU-CAMBRESIS,22535,46882,69417,
Musée de la Bière et du Pays de Stenay,2019,GRAND EST,STENAY,6648,15856,22504,M0522
Musée d'Histoire Locale de Marchiennes,2008,NORD-PAS-DE-CALAIS,MARCHIENNES,394,420,814,
Musée Départemental de la Guerre de 70,2019,GRAND EST,GRAVELOTTE,8527,8912,17439,M0526
Musée des Beaux-Arts,2008,NORD-PAS-DE-CALAIS,VALENCIENNES,85583,0,85583,
Musées de la Cour d'Or,2019,GRAND EST,METZ,29382,61866,91248,M0529
Musée d'Art Moderne de Lille Métropole,2008,NORD-PAS-DE-CALAIS,VILLENEUVE-D'ASCQ,9186,24079,33265,
Musée du Pays de Sarrebourg,2019,GRAND EST,SARREBOURG,9005,7716,16721,M0532
Musée Baron Gérard,2008,BASSE-NORMANDIE,BAYEUX,10368,14970,25338,
Musée de l'Image,2019,GRAND EST,EPINAL,9125,5738,14863,M0537
Mémorial de Caen,2008,BASSE-NORMANDIE,CAEN,345836,46392,392228,
Musée Pierre Noël - Musée de la Vie dans les Hautes-Vosges,2019,GRAND EST,SAINT-DIE-DES-VOSGES,13938,2889,16827,M0542
Musée Eugène Boudin,2008,BASSE-NORMANDIE,HONFLEUR,29379,1033,30412,
Musée Municipal de Soissons,2019,HAUTS-DE-France,SOISSONS,5814,1885,7699,M0794
Musée d'Art et d'Histoire de Lisieux,2008,BASSE-NORMANDIE,LISIEUX,709,2248,2957,
Musée de La Thiérache,2019,HAUTS-DE-France,VERVINS,0,5634,5634,M0795
Musée et Sites archéologiques de Vieux-la-Romaine,2008,BASSE-NORMANDIE,VIEUX,3783,14398,18181,
Musée de l'Ostrevant,2019,HAUTS-DE-France,BOUCHAIN,149,545,694,M0614
Musée Paléontologique,2008,BASSE-NORMANDIE,VILLERS-SUR-MER,0,33446,33446,
Musée Municipal de Cambrai,2019,HAUTS-DE-France,CAMBRAI,1422,9301,10723,M0615
Musée de l'Abbaye,2008,BASSE-NORMANDIE,CERISY-LA-FORET,5311,748,6059,
Ecomusée de la Région,2019,HAUTS-DE-France,FOURMIES-TRELON,22058,7291,29349,M0624
Musée Barbey d'Aurevilly,2008,BASSE-NORMANDIE,SAINT-SAUVEUR-LE-VICOMTE,4036,567,4603,
Palais des Beaux-Arts de Lille,2019,HAUTS-DE-France,LILLE,114150,183460,297610,M0629
Musée de la Poeslerie,2008,BASSE-NORMANDIE,VILLEDIEU-LES-POELES-ROUFFIGNY,5143,216,5359,
MUba - Musée des Beaux-Arts Eugène Leroy de Tourcoing,2019,HAUTS-DE-France,TOURCOING,31886,13024,44910,M0637
Musée Municipal - Musée du Jouet,2008,BASSE-NORMANDIE,LA FERTE-MACE,743,296,1039,
MUDO - Musée de l'Oise,2019,HAUTS-DE-France,BEAUVAIS,0,61332,61332,M0798
Musée du Percheron,2008,BASSE-NORMANDIE,MORTAGNE-AU-PERCHE,0,1023,1023,
Musée National du Château de Compiègne,2019,HAUTS-DE-France,COMPIEGNE,33626,57683,91309,M5009
Musée Municipal Nicolas Poussin,2008,HAUTE-NORMANDIE,LES ANDELYS,1267,1957,3224,
Musée Régional d'Ethnologie,2019,HAUTS-DE-France,BETHUNE,0,5211,5211,M0642
Musée de Boulogne-sur-Mer,2019,HAUTS-DE-France,BOULOGNE-SUR-MER,13664,21681,35345,M0643
Maison des Templiers,2008,HAUTE-NORMANDIE,CAUDEBEC-EN-CAUX,1096,0,1096,
Musée Louis-Philippe du Château d'Eu,2008,HAUTE-NORMANDIE,EU,9373,3919,13292,
Musée des Beaux-Arts et de la Dentelle,2019,HAUTS-DE-France,CALAIS,8086,14525,22611,M0644
Louvre-Lens,2019,HAUTS-DE-France,LENS,86615,446556,533171,
Musée d'Art Moderne André Malraux - MuMa,2008,HAUTE-NORMANDIE,LE HAVRE,32899,28172,61071,
Musée Municipal Bruno Danvin,2019,HAUTS-DE-France,SAINT-POL-SUR-TERNOISE,0,3221,3221,M0652
Musée Le Secq des Tournelles,2008,HAUTE-NORMANDIE,ROUEN,5616,9743,15359,
MUNAE - Musée National de l'Education,2008,HAUTE-NORMANDIE,ROUEN,2726,7418,10144,
Musée Alfred Danicourt,2019,HAUTS-DE-France,PERONNE,0,1277,1277,M0815
Musée Municipal des Ivoires,2008,HAUTE-NORMANDIE,YVETOT,1162,1086,2248,
Musée Municipal Robert Dubois-Corneau,2019,ILE-DE-France,BRUNOY,128,2452,2580,M0403
Musée des Marais Salant,2008,PAYS DE LA LOIRE,BATZ-SUR-MER,11948,1418,13366,
Musée Belmondo et de la Sculpture Figurative du XXè siècle,2019,ILE-DE-France,BOULOGNE-BILLANCOURT,3653,5552,9205,M1170
Muséum d'Histoire Naturelle de Nantes,2008,PAYS DE LA LOIRE,NANTES,27433,63046,90479,
Musée Français de la Carte à Jouer,2019,ILE-DE-France,ISSY-LES-MOULINEAUX,8983,19712,28695,M0411
Musée du Chaume/Kerhinet - PNR Brière,2008,PAYS DE LA LOIRE,SAINT-LYPHARD,0,40867,40867,
Galerie d'Anatomie Comparée et de Paléontologie (Muséum d'Histoire Naturelle),2019,ILE-DE-France,PARIS,169638,203193,372831,M7003
Maison de l'Eclusier /Parc Naturel Régional de Brière,2008,PAYS DE LA LOIRE,SAINT-MALO DE GUERSAC,4601,50,4651,
Musée National Eugène Delacroix,2019,ILE-DE-France,PARIS,37176,37388,74564,M5004
Musée des Beaux-Arts,2008,PAYS DE LA LOIRE,ANGERS,18144,53578,71722,
Musée de Montmartre,2019,ILE-DE-France,PARIS,97823,14062,111885,M0369
Galerie David d'Angers,2008,PAYS DE LA LOIRE,ANGERS,6957,15709,22666,
Musée Bourdelle,2019,ILE-DE-France,PARIS,69186,92307,161493,M1103
Musée d'Art et d'Histoire,2008,PAYS DE LA LOIRE,BAUGE,2047,1086,3133,
Musée de la Vie Romantique,2019,ILE-DE-France,PARIS,16120,138543,154663,M1113
Musée Jules-Desbois,2008,PAYS DE LA LOIRE,PARCAY-LES-PINS,3592,3495,7087,
Musée Yves Saint Laurent,2019,ILE-DE-France,PARIS,119984,12955,132939,M1204
Musée Communal Robert Tatin,2008,PAYS DE LA LOIRE,COSSE-LE-VIVIEN,14101,5410,19511,
Musée de l'Ecole de Barbizon - Auberge Ganne,2019,ILE-DE-France,BARBIZON,9171,6106,15277,M0370
Musée du Château de Mayenne,2008,PAYS DE LA LOIRE,MAYENNE,7344,12110,19454,
Centre Minier de Faymoreau,2008,PAYS DE LA LOIRE,FAYMOREAU,22411,6884,29295,
Musée du Château de Fontainebleau,2019,ILE-DE-France,FONTAINEBLEAU,216919,181924,398843,M5013
Musée Municipal,2008,PAYS DE LA LOIRE,LA ROCHE-SUR-YON,0,7664,7664,
Musée Gatien Bonnet,2019,ILE-DE-France,LAGNY-SUR-MARNE,1093,5265,6358,M0376
Musée du Château,2008,PAYS DE LA LOIRE,NOIRMOUTIER-EN-L'ILE,30100,2661,32761,
Musée de la Grande Guerre du Pays de Meaux,2019,ILE-DE-France,MEAUX,64000,36000,100000,M1171
Musée Entomologique,2008,PICARDIE,SAINT-QUENTIN,3906,4149,8055,
Musée Municipal de Soissons,2008,PICARDIE,SOISSONS,0,38821,38821,
Musée de la Résistance Nationale,2019,ILE-DE-France,CHAMPIGNY-SUR-MARNE,0,128,128,M0425
Musée de La Thiérache,2008,PICARDIE,VERVINS,0,2143,2143,
Ecomusée du Val de Bièvre,2019,ILE-DE-France,FRESNES,0,4851,4851,M0426
Musée de la Nacre et de la Tabletterie,2008,PICARDIE,MERU,14962,4628,19590,
Musée de Nogent-Sur-Marne,2019,ILE-DE-France,NOGENT-SUR-MARNE,516,6061,6577,M0427
Musée jean-Jacques Rousseau,2019,ILE-DE-France,MONTMORENCY,1071,905,1976,M0437
Musée de la Maison de Pierre Loti,2008,POITOU-CHARENTES,ROCHEFORT,26302,3616,29918,
Musée National de Port Royal des Champs,2019,ILE-DE-France,MAGNY-LES-HAMEAUX,4716,23252,27968,M5045
Musée de l'Ile d'Oléron,2008,POITOU-CHARENTES,ST-PIERRE D'OLERON,10514,3227,13741,
Musée de Bressuire,2008,POITOU-CHARENTES,BRESSUIRE,0,5886,5886,
Collections de la Fondation de Coubertin,2019,ILE-DE-France,SAINT-REMY-LES-CHEVREUSE,1047,2756,3803,M0399
Musée Bernard d’Agesci,2008,POITOU-CHARENTES,NIORT,3794,14862,18656,
Musée des Arts Décoratifs de l’Océan indien (MADOI),2019,LA REUNION,SAINT-LOUIS,8628,4260,12888,M1078
Musée d'Art et d'Histoire Georges Turpin,2008,POITOU-CHARENTES,PARTHENAY,495,5280,5775,
Ecomusée de la Martinique,2019,MARTINIQUE,RIVIERE-PILOTE,6305,1934,8239,M1081
"Musée de la Moto, de l'Automobile et du Vélo",2008,POITOU-CHARENTES,CHATELLERAULT,5577,8320,13897,
Musée Volcanologique Franck Arnold Perret,2019,MARTINIQUE,SAINT-PIERRE,20366,20074,40440,M7059
Musée Municipal de Civray,2008,POITOU-CHARENTES,CIVRAY,0,261,261,
Musée des Beaux-Arts,2019,NORMANDIE,CAEN,18418,45538,63956,M0657
Musée Archéologique,2008,PROVENCE-ALPES-CÔTE D'AZUR,RIEZ-LA-ROMAINE,30,752,782,
Musée de la Mine,2019,NORMANDIE,LE MOLAY-LITTRY,1831,492,2323,M0663
Musée archéologique,2008,PROVENCE-ALPES-CÔTE D'AZUR,VACHERES,1209,0,1209,
Musée Municipal,2019,NORMANDIE,VIRE NORMANDIE,0,112,112,M0672
Musée Départemental des Arts Asiatiques,2008,PROVENCE-ALPES-CÔTE D'AZUR,NICE,2312,66680,68992,
Musée de l'Ancien Evêché,2019,NORMANDIE,EVREUX,0,25687,25687,M0703
Musée National Marc Chagall,2008,PROVENCE-ALPES-CÔTE D'AZUR,NICE,112161,43630,155791,
Musée Alfred Canel,2019,NORMANDIE,PONT-AUDEMER,2739,4079,6818,M0707
Musée Archéologique - Site de Terra Amata,2008,PROVENCE-ALPES-CÔTE D'AZUR,NICE,1589,13045,14634,
Musée Alphonse-Georges Poulain,2019,NORMANDIE,VERNON,7575,7690,15265,M0708
Musée Réattu,2008,PROVENCE-ALPES-CÔTE D'AZUR,ARLES,92417,37893,130310,
Musée d'Art et d'Histoire de Granville,2019,NORMANDIE,GRANVILLE,0,36,36,M0682
Musée Ciotaden,2008,PROVENCE-ALPES-CÔTE D'AZUR,LA CIOTAT,2791,4316,7107,
Musée Christian Dior,2019,NORMANDIE,GRANVILLE,64233,8376,72609,M0684
Musée Frédéric Mistral,2008,PROVENCE-ALPES-CÔTE D'AZUR,MAILLANE,1868,1920,3788,
Musée Louis-Philippe du Château d'Eu,2019,NORMANDIE,EU,17538,4125,21663,M0714
"Musée d'Arts Africains, Océaniens, Amérindiens",2008,PROVENCE-ALPES-CÔTE D'AZUR,MARSEILLE,5716,8751,14467,
Musée du Prieuré,2019,NORMANDIE,HARFLEUR,208,1735,1943,M0717
Musée d'Art Contemporain - Galeries Contemporaines,2008,PROVENCE-ALPES-CÔTE D'AZUR,MARSEILLE,8307,18610,26917,
Musée d'Art Moderne André Malraux - MuMa,2019,NORMANDIE,LE HAVRE,57381,57292,114673,M0720
Musée de l'Empéri de Salon et de la Crau,2008,PROVENCE-ALPES-CÔTE D'AZUR,SALON-DE-PROVENCE,7111,14081,21192,
Muséum d'Histoire Naturelle,2019,NORMANDIE,LE HAVRE,14416,29051,43467,M7015
Ecomusée de la Basse-Seine,2019,NORMANDIE,NOTRE-DAME-DE-BLIQUETUIT,19680,800,20480,M0723
Musée de l'Annonciade,2008,PROVENCE-ALPES-CÔTE D'AZUR,SAINT-TROPEZ,30655,6663,37318,
Museoseine - Le Musée de la Seine Normande,2019,NORMANDIE,RIVES-EN-SEINE,15106,1894,17000,M0711
Muséum d'Histoire Naturelle de Toulon,2008,PROVENCE-ALPES-CÔTE D'AZUR,TOULON,0,20657,20657,
MUNAE - Musée National de l'Education,2019,NORMANDIE,ROUEN,7576,12641,20217,M5067
Muséum d'Histoire Naturelle Esprit Requien,2008,PROVENCE-ALPES-CÔTE D'AZUR,AVIGNON,0,21292,21292,
Musée Le Secq des Tournelles,2019,NORMANDIE,ROUEN,0,28676,28676,M0732
Musée Comtadin-Duplessis,2008,PROVENCE-ALPES-CÔTE D'AZUR,CARPENTRAS,0,1985,1985,
Musée de la Céramique,2019,NORMANDIE,ROUEN,0,10594,10594,M0730
Musée Sobirats,2008,PROVENCE-ALPES-CÔTE D'AZUR,CARPENTRAS,294,576,870,
Musée des Beaux-Arts,2019,NOUVELLE-AQUITAINE,ANGOULEME,12577,33186,45763,M0818
Musée Municipal de Cognac,2019,NOUVELLE-AQUITAINE,COGNAC,2491,4593,7084,M0822
Musée de la Bresse - Domaine des Planons,2008,RHONE-ALPES,SAINT-CYR-SUR-MENTHON,16355,8567,24922,
Musée Napoléonien et Africain,2019,NOUVELLE-AQUITAINE,ÎLE-D'AIX,11527,9066,20593,M5048
Musée-château d'Annecy,2008,RHONE-ALPES,ANNECY,47062,42419,89481,
Hôtel Hèbre de Saint-Clément - Musée d'Art et d'Histoire,2019,NOUVELLE-AQUITAINE,ROCHEFORT,13085,8026,21111,M0830
Musée des Vallées de Thônes,2008,RHONE-ALPES,THONES,1723,500,2223,
Ancienne École de médecine navale - Musée national de la Marine,2019,NOUVELLE-AQUITAINE,ROCHEFORT,4907,4511,9418,M5026
Musée de Grenoble,2008,RHONE-ALPES,GRENOBLE,73889,115376,189265,
Musée Archéologique,2019,NOUVELLE-AQUITAINE,SAINTES,990,4092,5082,M0835
Musée Dauphinois,2008,RHONE-ALPES,GRENOBLE,0,41344,41344,
Musée Dupuy-Mestreau,2019,NOUVELLE-AQUITAINE,SAINTES,256,399,655,M0838
Atelier - Musée du Chapeau,2008,RHONE-ALPES,CHAZELLES-SUR-LYON,10614,4311,14925,
Musée Ernest Cognacq,2019,NOUVELLE-AQUITAINE,SAINT-MARTIN-DE-RE,9335,5383,14718,M0833
Musée d'Allard,2008,RHONE-ALPES,MONTBRISON,2970,4919,7889,
Musée Labenche d'Art et d'Histoire,2019,NOUVELLE-AQUITAINE,BRIVE-LA-GAILLARDE,1935,33545,35480,M0499
Musée de la Mine / Site Couriot,2008,RHONE-ALPES,SAINT-ETIENNE,30920,27032,57952,
Musée du Pays d'Ussel,2019,NOUVELLE-AQUITAINE,USSEL,378,2658,3036,M0501
Château de la Bastie d'Urfé,2008,RHONE-ALPES,SAINT-ETIENNE-LE-MOLARD,15163,13690,28853,
Musée Barthélemy-Thimonnier,2008,RHONE-ALPES,AMPLEPUIS,2056,4439,6495,
Musée Folklorique et Traditions Populaires Marius Audin,2008,RHONE-ALPES,BEAUJEU,2054,1101,3155,
Musée Historique des Tissus,2008,RHONE-ALPES,LYON,6218,3443,9661,
Musée des Beaux-Arts et d'Archéologie,2019,NOUVELLE-AQUITAINE,LIBOURNE,0,19240,19240,M0072
Musée Municipal,2019,NOUVELLE-AQUITAINE,VILLANDRAUT,117,456,573,M0075
Musée Municipal d'Albertville-Conflans,2008,RHONE-ALPES,ALBERTVILLE,2248,3241,5489,
Musée René Baubérot,2019,NOUVELLE-AQUITAINE,CHATEAUPONSAC,1203,447,1650,M0504
Musée des Beaux-Arts,2008,RHONE-ALPES,CHAMBERY,5364,20940,26304,
Musée Départemental de la Faïence et des Arts de la table,2019,NOUVELLE-AQUITAINE,SAMADET,2887,1440,4327,M0086
Musée de la Poterie,2009,ALSACE,BETSCHDORF,2485,466,2951,
Musée des Beaux-Arts,2019,NOUVELLE-AQUITAINE,AGEN,16060,11958,28018,M0087
Maison de l'Archéologie des Vosges du Nord,2009,ALSACE,NIEDERBRONN-LES-BAINS,2416,3818,6234,
Musée du Liège et du Bouchon,2019,NOUVELLE-AQUITAINE,MEZIN,2849,1324,4173,M1163
Musée Zoologique de Strasbourg,2009,ALSACE,STRASBOURG,12864,35152,48016,
Musée Basque et de l'Histoire de Bayonne,2019,NOUVELLE-AQUITAINE,BAYONNE,22870,39519,62389,M0093
Musée Tomi Ungerer,2009,ALSACE,STRASBOURG,15295,23625,38920,
Musée Edmond Rostand,2019,NOUVELLE-AQUITAINE,CAMBO-LES-BAINS,83465,9075,92540,M0095
Musée de la Porte de Thann,2009,ALSACE,CERNAY,262,872,1134,
Musée des Traditions Populaires et d'Archéologie,2019,NOUVELLE-AQUITAINE,CHAUVIGNY,6002,2650,8652,M0848
Musée du Vignoble et des Vins d'Alsace,2009,ALSACE,KAYSERSBERG VIGNOBLE,4331,100,4431,
Musée Municipal de Civray,2019,NOUVELLE-AQUITAINE,CIVRAY,0,16,16,M0849
Musée Minéralogique de la Société Industrielle de Mulhouse,2009,ALSACE,MULHOUSE,0,223,223,
Musée d'Archéologie,2019,OCCITANIE,MONTSEGUR,14516,0,14516,M0545
Musée du Papier Peint,2009,ALSACE,RIXHEIM,6118,4674,10792,
Musée du Palais des Evêques,2019,OCCITANIE,SAINT-LIZIER,12099,553,12652,M0546
Château de Bourdeilles,2009,AQUITAINE,BOURDEILLES,23000,0,23000,
"Musée des Mœurs et Coutumes, Musée du Rouergue",2019,OCCITANIE,ESPALION,529,571,1100,M0547
Musée Municipal Urbain Cabrol,2019,OCCITANIE,VILLEFRANCHE-DE-ROUERGUE,0,8963,8963,M0555
Ecomusée de la Grande Lande,2009,AQUITAINE,SABRES,70800,11757,82557,
Musée-Bibliothèque Pierre-André Benoît,2019,OCCITANIE,ALES,2153,10764,12917,M0448
Musée Municipal Albert Marzelles,2009,AQUITAINE,MARMANDE,0,5811,5811,
Musée du Colombier,2019,OCCITANIE,ALES,461,8583,9044,M0449
Musée des Musiques Populaires - MuPop,2009,AUVERGNE,MONTLUCON,1545,5593,7138,
Musée Albert André,2019,OCCITANIE,BAGNOLS-SUR-CEZE,58,4207,4265,M1207
Musée des Arts D'Afrique et D'Asie,2009,AUVERGNE,VICHY,2141,1288,3429,
Musée du Vieux Nîmes,2019,OCCITANIE,NÎMES,8643,4858,13501,M0458
Musée d'Art Roger-Quillot,2009,AUVERGNE,CLERMONT-FERRAND,6039,22171,28210,
Musée des Amériques - Auch,2019,OCCITANIE,AUCH,2392,3802,6194,M0569
Muséum d'Histoire Naturelle Henri-Lecoq,2009,AUVERGNE,CLERMONT-FERRAND,4036,21805,25841,
Musée du Vieux Toulouse,2019,OCCITANIE,TOULOUSE,6642,843,7485,M0567
Musée des Pénitents Blancs,2009,AUVERGNE,MARSAC-EN-LIVRADOIS,187,0,187,
Musée Paul Dupuy,2019,OCCITANIE,TOULOUSE,2785,3539,6324,M0565
Musée Francisque Mandet,2009,AUVERGNE,RIOM,1920,9287,11207,
Musée Pyrénéen,2019,OCCITANIE,LOURDES,70384,12203,82587,M0588
Musée Régional d'Auvergne,2009,AUVERGNE,RIOM,749,2444,3193,
Musée Massey,2019,OCCITANIE,TARBES,4104,5833,9937,M0591
Musée du Vin de Bourgogne,2009,BOURGOGNE,BEAUNE,20230,4072,24302,
Musée de l'Etang de Thau,2019,OCCITANIE,BOUZIGUES,8726,5097,13823,M0469
Musée des Beaux-Arts,2009,BOURGOGNE,BEAUNE,5997,2505,8502,
Maison des Consuls - Musée d’Arts et d’Archéologie,2019,OCCITANIE,LES MATELLES,2348,1922,4270,M0473
Musée de Vulliod Saint-Germain,2019,OCCITANIE,PEZENAS,56,36,92,M0482
Muséum - Jardin des Sciences,2009,BOURGOGNE,DIJON,7354,94493,101847,
Musée d'Histoire de Figeac,2019,OCCITANIE,FIGEAC,479,307,786,M0577
Musée Champollion - Les Ecriture du Monde,2019,OCCITANIE,FIGEAC,29218,10408,39626,M0578
Musée Municipal,2009,BOURGOGNE,NUITS-SAINT-GEORGES,432,2381,2813,
"Musée Archéologique ""Armand-Viré""",2019,OCCITANIE,LUZECH,759,200,959,M0580
Musée Municipal François Pompon,2009,BOURGOGNE,SAULIEU,2143,2887,5030,
Musée Départemental de Cuzals,2019,OCCITANIE,SAULIAC-SUR-CELE,6293,2432,8725,M0583
Musée d'Art et d'Histoire Romain Rolland,2009,BOURGOGNE,CLAMECY,1671,2060,3731,
Musée Hyacinthe Rigaud,2019,OCCITANIE,PERPIGNAN,42059,27333,69392,M0491
Musée Municipal,2009,BOURGOGNE,LA CHARITE-SUR-LOIRE,805,748,1553,
Musée Charles Portal - Histoire et Patrimoine,2019,OCCITANIE,CORDES-SUR-CIEL,819,412,1231,M0596
Musée de la Mine,2009,BOURGOGNE,LA MACHINE,5791,1087,6878,
Musée d'histoire naturelle Philadelphe Thomas,2019,OCCITANIE,GAILLAC,2049,2390,4439,M7037
Musée du Pays de Guérande et de la Porte Saint Michel,2019,PAYS DE LA LOIRE,GUERANDE,18152,9216,27368,M0741
Musée Saint-Nazaire,2009,BOURGOGNE,BOURBON-LANCY,106,741,847,
Musée d'Art de Nantes,2019,PAYS DE LA LOIRE,NANTES,86375,212401,298776,M0743
Musée Nicéphore Niepce,2009,BOURGOGNE,CHALON-SUR-SAONE,0,23612,23612,
Muséum des Sciences Naturelles,2019,PAYS DE LA LOIRE,ANGERS,6526,21159,27685,M7017
Musée de la Tour du Moulin,2009,BOURGOGNE,MARCIGNY,1118,546,1664,
Musée Leblanc-Duvernois,2009,BOURGOGNE,AUXERRE,531,675,1206,
Musée des Beaux-Arts et Galerie David d'Angers,2019,PAYS DE LA LOIRE,ANGERS,33048,72230,105278,M0748
Musée de l'Avallonnais Jean Després,2009,BOURGOGNE,AVALLON,0,7856,7856,
Musée d'Art et d'Histoire,2019,PAYS DE LA LOIRE,CHOLET,1837,14325,16162,M0754
Musée de l'Aventure du Son,2009,BOURGOGNE,SAINT-FARGEAU,3815,623,4438,
Musée du Textile,2019,PAYS DE LA LOIRE,CHOLET,5536,9850,15386,M0756
Musée d'Art et d'Histoire du Puisaye,2009,BOURGOGNE,VILLIERS-SAINT-BENOIT,787,547,1334,
Musée Archéologique Départemental de Jublains,2019,PAYS DE LA LOIRE,JUBLAINS,16778,9604,26382,M0765
Musée de Pont-Aven,2009,BRETAGNE,PONT-AVEN,41830,11460,53290,
Musée Milcendeau Jean-Yole,2019,PAYS DE LA LOIRE,SOULLANS,3136,2030,5166,M0783
Musée Départemental Breton,2009,BRETAGNE,QUIMPER,24734,17711,42445,
Musée Renoir,2019,PROVENCE-ALPES-CÔTE D'AZUR,CAGNES-SUR-MER,26790,26916,53706,M0871
Ecomusée du Pays de Montfort,2009,BRETAGNE,MONTFORT-SUR-MEU,2969,1547,4516,
Musée de la Castre,2019,PROVENCE-ALPES-CÔTE D'AZUR,CANNES,22283,14246,36529,M0872
Musée Saint-Nicolas,2009,BRETAGNE,VITRE,1360,621,1981,
Musée de la Mer,2019,PROVENCE-ALPES-CÔTE D'AZUR,CANNES,43900,34493,78393,M0873
Ecomusée de Saint-Dégan,2009,BRETAGNE,BREC'H,11957,2867,14824,
Musée International de la Parfumerie,2019,PROVENCE-ALPES-CÔTE D'AZUR,GRASSE,74515,42371,116886,M0877
Musée de la Compagnie des Indes,2009,BRETAGNE,PORT-LOUIS,68683,0,68683,
Musée Bonnard,2019,PROVENCE-ALPES-CÔTE D'AZUR,LE CANNET,34622,12164,46786,M1135
"La Cohue, Musée des Beaux-Arts de vannes",2009,BRETAGNE,VANNES,6594,9083,15677,
Musée Jean Cocteau Collection Séverin Wunderman,2019,PROVENCE-ALPES-CÔTE D'AZUR,MENTON,16378,0,16378,M0879
Musée des Beaux-Arts,2009,CENTRE,CHARTRES,4944,7786,12730,
Conservatoire du Machinisme et des Pratiques Agricoles,2009,CENTRE,CHARTRES-MAINVILLIERS,7332,44290,51622,
Musée d'Art Naïf Anatole Jakovsky,2019,PROVENCE-ALPES-CÔTE D'AZUR,NICE,3126,4814,7940,M0886
Château Musée,2009,CENTRE,AZAY-LE-FERRON,10679,4808,15487,
Musée Archéologique - Site de  Cimiez,2019,PROVENCE-ALPES-CÔTE D'AZUR,NICE,16244,16294,32538,M0883
Musée Ornithologique (Ecomusée de la Brenne),2009,CENTRE,LE BLANC,2620,1774,4394,
Muséum d'Histoire Naturelle,2019,PROVENCE-ALPES-CÔTE D'AZUR,NICE,2047,2646,4693,M7050
"""Maison Musée"" René Descartes",2009,CENTRE,DESCARTES,1336,654,1990,
Musée Départemental des Merveilles,2019,PROVENCE-ALPES-CÔTE D'AZUR,TENDE,4119,21410,25529,M0891
Musée Municipal,2009,CENTRE,SAINTE-MAURE-DE-TOURAINE,94,87,181,
Ecomusée du Véron,2009,CENTRE,SAVIGNY-EN-VERON,8480,0,8480,
Musée des Tapisseries,2019,PROVENCE-ALPES-CÔTE D'AZUR,AIX-EN-PROVENCE,4592,13120,17712,M0897
Musée de Minerve,2009,CENTRE,YZEURES-SUR-CREUSE,0,1000,1000,
Musée Municipal Méditerranéen de Cassis A.T.P.,2019,PROVENCE-ALPES-CÔTE D'AZUR,CASSIS,112,6627,6739,M0904
Musée de Sologne,2009,CENTRE,ROMORANTIN-LANTHENAY,3766,14939,18705,
Musée Alphonse Daudet,2019,PROVENCE-ALPES-CÔTE D'AZUR,FONTVIEILLE,1948,919,2867,M0905
Musée Gaston Couté,2009,CENTRE,MEUNG-SUR-LOIRE,0,2648,2648,
Musée Ciotaden,2019,PROVENCE-ALPES-CÔTE D'AZUR,LA CIOTAT,2617,2494,5111,M0907
Musée Girodet,2009,CENTRE,MONTARGIS,2294,4179,6473,
Musée des Docks Romains,2019,PROVENCE-ALPES-CÔTE D'AZUR,MARSEILLE,0,13298,13298,M0916
Musée Grobet-Labadié,2019,PROVENCE-ALPES-CÔTE D'AZUR,MARSEILLE,5810,19556,25366,M0917
Musée Municipal,2009,CHAMPAGNE-ARDENNES,BOURBONNE-LES-BAINS,0,2243,2243,
Musée Municipal,2009,CHAMPAGNE-ARDENNES,CHALONS-EN-CHAMPAGNE,1594,10520,12114,
Musée Archéologique Gallo-Romaine du Var,2019,PROVENCE-ALPES-CÔTE D'AZUR,FREJUS,4950,2881,7831,M1182
Planétarium/Musée de l'Ancien Collège des Jésuites,2009,CHAMPAGNE-ARDENNES,REIMS,2951,29228,32179,
Musée Archéologique,2019,PROVENCE-ALPES-CÔTE D'AZUR,SAINT-RAPHAËL,0,24713,24713,M0940
Musée de la Corse,2009,CORSE,CORTE,67635,11516,79151,
Musée Calvet (et musée Lapidaire),2019,PROVENCE-ALPES-CÔTE D'AZUR,AVIGNON,0,71436,71436,M0946
Muséum de Besançon,2009,FRANCHE-COMTE,BESANCON,203471,45312,248783,
Musée Sobirats,2019,PROVENCE-ALPES-CÔTE D'AZUR,CARPENTRAS,0,161,161,M0951
Musée de la Tour des Echevins,2009,FRANCHE-COMTE,LUXEUIL-LES-BAINS,1799,5043,6842,
Musée Municipal,2019,PROVENCE-ALPES-CÔTE D'AZUR,ORANGE,50371,0,50371,M0959
Musée Municipal,2019,PROVENCE-ALPES-CÔTE D'AZUR,SAULT,0,782,782,M0960
Musée Territorial Alexandre Franconie,2009,GUYANE,CAYENNE,2474,5762,8236,
Musée du Bugey-Valmorey,2020,AUVERGNE-RHONE-ALPES,LOCHIEU,1794,1210,3004,M0967
Fondation Arp,2009,ILE-DE-FRANCE,CLAMART,1339,509,1848,
Musée de la Résistance et de la Déportation de l'Ain,2020,AUVERGNE-RHONE-ALPES,NANTUA,4040,2751,6791,M0968
Musée du Vieux Pérouges,2020,AUVERGNE-RHONE-ALPES,PEROUGES,10315,233,10548,M0970
Musée d'Art et d'Histoire,2009,ILE-DE-FRANCE,MEUDON,0,9330,9330,
Musée - Atelier Rodin (Annexe du musée de Paris),2009,ILE-DE-FRANCE,MEUDON,2337,3499,5836,
Musée National des Châteaux de Malmaison et de Bois-Préau,2009,ILE-DE-FRANCE,RUEIL-MALMAISON,36374,28617,64991,
Musée de la Haute Auvergne,2020,AUVERGNE-RHONE-ALPES,SAINT-FLOUR,2026,1458,3484,M0113
Musée de l'Île-de-France,2009,ILE-DE-FRANCE,SCEAUX,11900,44470,56370,
Musée d'Histoire et d'Archéologie,2020,AUVERGNE-RHONE-ALPES,DIE,333,1570,1903,M0982
Château de Grignan,2020,AUVERGNE-RHONE-ALPES,GRIGNAN,81905,0,81905,M0983
Musée de l'Armée,2009,ILE-DE-FRANCE,PARIS,778808,442988,1221796,
Musée de Paléontologie,2020,AUVERGNE-RHONE-ALPES,CHILHAC,1624,0,1624,M7031
Musée du Moyen Age-Thermes et Hôtel de Cluny,2009,ILE-DE-FRANCE,PARIS,160268,154289,314557,
Musée des Manufactures de Dentelles,2020,AUVERGNE-RHONE-ALPES,RETOURNAC,993,379,1372,M0117
Musée de l'Orangerie,2009,ILE-DE-FRANCE,PARIS,398480,170106,568586,
Musée-château d'Annecy,2020,AUVERGNE-RHONE-ALPES,ANNECY,42895,21103,63998,M1052
Musée National de la Légion d'Honneur et des Ordres de Chevalerie,2009,ILE-DE-FRANCE,PARIS,0,44500,44500,
Musée Alpin,2020,AUVERGNE-RHONE-ALPES,CHAMONIX,8179,3035,11214,M1053
Maison de Balzac,2009,ILE-DE-FRANCE,PARIS,820,36427,37247,
Musée du Patrimoine de l'Oisans,2020,AUVERGNE-RHONE-ALPES,ALPE D'HUEZ,0,4237,4237,M1000
Musée de Montmartre,2009,ILE-DE-FRANCE,PARIS,50541,3813,54354,
Musée Lapidaire Saint-Pierre,2020,AUVERGNE-RHONE-ALPES,VIENNE,3347,0,3347,M1006
Etablissement Public du Musée des Arts Asiatiques Guimet,2009,ILE-DE-FRANCE,PARIS,133586,113249,246835,
Mémorial du Maréchal Leclerc de Hauteclocque et de la Libération de Paris-musée Jean Moulin,2009,ILE-DE-FRANCE,PARIS,9828,14154,23982,
Musée d'Allard,2020,AUVERGNE-RHONE-ALPES,MONTBRISON,1339,2783,4122,M1016
Musée National Picasso,2009,ILE-DE-FRANCE,PARIS,149955,99820,249775,
Musée de la Mine / Site Couriot,2020,AUVERGNE-RHONE-ALPES,SAINT-ETIENNE,8384,9487,17871,M1025
Musée des Arts Décoratifs (Union Centrale des Arts Décoratifs),2009,ILE-DE-FRANCE,PARIS,232867,176264,409131,
Château de la Bastie d'Urfé,2020,AUVERGNE-RHONE-ALPES,SAINT-ETIENNE-LE-MOLARD,3850,4700,8550,M1026
Musée National des Techniques,2009,ILE-DE-FRANCE,PARIS,75430,127636,203066,
Musée des Monnaies et des Médailles,2009,ILE-DE-FRANCE,PARIS,11351,24485,35836,
Musée d'Art Contemporain de Lyon,2020,AUVERGNE-RHONE-ALPES,LYON,2796,4193,6989,M1033
Château-musée de Nemours,2009,ILE-DE-FRANCE,NEMOURS,2702,5521,8223,
Musée Henri Malartre,2020,AUVERGNE-RHONE-ALPES,ROCHETAILLEE-SUR-SAONE,8498,7773,16271,M1040
Ecomusée,2009,ILE-DE-FRANCE,SAVIGNY-LE-TEMPLE,247,10053,10300,
Musée Paul Dini,2020,AUVERGNE-RHONE-ALPES,VILLEFRANCHE-SUR-SAONE,2222,4017,6239,M1041
"MAC VAL, Musée d'Art Contemporain du Val-de-Marne",2009,ILE-DE-FRANCE,VITRY SUR SEINE,10529,46308,56837,
Musée du docteur Faure,2020,AUVERGNE-RHONE-ALPES,AIX-LES-BAINS,6815,0,6815,M1045
Musée de la Renaissance - Château d'Ecouen,2009,ILE-DE-FRANCE,ECOUEN,23909,49309,73218,
Musée Archéologique,2020,AUVERGNE-RHONE-ALPES,AIX-LES-BAINS,100,0,100,M1044
Musée d'Art et d'Histoire Louis Senlecq,2009,ILE-DE-FRANCE,L'ISLE-ADAM,944,5938,6882,
Musée Bonaparte,2020,BOURGOGNE-FRANCHE-COMTE,AUXONNE,0,250,250,M0132
Musée de la Ville,2009,ILE-DE-FRANCE,MONTIGNY LE BRETONNEUX,9808,3500,13308,
Musée d'Archéologie Nationale (des origines à l'an mille) - Château de st-Germain-en-Laye,2009,ILE-DE-FRANCE,SAINT-GERMAIN-EN-LAYE,19102,72792,91894,
Collections de la Fondation de Coubertin,2009,ILE-DE-FRANCE,SAINT-REMY-LES-CHEVREUSE,2256,1811,4067,
Musée National Magnin,2020,BOURGOGNE-FRANCHE-COMTE,DIJON,2902,3205,6107,M5011
Etablissement Public du Musée et du Domaine National de Versailles,2009,ILE-DE-FRANCE,VERSAILLES,3962677,1696929,5659606,
Musée François Rude,2020,BOURGOGNE-FRANCHE-COMTE,DIJON,0,46701,46701,M0140
Musée des Beaux-Arts,2009,LANGUEDOC-ROUSSILLON,CARCASSONNE,0,46306,46306,
Musée Archéologique,2020,BOURGOGNE-FRANCHE-COMTE,DIJON Cedex,0,9077,9077,M0138
Musée Archéologique du Lauragais,2009,LANGUEDOC-ROUSSILLON,CASTELNAUDARY,0,1401,1401,
Musée Buffon,2020,BOURGOGNE-FRANCHE-COMTE,MONTBARD,98,4627,4725,M0143
Musée du Colombier,2009,LANGUEDOC-ROUSSILLON,ALES,0,15763,15763,
Musée Municipal,2020,BOURGOGNE-FRANCHE-COMTE,NUITS-SAINT-GEORGES,19,1843,1862,M0144
Musée des Vallées Cévenoles,2009,LANGUEDOC-ROUSSILLON,SAINT-JEAN DU GARD,8778,7378,16156,
Musée de la résistance et de la Déportation,2020,BOURGOGNE-FRANCHE-COMTE,BESANCON,445,0,445,M0335
Musée du Biterrois,2009,LANGUEDOC-ROUSSILLON,BEZIERS,2863,10162,13025,
Musée de Plein Air des Maisons Comtoises,2020,BOURGOGNE-FRANCHE-COMTE,NANCRAY,16927,7082,24009,M0338
Musée de l'Etang de Thau,2009,LANGUEDOC-ROUSSILLON,BOUZIGUES,16316,358,16674,
Musée de Pontarlier,2020,BOURGOGNE-FRANCHE-COMTE,PONTARLIER,210,2333,2543,M0340
Musée de l'Ephèbe,2009,LANGUEDOC-ROUSSILLON,LE CAP D'AGDE,11782,2104,13886,
Musée Sarret de Grozon,2020,BOURGOGNE-FRANCHE-COMTE,ARBOIS,578,531,1109,M0341
Musée Archéologique,2009,LANGUEDOC-ROUSSILLON,MINERVE,5372,0,5372,
Musée de la Vigne et du Vin,2020,BOURGOGNE-FRANCHE-COMTE,ARBOIS,1087,2298,3385,M0342
Musée de Vulliod Saint-Germain,2009,LANGUEDOC-ROUSSILLON,PEZENAS,2166,3356,5522,
Viséum-Musée de la Lunette,2020,BOURGOGNE-FRANCHE-COMTE,MOREZ HAUTS DE BIENNE,6552,1850,8402,M0350
Musée Paul Valéry,2009,LANGUEDOC-ROUSSILLON,SETE,5096,7668,12764,
Musée de la Grande Saline,2020,BOURGOGNE-FRANCHE-COMTE,SALINS-LES-BAINS,40737,4109,44846,M0353
Musée de Tautavel,2009,LANGUEDOC-ROUSSILLON,TAUTAVEL,65631,8983,74614,
Musée de l'Artisanat Jurassien,2020,BOURGOGNE-FRANCHE-COMTE,VOITEUR,0,8605,8605,M0343
Musée du Président Jacques Chirac,2009,LIMOUSIN,SARRAN,36579,10374,46953,
Musée d'Art et d'Histoire Saint-Germain,2020,BOURGOGNE-FRANCHE-COMTE,AUXERRE,0,23600,23600,M0184
Musée Municipal des Emaux et Faïences,2009,LORRAINE,LONGWY,4730,1473,6203,
Musée de l'Avallonnais Jean Després,2020,BOURGOGNE-FRANCHE-COMTE,AVALLON,201,1564,1765,M0186
Musée de l'Ecole de Nancy,2009,LORRAINE,NANCY,33869,28325,62194,
Musée de Dinan,2020,BRETAGNE,DINAN,0,18814,18814,M0194
Muséum- Aquarium de Nancy,2009,LORRAINE,NANCY,27718,48966,76684,
Musée d'Art et d'Histoire,2020,BRETAGNE,SAINT-BRIEUC,0,5778,5778,M0196
Palais des ducs de Lorraine - Musée Historique Lorrain,2009,LORRAINE,NANCY,19782,33085,52867,
Musée des Beaux-Arts de Brest,2020,BRETAGNE,BREST,5696,4952,10648,M0197
"Musée ""au Fil du Papier""",2009,LORRAINE,PONT-A-MOUSSON,2876,2466,5342,
Musée de Morlaix,2020,BRETAGNE,MORLAIX,447,1586,2033,M0202
Musée de la Bière et du Pays de Stenay,2009,LORRAINE,STENAY,6353,10570,16923,
Musée des Phares et Balises,2020,BRETAGNE,OUESSANT,10957,1005,11962,M0204
Musée Départemental du Sel,2009,LORRAINE,MARSAL,6435,4748,11183,
Musée de Bretagne,2020,BRETAGNE,RENNES Cedex,30944,1843,32787,M0212
Maison du Verre et du Cristal,2009,LORRAINE,MEISENTHAL,19583,16450,36033,
Musée des Rochers de Sévigné,2020,BRETAGNE,VITRE,400,50,450,M0218
Musée Départemental d'Archéologie Précolombienne et de Préhistoire de la Martinique,2009,MARTINIQUE,FORT-DE-FRANCE,3911,2806,6717,
Musée du Château de Vitré,2020,BRETAGNE,VITRE Cedex,12328,0,12328,M0216
Musée Volcanologique Franck Arnold Perret,2009,MARTINIQUE,SAINT-PIERRE,22062,882,22944,
Musée de Préhistoire J. Miln- Z. Le-Rouzic,2020,BRETAGNE,CARNAC,15788,2558,18346,M0221
Musée Municipal de Millau,2009,MIDI-PYRENEES,MILLAU,5461,13489,18950,
Musée de la Compagnie des Indes,2020,BRETAGNE,PORT-LOUIS,25669,20955,46624,M0224
"La Cohue, Musée des Beaux-Arts de vannes",2020,BRETAGNE,VANNES,10562,173496,184058,M0228
Musée de l'Armagnac,2009,MIDI-PYRENEES,CONDOM,3687,398,4085,
Musée de la Chemiserie et de l'Elégance Masculine,2020,CENTRE-VAL DE LOIRE,ARGENTON-SUR-CREUSE,2734,1877,4611,M0245
Musée Archéologique,2009,MIDI-PYRENEES,EAUZE,3193,2316,5509,
Château Musée,2020,CENTRE-VAL DE LOIRE,AZAY-LE-FERRON,14063,1460,15523,M0246
Musée des Beaux-Arts et des Arts Décoratifs,2009,MIDI-PYRENEES,MIRANDE,618,648,1266,
Musée du Pays de Luchon,2009,MIDI-PYRENEES,BAGNERES-DE-LUCHON,2777,1996,4773,
"""Maison Musée"" René Descartes",2020,CENTRE-VAL DE LOIRE,DESCARTES,632,488,1120,M0257
Musée de Préhistoire Amédée Lémozi,2009,MIDI-PYRENEES,CABRERETS,71800,550,72350,
Musée de l'Hôtel de Ville,2020,CENTRE-VAL DE LOIRE,RICHELIEU,1606,500,2106,M0261
Musée Murat,2009,MIDI-PYRENEES,CŒUR DE CAUSSE,620,187,807,
Musée du Vieux Figeac,2009,MIDI-PYRENEES,FIGEAC,803,123,926,
Musée de la Marine de Loire,2020,CENTRE-VAL DE LOIRE,CHÂTEAUNEUF-SUR-LOIRE,2686,1457,4143,M0280
Musée Gallo-Romain d'Uxellodunum,2009,MIDI-PYRENEES,MARTEL,399,667,1066,
Musée Girodet,2020,CENTRE-VAL DE LOIRE,MONTARGIS,2444,1143,3587,M0284
Musée de l'Automate,2009,MIDI-PYRENEES,SOUILLAC,21270,3951,25221,
Musée Palais Fesch,2020,CORSE,AJACCIO,20859,3368,24227,M0324
Musée Jean Jaurès,2009,MIDI-PYRENEES,CASTRES,1577,10986,12563,
Musée d'archéologie d'Aleria - Jérôme Carcopino,2020,CORSE,ALERIA,0,16794,16794,M0328
Musée des Beaux-Arts,2009,MIDI-PYRENEES,GAILLAC,2109,2088,4197,
Musée de l'Ardenne,2020,GRAND EST,CHARLEVILLE-MEZIERES,3029,14493,17522,M0292
Musée Ingres,2009,MIDI-PYRENEES,MONTAUBAN,25548,32024,57572,
Musée du Rethelois et du Porcien,2020,GRAND EST,RETHEL,0,712,712,M0295
Musée Théophile Jouglet,2009,NORD-PAS-DE-CALAIS,ANZIN,0,2014,2014,
Maison de l'Outil  et de la Pensée Ouvrière,2020,GRAND EST,TROYES,6999,1099,8098,M0306
Musée Municipal de Cambrai,2009,NORD-PAS-DE-CALAIS,CAMBRAI,5727,7632,13359,
Musée Alsacien,2020,GRAND EST,HAGUENAU,160,195,355,M0004
Maison de l'Archéologie des Vosges du Nord,2020,GRAND EST,NIEDERBRONN-LES-BAINS,213,201,414,M0008
Musée d'Archéologie et d'Histoire Locale,2009,NORD-PAS-DE-CALAIS,DENAIN,0,2600,2600,
Musée du Château des Rohan,2020,GRAND EST,SAVERNE,1449,1740,3189,M0012
Musée des Beaux-Arts,2009,NORD-PAS-DE-CALAIS,DUNKERQUE,7837,0,7837,
Ecomusée de la Région,2009,NORD-PAS-DE-CALAIS,FOURMIES,31751,29606,61357,
Musée Archéologique,2020,GRAND EST,STRASBOURG,11546,11722,23268,M0015
Musée Départemental Matisse,2009,NORD-PAS-DE-CALAIS,LE CATEAU-CAMBRESIS,23119,52610,75729,
Musée de l'Œuvre Notre-Dame,2020,GRAND EST,STRASBOURG,8478,12722,21200,M0017
Musée des Beaux-Arts,2009,NORD-PAS-DE-CALAIS,ARRAS,42002,30139,72141,
Musée du Vignoble et des Vins d'Alsace,2020,GRAND EST,KAYSERSBERG VIGNOBLE,982,0,982,M0032
Musée Municipal,2009,NORD-PAS-DE-CALAIS,LE TOUQUET-PARIS-PLAGE,1975,0,1975,
Musée d'Histoire Local,2020,GRAND EST,KAYSERSBERG VIGNOBLE,0,1961,1961,M0031
Musée du Débarquement,2009,BASSE-NORMANDIE,ARROMANCHES,315766,12915,328681,
Musée Municipal,2020,GRAND EST,CHÂLONS-EN-CHAMPAGNE,778,4434,5212,M0307
Musée de la Poste et des Techniques de communication,2009,BASSE-NORMANDIE,CAEN,3848,0,3848,
Musée du Cloître de Notre-Dame-en-Vaux,2020,GRAND EST,CHÂLONS-EN-CHAMPAGNE,403,630,1033,M1178
Musée des Beaux-Arts,2009,BASSE-NORMANDIE,CAEN,5556,56653,62209,
Musée Hôtel le Vergeur,2020,GRAND EST,REIMS,1405,3219,4624,M0314
Musée Départemental Raymond Poincaré,2020,GRAND EST,SAMPIGNY,0,1082,1082,M0521
Musée Paléontologique,2009,BASSE-NORMANDIE,VILLERS-SUR-MER,0,38262,38262,
Musée de la Bière et du Pays de Stenay,2020,GRAND EST,STENAY,3158,7529,10687,M0522
Muséum Emmanuel Liais,2009,BASSE-NORMANDIE,CHERBOURG-EN-COTENTIN,0,20860,20860,
Musée d'Argonne,2020,GRAND EST,VARENNES-EN-ARGONNE,780,0,780,M0523
Musée des Beaux-Arts,2009,BASSE-NORMANDIE,SAINT-LO,6250,0,6250,
Centre Pompidou de Metz,2020,GRAND EST,METZ,112192,2550,114742,
"Musée du Bocage Normand, ferme du bois Jugan",2009,BASSE-NORMANDIE,SAINT-LO,2370,3801,6171,
Moulin de la Blies - Musée des Techniques Faïencières,2020,GRAND EST,SARREGUEMINES,8642,3483,12125,M0533
Musée du Granit,2009,BASSE-NORMANDIE,SAINT-MICHEL-DE-MONTJOIE,1351,500,1851,
Musée Franco-Américain du Château de Blérancourt,2020,HAUTS-DE-France,BLERANCOURT,1389,1876,3265,M5008
Musée du Percheron,2009,BASSE-NORMANDIE,MORTAGNE-AU-PERCHE,0,1015,1015,
Musée Départemental des Arts et Traditions Populaires du Perche,2009,BASSE-NORMANDIE,SAINT-CYR LA ROSIERE,12075,11804,23879,
Musée Municipal,2009,HAUTE-NORMANDIE,BERNAY,2854,8566,11420,
Musée Entomologique,2020,HAUTS-DE-France,SAINT-QUENTIN,2936,4771,7707,M7060
Musée du Verre et de la Pierre,2009,HAUTE-NORMANDIE,CONCHES-EN-OUCHE,1826,1875,3701,
Musée du Mont-de-Piété,2020,HAUTS-DE-France,BERGUES,0,3172,3172,M0613
Pavillon Flaubert,2009,HAUTE-NORMANDIE,CANTELEU,0,827,827,
Musée de la Chartreuse,2020,HAUTS-DE-France,DOUAI,1859,5777,7636,M0619
Château-Musée de Dieppe,2009,HAUTE-NORMANDIE,DIEPPE,29839,11416,41255,
Musée d'Histoire Naturelle et de Géologie,2020,HAUTS-DE-France,LILLE,28752,39180,67932,M7001
La Maison de l'Armateur,2009,HAUTE-NORMANDIE,LE HAVRE,5462,5991,11453,
La Piscine - Musée d'Art et d'Industrie André Diligent de Roubaix,2020,HAUTS-DE-France,ROUBAIX,51890,57425,109315,M0634
Abbaye de Graville - Musée du Prieuré de Graville,2009,HAUTE-NORMANDIE,LE HAVRE,1850,4550,6400,
Musée des Beaux-Arts,2020,HAUTS-DE-France,VALENCIENNES,7110,2540,9650,M0638
Muséum d'Histoire Naturelle,2009,HAUTE-NORMANDIE,LE HAVRE,0,29810,29810,
Musée Condé,2020,HAUTS-DE-France,CHANTILLY,211396,0,211396,5052
Musée Départemental Pierre Corneille,2009,HAUTE-NORMANDIE,LE PETIT-COURONNE,664,3634,4298,
Musée de l'Archerie et de l'Art Sacré,2020,HAUTS-DE-France,CREPY-EN-VALOIS,1848,621,2469,M0806
Ecomusée de la Basse-Seine,2009,HAUTE-NORMANDIE,NOTRE-DAME-DE-BLIQUETUIT,17752,3255,21007,
Musée de la Vénerie,2020,HAUTS-DE-France,SENLIS,553,1977,2530,M0810
Musée Industriel de la Corderie Vallois,2009,HAUTE-NORMANDIE,NOTRE-DAME-DE-BONDEVILLE,2155,7636,9791,
"Musée de la Fève, Crèches et Traditions Populaires",2009,PAYS DE LA LOIRE,BLAIN,1142,353,1495,
Musée de Picardie,2020,HAUTS-DE-France,AMIENS,11120,21887,33007,M0812
Musée du Château des Ducs de Bretagne,2009,PAYS DE LA LOIRE,NANTES,80292,87575,167867,
Musée Alfred Danicourt,2020,HAUTS-DE-France,PERONNE Cédex,0,306,306,M0815
Musée Communal Robert Tatin,2009,PAYS DE LA LOIRE,COSSE-LE-VIVIEN,14365,3719,18084,
Musée Français de la Photographie,2020,ILE-DE-France,BIEVRES,1035,2200,3235,M0401
Musée des Sciences - CCSTI,2009,PAYS DE LA LOIRE,LAVAL,2839,48312,51151,
Musée du Château,2020,ILE-DE-France,DOURDAN,9244,0,9244,M0404
Musée de l'Ardoise et de la Géologie,2009,PAYS DE LA LOIRE,RENAZE,1579,412,1991,
Musée du Domaine Départemental de Sceaux,2020,ILE-DE-France,SCEAUX,7046,10460,17506,M0417
Ecomusée du Marais Breton Vendéen,2009,PAYS DE LA LOIRE,LA BARRE-DE-MONTS,20706,8427,29133,
MUS - Musée d'Histoire Urbaine et Sociale,2020,ILE-DE-France,SURESNES,2795,2994,5789,M0418
Musée ornithologique Charles-Payraudeau,2009,PAYS DE LA LOIRE,LA-CHAIZE-LE-VICOMTE,0,1023,1023,
Musée de La Thiérache,2009,PICARDIE,VERVINS,0,1932,1932,
Musée National de la Légion d'Honneur et des Ordres de Chevalerie,2020,ILE-DE-France,PARIS,0,18193,18193,M5059
Musée Pillon,2009,PICARDIE,CHAUMONT-EN-VEXIN,0,200,200,
Musée de l'Assistance Publique - Hôpitaux de Paris,2020,ILE-DE-France,PARIS,44,0,44,M1076
Musée - Atelier Rodin,2020,ILE-DE-France,MEUDON,0,4962,4962,M5044
Musée du Moyen Age-Thermes et Hôtel de Cluny,2020,ILE-DE-France,PARIS,23346,28100,51446,M5003
Musée Municipal de Cognac,2009,POITOU-CHARENTES,COGNAC,1810,9029,10839,
Musée des Arts du Cognac (Annexe musée municipal),2009,POITOU-CHARENTES,COGNAC,6262,6410,12672,
Musée du Louvre,2020,ILE-DE-France,PARIS,1222612,1474972,2697584,M5031
Musée Zadkine,2020,ILE-DE-France,PARIS,12317,5595,17912,M1115
Musée Picasso,2009,PROVENCE-ALPES-CÔTE D'AZUR,ANTIBES,85663,45937,131600,
Palais Galliera - Musée de la Mode de la ville de Paris,2020,ILE-DE-France,PARIS,24420,15471,39891,M1108
Musée d'Histoire et d'Archéologie,2009,PROVENCE-ALPES-CÔTE D'AZUR,ANTIBES,3637,4768,8405,
Musée Renoir,2009,PROVENCE-ALPES-CÔTE D'AZUR,CAGNES-SUR-MER,27134,9827,36961,
Musée des Arts et Métiers,2020,ILE-DE-France,PARIS,21572,62138,83710,M5065
Musée d'Art Moderne et d'Art Contemporain,2009,PROVENCE-ALPES-CÔTE D'AZUR,NICE,0,163803,163803,
Musée Départemental de Préhistoire d'Île de France,2020,ILE-DE-France,NEMOURS,3114,13124,16238,M0382
Ecomusée du Pays de la Roudoule,2009,PROVENCE-ALPES-CÔTE D'AZUR,PUGET-ROSTANG,1096,659,1755,
Musée de l'Air et de l'Espace,2020,ILE-DE-France,LE BOURGET Cedex,76537,25349,101886,M5024
Musée- Atelier de Paul Cézanne,2009,PROVENCE-ALPES-CÔTE D'AZUR,AIX-EN-PROVENCE,50000,8678,58678,
Ecomusée du Val de Bièvre,2020,ILE-DE-France,FRESNES,0,3803,3803,M0426
Musée des Docks Romains,2009,PROVENCE-ALPES-CÔTE D'AZUR,MARSEILLE,2876,2634,5510,
Musée d'Archéologie Méditerranéenne,2009,PROVENCE-ALPES-CÔTE D'AZUR,MARSEILLE,6458,11540,17998,
Musée jean-Jacques Rousseau,2020,ILE-DE-France,MONTMORENCY,479,489,968,M0437
Musée Municipal Paul Lafran,2009,PROVENCE-ALPES-CÔTE D'AZUR,SAINT-CHAMAS,0,1949,1949,
Musée du Pays Brignolais,2009,PROVENCE-ALPES-CÔTE D'AZUR,BRIGNOLES,2521,2861,5382,
Musée d'Archéologie Précolombienne et de Préhistoire de la Martinique,2020,MARTINIQUE,FORT-DE-FRANCE,1574,622,2196,M1065
Musée Régional d'Histoire et d'Ethnologie,2020,MARTINIQUE,FORT-DE-FRANCE - MARTINIQUE-,740,1087,1827,M1066
Musée de l'Artillerie,2009,PROVENCE-ALPES-CÔTE D'AZUR,DRAGUIGNAN,0,19006,19006,
MuMa - Musée de Mayotte,2020,MAYOTTE,DZAOUDZI,0,868,868,M1212
Musée Archéologique,2009,PROVENCE-ALPES-CÔTE D'AZUR,SAINT-RAPHAËL,0,18712,18712,
Tapisserie de Bayeux - MAHB Musée d'Art et d'Histoire Baron Gérard,2020,NORMANDIE,BAYEUX,86532,13127,99659,M0655
Musée du Vêtement Provençal (Jean Aicard),2009,PROVENCE-ALPES-CÔTE D'AZUR,SOLLIES-VILLE,0,4754,4754,
Musée des Beaux-Arts,2020,NORMANDIE,CAEN,30750,41880,72630,M0657
Musée du Petit Palais,2009,PROVENCE-ALPES-CÔTE D'AZUR,AVIGNON,36877,21856,58733,
Musée d'Initiation à la Nature,2020,NORMANDIE,CAEN,0,2262,2262,M7072
Musée de la Meunerie - Moulin de Marcy,2020,NORMANDIE,LE MOLAY-LITTRY,737,234,971,M0664
Musée-Bibliothèque François Pétrarque,2009,PROVENCE-ALPES-CÔTE D'AZUR,FONTAINE-DE-VAUCLUSE,2496,944,3440,
Château de Saint-Germain de Livet,2020,NORMANDIE,SAINT-GERMAIN-DE-LIVET,7762,7238,15000,M0668
Musée du Bugey-Valmorey,2009,RHONE-ALPES,LOCHIEU,2410,2268,4678,
Paléospace,2020,NORMANDIE,VILLERS-SUR-MER,35861,4432,40293,M7063
Musée de l'Ancien Evêché,2020,NORMANDIE,EVREUX,0,10609,10609,M0703
Musée Thomas Henry,2020,NORMANDIE,CHERBOURG-EN-COTENTIN,3804,7297,11101,M0677
Musée du Rhône,2009,RHONE-ALPES,TOURNON-SUR-RHÔNE,5909,4001,9910,
Musée Richard Anacréon,2020,NORMANDIE,GRANVILLE,3768,3146,6914,M0683
Musée International de la Chaussure,2009,RHONE-ALPES,ROMANS,18914,13409,32323,
"Musée du Bocage Normand, ferme du bois Jugan",2020,NORMANDIE,SAINT-LÔ,1122,0,1122,M0686
Musée d'Archéologie Tricastine,2009,RHONE-ALPES,SAINT-PAUL-TROIS-CHATEAUX,1019,3610,4629,
Musée des Beaux-Arts et de la Dentelle,2020,NORMANDIE,ALENCON,8712,0,8712,M0694
Musée Alpin,2009,RHONE-ALPES,CHAMONIX,12293,6383,18676,
Musée Départemental des Arts et Traditions Populaires du Perche,2020,NORMANDIE,SAINT-CYR-LA-ROSIERE,3236,3880,7116,M0699
Musée Jadis Allevard,2009,RHONE-ALPES,ALLEVARD-LES-BAINS,1080,4727,5807,
Musée du Prieuré,2020,NORMANDIE,HARFLEUR,47,206,253,M0717
Musée de la Résistance de la Déportation de l'Isère,2009,RHONE-ALPES,GRENOBLE,0,22325,22325,
Musée des Traditions et Arts Normands,2020,NORMANDIE,MARTAINVILLE-EPREVILLE,5038,5412,10450,M0725
Musée de Grenoble,2009,RHONE-ALPES,GRENOBLE,58232,102288,160520,
Musée Départemental Pierre Corneille,2020,NORMANDIE,PETIT-COURONNE,0,1349,1349,M0722
Musée Dauphinois,2009,RHONE-ALPES,GRENOBLE,0,57597,57597,
Museoseine - Le Musée de la Seine Normande,2020,NORMANDIE,RIVES-EN-SEINE,4065,2450,6515,M0711
Maison du Patrimoine de Hières-sur-Amby,2009,RHONE-ALPES,HIERES SUR AMBY,12065,0,12065,
Musée de la Céramique,2020,NORMANDIE,ROUEN,5437,2702,8139,M0730
Musée Hébert,2009,RHONE-ALPES,LA TRONCHE,0,38676,38676,
Musée-Cloître Saint-André-Le-Bas,2009,RHONE-ALPES,VIENNE,3266,3782,7048,
Musée Municipal des Ivoires,2020,NORMANDIE,YVETOT,411,79,490,M0737
Musée Hospitalier,2009,RHONE-ALPES,CHARLIEU,3037,1315,4352,
Musée du Cloître de Tulle André Mazeyrie,2020,NOUVELLE-AQUITAINE,TULLE,0,4082,4082,M0500
Musée Historique des Tissus,2009,RHONE-ALPES,LYON,90420,41380,131800,
Musée de la Mémoire et des Industries Tullistes,2020,NOUVELLE-AQUITAINE,TULLE,0,392,392,M1191
Lugdunum - Musée et Théâtres Romains,2009,RHONE-ALPES,LYON,20995,53249,74244,
Musée Départemental de la Tapisserie,2020,NOUVELLE-AQUITAINE,AUBUSSON,19981,5904,25885,M0502
Muséum d'Histoire Naturelle,2009,RHONE-ALPES,LYON,0,66777,66777,
Musée des Sapeurs-Pompiers de Lyon,2009,RHONE-ALPES,LYON,0,9014,9014,
Musée ethnographique et archéologique du Donjon,2020,NOUVELLE-AQUITAINE,NIORT,6412,6726,13138,M0842
Musée d'Art Contemporain de Lyon,2009,RHONE-ALPES,LYON,88408,26188,114596,
Musée d'Art et d'Histoire Georges Turpin,2020,NOUVELLE-AQUITAINE,PARTHENAY,0,2491,2491,M0843
Musée Henri Malartre,2009,RHONE-ALPES,ROCHETAILLEE-SUR-SAONE,19946,18578,38524,
Musée Militaire - Souvenir du Périgord,2020,NOUVELLE-AQUITAINE,PERIGUEUX,1530,388,1918,M0056
Musée Tomi Ungerer,2010,ALSACE,STRASBOURG,15275,24133,39408,
Musée Gallo-Romain de Vesunna,2020,NOUVELLE-AQUITAINE,PERIGUEUX,14638,8898,23536,M1188
Musée des Beaux-Arts,2020,NOUVELLE-AQUITAINE,BORDEAUX,9352,27726,37078,M0065
Musée Théodore Deck et des Pays du Florival,2010,ALSACE,GUEBWILLER,1988,2256,4244,
Musée des Beaux-Arts et d'Archéologie,2020,NOUVELLE-AQUITAINE,LIBOURNE,0,5947,5947,M0072
Cité du Train,2010,ALSACE,MULHOUSE,76999,7245,84244,
Musée National Adrien Dubouché,2020,NOUVELLE-AQUITAINE,LIMOGES,9169,8155,17324,M5015
Musée du Papier Peint,2010,ALSACE,RIXHEIM,6471,4008,10479,
Musée Municipal du Lac,2020,NOUVELLE-AQUITAINE,SANGUINET,710,604,1314,M0085
Château de Bourdeilles,2010,AQUITAINE,BOURDEILLES,22732,0,22732,
Musée du Liège et du Bouchon,2020,NOUVELLE-AQUITAINE,MEZIN,1533,475,2008,M1163
Musée des Arts et Traditions Populaires du Périgord,2010,AQUITAINE,MUSSIDAN,1130,875,2005,
Musée du Château Henri IV,2020,NOUVELLE-AQUITAINE,NERAC,3179,928,4107,M0089
Musée d'Aquitaine,2010,AQUITAINE,BORDEAUX,12108,117920,130028,
Musée de Préhistoire Raymond Touchard,2020,NOUVELLE-AQUITAINE,LUSSAC-LES-CHATEAUX,1088,2642,3730,M1097
Musée Historique de l'Hydravion,2010,AQUITAINE,BISCARROSSE,13829,4074,17903,
Musée du baptistère Saint-Jean,2020,NOUVELLE-AQUITAINE,POITIERS,5546,189,5735,M0855
Musée Despiau-Wlérick,2010,AQUITAINE,MONT-DE-MARSAN,0,39915,39915,
Collection d'Histoire Naturelle,2020,NOUVELLE-AQUITAINE,POITIERS,6000,14000,20000,M7057
Musée du Liège et du Bouchon,2010,AQUITAINE,MEZIN,4884,824,5708,
Musée du Château Henri IV,2010,AQUITAINE,NERAC,19913,6747,26660,
Musée Sainte-Croix,2020,NOUVELLE-AQUITAINE,POITIERS,3370,15299,18669,M0852
Musée Edmond Rostand,2010,AQUITAINE,CAMBO-LES-BAINS,63697,5503,69200,
Musée du Textile et du Peigne en Corne,2020,OCCITANIE,LAVELANET,1251,230,1481,M1090
Musée des Musiques Populaires - MuPop,2010,AUVERGNE,MONTLUCON,1644,2703,4347,
Musée Anne de Beaujeu,2010,AUVERGNE,MOULINS,13236,3154,16390,
Musée Archéologique,2020,OCCITANIE,SALLELES-D'AUDE,2319,1300,3619,M0446
Centre National du Costume de Scène et de la Scénographie,2010,AUVERGNE,MOULINS,55995,12610,68605,
Musée des Corbières,2020,OCCITANIE,SIGEAN,172,415,587,M0447
Musée Rieckotter,2010,AUVERGNE,NERIS-LES-BAINS,418,434,852,
Musée des Beaux-Arts Denys Puech,2020,OCCITANIE,RODEZ,0,5169,5169,M0550
Musée Municipal de Souvigny,2010,AUVERGNE,SOUVIGNY,8304,3100,11404,
Musée Municipal Georges Borias,2020,OCCITANIE,UZES Cedex,166,686,852,M0463
Musée des Arts D'Afrique et D'Asie,2010,AUVERGNE,VICHY,2283,1859,4142,
Musée Archéologique,2020,OCCITANIE,EAUZE,4129,1505,5634,M0571
Musée d'art et d'histoire Alfred Douët,2010,AUVERGNE,SAINT-FLOUR,1263,1342,2605,
Musée Archéologique,2020,OCCITANIE,SAINT-BERTRAND-DE-COMMINGES,0,9819,9819,M0560
Musée des Arts et Traditions Populaires de Haute Loire,2010,AUVERGNE,LAVAUDIEU,10453,689,11142,
Musée Saint-Raymond,2020,OCCITANIE,TOULOUSE,30488,0,30488,M0563
Muséum d'Histoire Naturelle Henri-Lecoq,2010,AUVERGNE,CLERMONT-FERRAND,3979,21915,25894,
Musée Municipal de la Coutellerie,2010,AUVERGNE,THIERS,22518,4949,27467,
Musée Bonaparte,2010,BOURGOGNE,AUXONNE,0,2605,2605,
Musée Champollion - Les Ecritures du Monde,2020,OCCITANIE,FIGEAC,17641,6179,23820,M0578
Muséum - Jardin des Sciences,2010,BOURGOGNE,DIJON,4618,85383,90001,
Musée Hyacinthe Rigaud,2020,OCCITANIE,PERPIGNAN,6631,7338,13969,M0491
Musée des Beaux-Arts,2010,BOURGOGNE,MONTBARD,0,621,621,
Musée des Monnaies et Médailles Joseph Puig,2020,OCCITANIE,PERPIGNAN,0,739,739,M0492
Musée Municipal,2010,BOURGOGNE,NUITS-SAINT-GEORGES,529,2664,3193,
Musée Eugénie et Maurice Guérin,2020,OCCITANIE,ANDILLAC,0,2822,2822,M0593
Musée Municipal,2010,BOURGOGNE,SEMUR-EN-AUXOIS,1026,4190,5216,
Musée de l'Abbaye Saint-Michel,2020,OCCITANIE,GAILLAC,238,58,296,M0598
Musée Théodore Calbet,2020,OCCITANIE,GRISOLLES,0,1600,1600,M0605
Musée de la Mine,2010,BOURGOGNE,BLANZY,10337,1293,11630,
Musée des Marais Salant,2020,PAYS DE LA LOIRE,BATZ-SUR-MER,8367,3300,11667,M1124
Ecomusée de la Communauté Le Creusot-Monceau-Les-Mines,2010,BOURGOGNE,LE CREUSOT,11764,3703,15467,
Musée du Château des Ducs de Bretagne,2020,PAYS DE LA LOIRE,NANTES,69016,69068,138084,M0744
Musée Départemental du Compagnonnage,2010,BOURGOGNE,ROMANECHE-THORINS,1798,1411,3209,
Muséum d'Histoire Naturelle de Nantes,2020,PAYS DE LA LOIRE,NANTES,21822,36380,58202,M7049
Musée du Terroir,2010,BOURGOGNE,ROMENAY,1971,709,2680,
Musée Jean Lurcat et de la Tapisserie Contemporaine,2020,PAYS DE LA LOIRE,ANGERS,6567,12140,18707,M0751
Musée d'Art et d'Histoire,2010,BOURGOGNE,AUXERRE,6924,22429,29353,
Musée Joseph Denais,2020,PAYS DE LA LOIRE,BEAUFORT-EN-VALLEE,1661,1110,2771,M0753
Musée Communal Robert Tatin,2020,PAYS DE LA LOIRE,COSSE-LE-VIVIEN,10613,6204,16817,M0762
Musée de la Pêche,2010,BRETAGNE,CONCARNEAU,28149,4427,32576,
Musée des Phares et Balises,2010,BRETAGNE,OUESSANT,12479,4077,16556,
Ecomusée des Monts d'Arrée - Maison Cornec,2010,BRETAGNE,RIVOAL,4209,2791,7000,
Musée de l'Ardoise et de la Géologie,2020,PAYS DE LA LOIRE,RENAZE,267,75,342,M0768
Musée de Préhistoire J. Miln- Z. Le-Rouzic,2010,BRETAGNE,CARNAC,25332,5824,31156,
Musée Vert Véron-de-Forbonnais,2020,PAYS DE LA LOIRE,LE MANS,2777,2772,5549,M1192
Ecomusée de l'Île de Groix,2010,BRETAGNE,ILE DE GROIX,6597,980,7577,
Centre Minier de Faymoreau,2020,PAYS DE LA LOIRE,FAYMOREAU-LES-MINES,8258,2382,10640,M0772
Musée de la Compagnie des Indes,2010,BRETAGNE,PORT-LOUIS,35827,25472,61299,
Musée National Clemenceau-de Lattre,2020,PAYS DE LA LOIRE,MOUILLERON-EN-PAREDS,1544,1082,2626,M5049
Musée Picasso,2020,PROVENCE-ALPES-CÔTE D'AZUR,ANTIBES,43175,0,43175,M0867
Musée du Berry,2010,CENTRE,BOURGES,0,14612,14612,
Musée Fernand Léger,2020,PROVENCE-ALPES-CÔTE D'AZUR,BIOT,7303,6313,13616,M5028
Musée d'Histoire Naturelle Gabriel Foucher,2010,CENTRE,BOURGES,11075,15029,26104,
Musée Archéologique - Site de  Cimiez,2020,PROVENCE-ALPES-CÔTE D'AZUR,NICE,5211,8110,13321,M0883
Musée Emile Chénon,2010,CENTRE,CHATEAUMEILLANT,778,3077,3855,
Musée National Message Biblique Marc Chagall,2020,PROVENCE-ALPES-CÔTE D'AZUR,NICE,25221,20836,46057,M5029
"Musée Magnelli, Musée de la Céramique",2020,PROVENCE-ALPES-CÔTE D'AZUR,VALLAURIS,5738,2984,8722,M0892
Conservatoire du Machinisme et des Pratiques Agricoles,2010,CENTRE,CHARTRES-MAINVILLIERS,6104,43271,49375,
Musée d'art et d'histoire - Musées de la Citadelle,2020,PROVENCE-ALPES-CÔTE D'AZUR,VILLEFRANCHE-SUR-MER,0,72,72,M0893
Musée de l'Histoire du Perche,2010,CENTRE,NOGENT-LE-ROTROU,9737,8045,17782,
Musée- Atelier de Paul Cézanne,2020,PROVENCE-ALPES-CÔTE D'AZUR,AIX-EN-PROVENCE,14971,0,14971,M0895
Musée George Sand et de la Vallée Noire,2010,CENTRE,LA CHATRE,2942,1201,4143,
Musée des Docks Romains,2020,PROVENCE-ALPES-CÔTE D'AZUR,MARSEILLE,0,1777,1777,M0916
Musée Ornithologique (Ecomusée de la Brenne),2010,CENTRE,LE BLANC,2526,1687,4213,
Musée du Vieux Chinon,2010,CENTRE,CHINON,3046,0,3046,
Musée des Alpilles Pierre de Brun,2020,PROVENCE-ALPES-CÔTE D'AZUR,SAINT-REMY-DE-PROVENCE,671,7198,7869,M0926
Musée Municipal,2010,CENTRE,SAINTE-MAURE-DE-TOURAINE,174,41,215,
Musée François Rabelais,2010,CENTRE,SEUILLY,9478,3034,12512,
Musée du Petit Palais,2020,PROVENCE-ALPES-CÔTE D'AZUR,AVIGNON,0,21430,21430,M0947
Musée de la Corbillière,2010,CENTRE,MER,0,1226,1226,
Atelier Musée Louis Leygue,2010,CENTRE,NAVEIL,0,51,51,
Synagogue Musée Juif Comtadin,2020,PROVENCE-ALPES-CÔTE D'AZUR,CAVAILLON,1477,585,2062,M0954
Musée de la Marine de Loire,2010,CENTRE,CHATEAUNEUF-SUR-LOIRE,8502,5623,14125,
Musée-Bibliothèque François Pétrarque,2020,PROVENCE-ALPES-CÔTE D'AZUR,FONTAINE-DE-VAUCLUSE,739,870,1609,M0956
Musée Gaston Couté,2010,CENTRE,MEUNG-SUR-LOIRE,0,2647,2647,
Musée Archéologique Théo Desplans,2020,PROVENCE-ALPES-CÔTE D'AZUR,VAISON-LA-ROMAINE,35240,2086,37326,M0961
Musée du Feutre,2010,CHAMPAGNE-ARDENNES,MOUZON,4013,637,4650,
Musée Paul Dubois-Alfred Boucher,2010,CHAMPAGNE-ARDENNES,NOGENT-SUR-SEINE,0,890,890,
Musée Saint-Rémi,2010,CHAMPAGNE-ARDENNES,REIMS,5636,42493,48129,
Musée des Beaux-Arts de Saint-Denis,2010,CHAMPAGNE-ARDENNES,REIMS,15395,32880,48275,
Musée d'archéologie d'Aleria - Jérôme Carcopino,2010,CORSE,ALERIA,31484,27542,59026,
Musée Départemental Albert-et-Félicie Demard - ATP,2010,FRANCHE-COMTE,CHAMPLITTE,11180,7126,18306,
Musée Georges Garret,2010,FRANCHE-COMTE,VESOUL,0,5357,5357,
Musée Municipal d'Archéologie,2010,FRANCHE-COMTE,CHAMPAGNOLE,259,323,582,
Donation Maurice Jardot,2010,FRANCHE-COMTE,BELFORT,3500,0,3500,
Forge-Musée,2010,FRANCHE-COMTE,ETUEFFONT,1191,906,2097,
Musée Précolombien Edgar Clerc,2010,GUADELOUPE,LE MOULE,0,7470,7470,
Musée Français de la Photographie,2010,ILE-DE-FRANCE,BIEVRES,4630,1396,6026,
Etablissement public Sèvres - Cité de la céramique,2010,ILE-DE-FRANCE,SEVRES,22544,17531,40075,
Musée National des Arts et des Traditions Populaires (MuCem),2010,ILE-DE-FRANCE,PARIS,0,13832,13832,
Maison de Victor Hugo,2010,ILE-DE-FRANCE,PARIS,26221,136437,162658,
Musée National Eugène Delacroix,2010,ILE-DE-FRANCE,PARIS,46188,21384,67572,
Musée National Gustave Moreau,2010,ILE-DE-FRANCE,PARIS,20865,17800,38665,
Musée National Jean-Jacques Henner,2010,ILE-DE-FRANCE,PARIS,8729,4699,13428,
"Petit Palais, Musée des Beaux-Arts de la ville de Paris",2010,ILE-DE-FRANCE,PARIS,302510,393245,695755,
Musée de la Vie Romantique,2010,ILE-DE-FRANCE,PARIS,63105,77563,140668,
"Musée Cognacq-Jay, Musée du XVIIIe siècle de la ville de Paris",2010,ILE-DE-FRANCE,PARIS,5239,38847,44086,
Musée d'Art Moderne de la ville de Paris,2010,ILE-DE-FRANCE,PARIS,365147,314464,679611,
Établissement Public de la Porte Dorée - Cité Nationale de l’Histoire de l’Immigration,2010,ILE-DE-FRANCE,PARIS,11174,97775,108949,
Musée des Arts d'Afrique et d'Océanie - Aquarium de la Porte Dorée,2010,ILE-DE-FRANCE,PARIS,154294,102857,257151,
"Musée Cernuschi, Musée des Arts de l'Asie de la ville de Paris",2010,ILE-DE-FRANCE,PARIS,30436,39847,70283,
Musée Départemental de l'Ecole de Barbizon - Auberge Ganne,2010,ILE-DE-FRANCE,BARBIZON,10879,7660,18539,
Musée d'Art et d'Histoire Militaire,2010,ILE-DE-FRANCE,FONTAINEBLEAU,807,2027,2834,
Musée Gatien Bonnet,2010,ILE-DE-FRANCE,LAGNY-SUR-MARNE,301,1538,1839,
Musée Henri Chapu,2010,ILE-DE-FRANCE,LE MEE-SUR-SEINE,0,376,376,
Musée Municipal,2010,ILE-DE-FRANCE,MORET-SUR-LOING,0,3433,3433,
Musée des Pays de Seine-et-Marne,2010,ILE-DE-FRANCE,SAINT-CYR-SUR-MORIN,1768,10425,12193,
Musée d'Art et d'Histoire,2010,ILE-DE-FRANCE,SAINT-DENIS,3865,28891,32756,
Musée Adrien Mentienne,2010,ILE-DE-FRANCE,BRY-SUR-MARNE,0,1550,1550,
Ecomusée du Val de Bièvre,2010,ILE-DE-FRANCE,FRESNES,0,11117,11117,
Musée du Vieil Argenteuil,2010,ILE-DE-FRANCE,ARGENTEUIL,801,1125,1926,
Musée d'Art et d'Histoire Louis Senlecq,2010,ILE-DE-FRANCE,L'ISLE-ADAM,2123,6951,9074,
Musée jean-Jacques Rousseau,2010,ILE-DE-FRANCE,MONTMORENCY,807,1925,2732,
Musée Zola-Dreyfus,2010,ILE-DE-FRANCE,MEDAN,6105,338,6443,
Musée de la Ville,2010,ILE-DE-FRANCE,MONTIGNY LE BRETONNEUX,7564,4149,11713,
Collections de la Fondation de Coubertin,2010,ILE-DE-FRANCE,SAINT-REMY-LES-CHEVREUSE,4018,2758,6776,
Musée Départemental de la Réunion - Musée Léon Dierx,2010,LA REUNION,SAINT-DENIS,3287,13323,16610,
Musée d'Art et d'Histoire - Ensemble monumental de Narbonne,2010,LANGUEDOC-ROUSSILLON,NARBONNE,58027,262394,320421,
Musée du Vieux Nîmes,2010,LANGUEDOC-ROUSSILLON,NIMES,0,24780,24780,
Carré d'Art Musée d'Art Contemporain de Nîmes,2010,LANGUEDOC-ROUSSILLON,NIMES,12849,28880,41729,
Musée des Beaux-Arts,2010,LANGUEDOC-ROUSSILLON,NIMES,3240,16409,19649,
Musée Agathois,2010,LANGUEDOC-ROUSSILLON,AGDE,2951,1882,4833,
Musée du Biterrois,2010,LANGUEDOC-ROUSSILLON,BEZIERS,4240,12038,16278,
Site Archéologique Lattara - Musée Henri Prades de Montpellier Agglomération,2010,LANGUEDOC-ROUSSILLON,LATTES,8312,13428,21740,
Musée Fleury,2010,LANGUEDOC-ROUSSILLON,LODEVE,57961,11303,69264,
Musée d'Art Moderne - Fonds Peskè,2010,LANGUEDOC-ROUSSILLON,COLLIOURE,7555,2033,9588,
Musée du Castillet Casa Pairal,2010,LANGUEDOC-ROUSSILLON,PERPIGNAN,5929,22633,28562,
Musée de Cerdagne,2010,LANGUEDOC-ROUSSILLON,SAINTE-LEOCADIE,3100,969,4069,
Musée de la Mémoire et des Industries Tullistes,2010,LIMOUSIN,TULLE,0,2690,2690,
Musée de l'Ecole de Nancy,2010,LORRAINE,NANCY,26050,21065,47115,
Musée de la Céramique et de l'Ivoire,2010,LORRAINE,COMMERCY,1173,887,2060,
Musée Jules Bastien-Lepage - Musée de la Fortification,2010,LORRAINE,MONTMEDY,11369,989,12358,
Musée de la Bière et du Pays de Stenay,2010,LORRAINE,STENAY,8035,9205,17240,
Musée d'Argonne,2010,LORRAINE,VARENNES-EN-ARGONNE,1980,0,1980,
Musée du Pays de Sarrebourg,2010,LORRAINE,SARREBOURG,12402,11399,23801,
Musée Départemental Georges de la Tour,2010,LORRAINE,VIC-SUR-SEILLE,8930,6153,15083,
Musée Départemental d'Art Ancien et Contemporain,2010,LORRAINE,EPINAL,3059,17842,20901,
Musée Louis Français,2010,LORRAINE,PLOMBIERES-LES-BAINS,0,195,195,
Ecomusée de la Martinique,2010,MARTINIQUE,RIVIERE-PILOTE,5137,3039,8176,
Musée Volcanologique Franck Arnold Perret,2010,MARTINIQUE,SAINT-PIERRE,22555,563,23118,
Musée Régional de Géologie Pierre Vetter,2010,MIDI-PYRENEES,DECAZEVILLE,2517,3029,5546,
Musée des Beaux-Arts Denys Puech,2010,MIDI-PYRENEES,RODEZ,1203,9136,10339,
Musée des Arts et Métiers Traditionnels,2010,MIDI-PYRENEES,SALLES-LA-SOURCE,7017,2154,9171,
Musée Municipal Urbain Cabrol,2010,MIDI-PYRENEES,VILLEFRANCHE-DE-ROUERGUE,0,4576,4576,
Musée d'Archéologie,2010,MIDI-PYRENEES,LECTOURE,1400,684,2084,
Musée Campanaire,2010,MIDI-PYRENEES,L'ISLE JOURDAIN,6057,3623,9680,
Musée Joseph Abeilhé,2010,MIDI-PYRENEES,MARCIAC,52,60,112,
Le Musée - Arts et Figures des Pyrénées Centrales,2010,MIDI-PYRENEES,SAINT-GAUDENS,0,5220,5220,
Muséum d'Histoire Naturelle,2010,MIDI-PYRENEES,BAGNERES-DE-BIGORRE,621,102,723,
Musée de Préhistoire Amédée Lémozi,2010,MIDI-PYRENEES,CABRERETS,73059,0,73059,
Musée Champollion - Les Ecriture du Monde,2010,MIDI-PYRENEES,FIGEAC,39718,9185,48903,
Musée Jean Jaurès,2010,MIDI-PYRENEES,CASTRES,2935,10940,13875,
Musée du Protestantisme en Haut-Languedoc,2010,MIDI-PYRENEES,FERRIERES,1704,1668,3372,
Musée Départemental du Textile,2010,MIDI-PYRENEES,LA-BASTIDE-ROUAIROUX,2245,2143,4388,
Musée Théodore Calbet,2010,MIDI-PYRENEES,GRISOLLES,0,2092,2092,
Musée du Mont-de-Piété,2010,NORD-PAS-DE-CALAIS,BERGUES,2200,0,2200,
Musée Portuaire,2010,NORD-PAS-DE-CALAIS,DUNKERQUE,28740,20546,49286,
Musée du Dessin et de l'Estampe Originale,2010,NORD-PAS-DE-CALAIS,GRAVELINES,7556,5081,12637,
Musée Municipal,2010,NORD-PAS-DE-CALAIS,SAINT-AMAND-LES-EAUX,0,6707,6707,
Musée du Verre,2010,NORD-PAS-DE-CALAIS,SARS-POTERIES,4905,3963,8868,
Musée des Beaux-Arts,2010,NORD-PAS-DE-CALAIS,VALENCIENNES,14928,19917,34845,
Musée de la Céramique,2010,NORD-PAS-DE-CALAIS,DESVRES,6889,586,7475,
Musée Jean-Charles Cazin,2010,NORD-PAS-DE-CALAIS,SAMER,0,602,602,
Musée Baron Gérard,2010,BASSE-NORMANDIE,BAYEUX,4817,0,4817,
Musée Municipal,2010,BASSE-NORMANDIE,VIRE NORMANDIE,1418,5175,6593,
Musée Municipal d'Avranches,2010,BASSE-NORMANDIE,AVRANCHES,0,1860,1860,
Muséum Emmanuel Liais,2010,BASSE-NORMANDIE,CHERBOURG-EN-COTENTIN,0,15312,15312,
Musée Maritime de l'Ile de Tatihou,2010,BASSE-NORMANDIE,SAINT-VAAST-LA-HOUGUE,56501,3197,59698,
Musée de la Poeslerie,2010,BASSE-NORMANDIE,VILLEDIEU-LES-POELES-ROUFFIGNY,10211,895,11106,
Musée Départemental d'Art Sacré,2010,BASSE-NORMANDIE,SEES,943,281,1224,
Museoseine,2010,HAUTE-NORMANDIE,CAUDEBEC-EN-CAUX,2257,1169,3426,
Musée d'Elbeuf,2010,HAUTE-NORMANDIE,ELBEUF,0,4712,4712,
Musée Mathon-Durand,2010,HAUTE-NORMANDIE,NEUFCHATEL-EN-BRAY,624,1885,2509,
MUNAE - Musée National de l'Education,2010,HAUTE-NORMANDIE,ROUEN,1842,10091,11933,
Muséum d'Histoire Naturelle,2010,HAUTE-NORMANDIE,ROUEN,19802,21359,41161,
Musée Municipal des Ivoires,2010,HAUTE-NORMANDIE,YVETOT,699,427,1126,
Galerie David d'Angers,2010,PAYS DE LA LOIRE,ANGERS,6727,15467,22194,
Musée Communal Robert Tatin,2010,PAYS DE LA LOIRE,COSSE-LE-VIVIEN,16060,6586,22646,
Musée du Château de Mayenne,2010,PAYS DE LA LOIRE,MAYENNE,11664,8504,20168,
Musée de la Reine Bérengère,2010,PAYS DE LA LOIRE,LE MANS,2496,3730,6226,
Musée Espace Faïence de Malicorne,2010,PAYS DE LA LOIRE,MALICORNE-SUR-SARTHE,23050,8500,31550,
Centre Minier de Faymoreau,2010,PAYS DE LA LOIRE,FAYMOREAU,17601,8994,26595,
Musée de Fontenay-le-Comte,2010,PAYS DE LA LOIRE,FONTENAY-LE-COMTE,2295,3608,5903,
Musée du Nord de la Vendée,2010,PAYS DE LA LOIRE,MONTAIGU,0,650,650,
Musée Entomologique,2010,PICARDIE,SAINT-QUENTIN,4248,6003,10251,
Musée des Beaux-Arts Antoine Lecuyer,2010,PICARDIE,SAINT-QUENTIN,4209,7248,11457,
Musée Pillon,2010,PICARDIE,CHAUMONT-EN-VEXIN,0,578,578,
Musée de la Figurine Historique,2010,PICARDIE,COMPIEGNE,4251,3255,7506,
Musée de la Nacre et de la Tabletterie,2010,PICARDIE,MERU,13864,5545,19409,
Musée de la Vénerie,2010,PICARDIE,SENLIS,7061,6695,13756,
Musée Alfred Danicourt,2010,PICARDIE,PERONNE,0,1654,1654,
Atelier - Musée du Papier,2010,POITOU-CHARENTES,ANGOULEME,0,12073,12073,
Musée d'Orbigny-Bernon,2010,POITOU-CHARENTES,LA ROCHELLE,2237,6501,8738,
Musée Municipal des Cordeliers,2010,POITOU-CHARENTES,SAINT-JEAN-D'ANGELY,101,5188,5289,
Musée Ernest Cognacq,2010,POITOU-CHARENTES,SAINT-MARTIN-DE-RE,5884,3842,9726,
Musée d'Art et d'Histoire Georges Turpin,2010,POITOU-CHARENTES,PARTHENAY,0,9392,9392,
Musée Municipal de Civray,2010,POITOU-CHARENTES,CIVRAY,0,335,335,
Musée de Préhistoire Raymond Touchard,2010,POITOU-CHARENTES,LUSSAC-LES-CHATEAUX,679,1367,2046,
Collection d'Histoire Naturelle,2010,POITOU-CHARENTES,POITIERS,50100,0,50100,
Musée Picasso,2010,PROVENCE-ALPES-CÔTE D'AZUR,ANTIBES,83158,49810,132968,
Musée d'Histoire Locale,2010,PROVENCE-ALPES-CÔTE D'AZUR,BIOT,6029,0,6029,
Musée Fernand Léger,2010,PROVENCE-ALPES-CÔTE D'AZUR,BIOT,20308,16524,36832,
Musée-Château de Cagnes,2010,PROVENCE-ALPES-CÔTE D'AZUR,CAGNES-SUR-MER,18104,8379,26483,
Musée Renoir,2010,PROVENCE-ALPES-CÔTE D'AZUR,CAGNES-SUR-MER,34081,10586,44667,
Musée d'Art et d'Histoire de Provence,2010,PROVENCE-ALPES-CÔTE D'AZUR,GRASSE,0,13599,13599,
Musée Départemental des Arts Asiatiques,2010,PROVENCE-ALPES-CÔTE D'AZUR,NICE,3695,70531,74226,
Musée d'Art Moderne et d'Art Contemporain,2010,PROVENCE-ALPES-CÔTE D'AZUR,NICE,0,163247,163247,
Muséum d'Histoire Naturelle,2010,PROVENCE-ALPES-CÔTE D'AZUR,AIX-EN-PROVENCE,10998,34279,45277,
Musée- Atelier de Paul Cézanne,2010,PROVENCE-ALPES-CÔTE D'AZUR,AIX-EN-PROVENCE,52620,15034,67654,
Cabinet des Monnaies et Médailles de Marseille,2010,PROVENCE-ALPES-CÔTE D'AZUR,MARSEILLE,0,1665,1665,
Musée de la Faïence,2010,PROVENCE-ALPES-CÔTE D'AZUR,MARSEILLE,2186,6573,8759,
Musée d'Art Contemporain - Galeries Contemporaines,2010,PROVENCE-ALPES-CÔTE D'AZUR,MARSEILLE,4549,15182,19731,
Musée des Alpilles,2010,PROVENCE-ALPES-CÔTE D'AZUR,SAINT-REMY-DE-PROVENCE,2554,6020,8574,
Musée Départemental des Hautes-Alpes,2010,PROVENCE-ALPES-CÔTE D'AZUR,GAP,0,12958,12958,
Musée Municipal,2010,PROVENCE-ALPES-CÔTE D'AZUR,DRAGUIGNAN,0,12903,12903,
Muséum d'Histoire Naturelle de Toulon,2010,PROVENCE-ALPES-CÔTE D'AZUR,TOULON,0,5755,5755,
Musée d'Art et d'Archéologie,2010,PROVENCE-ALPES-CÔTE D'AZUR,TOULON,0,17400,17400,
Musée d'Apt,2010,PROVENCE-ALPES-CÔTE D'AZUR,APT,2052,4557,6609,
Musée Calvet (et musée Lapidaire),2010,PROVENCE-ALPES-CÔTE D'AZUR,AVIGNON,13604,22078,35682,
Musée Municipal Camille Pautet,2010,PROVENCE-ALPES-CÔTE D'AZUR,MAZAN,0,3540,3540,
Musée Archéologique Théo Desplans,2010,PROVENCE-ALPES-CÔTE D'AZUR,VAISON-LA-ROMAINE,61849,7465,69314,
Musée du Vieux Pérouges,2010,RHONE-ALPES,PEROUGES,12550,2100,14650,
Cité de Préhistoire,2010,RHONE-ALPES,ORGNAC-L'AVEN,94664,4428,99092,
Musée d'Histoire et d'Archéologie,2010,RHONE-ALPES,DIE,661,1421,2082,
Musée du Château des Adhémars,2010,RHONE-ALPES,MONTELIMAR,14599,0,14599,
Musée d'Art Sacré,2010,RHONE-ALPES,MOURS SAINT-EUSEBE,1262,0,1262,
Musée des Beaux-Arts,2010,RHONE-ALPES,VALENCE,0,2197,2197,
Musée Matheysin,2010,RHONE-ALPES,LA MURE,1017,1598,2615,
Musée de la Grande Chartreuse,2010,RHONE-ALPES,SAINT-PIERRE-DE-CHARTREUSE,42506,3867,46373,
Musée d'Archéologie,2010,RHONE-ALPES,FEURS,905,5105,6010,
Musée des Beaux-Arts et d'Archéologie J. Dechelette,2010,RHONE-ALPES,ROANNE,2364,11111,13475,
Musée Folklorique du Vieux Saint-Etienne,2010,RHONE-ALPES,SAINT-ETIENNE,622,1402,2024,
Château de la Bastie d'Urfé,2010,RHONE-ALPES,SAINT-ETIENNE-LE-MOLARD,10999,14558,25557,
Musée de l'Imprimerie et de la Communication Graphique,2010,RHONE-ALPES,LYON,13949,10776,24725,
Musée d'Art Contemporain de Lyon,2010,RHONE-ALPES,LYON,87114,39721,126835,
Musée Savoisien,2010,RHONE-ALPES,CHAMBERY,8140,11918,20058,
Musée Alsacien,2011,ALSACE,HAGUENAU,1168,1002,2170,
Maison de l'Archéologie des Vosges du Nord,2011,ALSACE,NIEDERBRONN-LES-BAINS,2375,2810,5185,
Musée de l'Image Populaire de Pfaffenhoffen,2011,ALSACE,PFAFFENHOFFEN,1966,1895,3861,
Musée Historique,2011,ALSACE,STRASBOURG,10034,26547,36581,
Musée des Arts Décoratifs,2011,ALSACE,STRASBOURG,9220,40362,49582,
Musée Lalique,2011,ALSACE,WINGEN-SUR-MODER,50749,14596,65345,
Musée de la Porte de Thann,2011,ALSACE,CERNAY,1200,260,1460,
Cité du Train,2011,ALSACE,MULHOUSE,82012,4803,86815,
Musée du Papier Peint,2011,ALSACE,RIXHEIM,6256,4414,10670,
Musée des Amis de Thann,2011,ALSACE,THANN,759,1652,2411,
Musée Fernand Desmoulin,2011,AQUITAINE,BRANTOME,16593,3812,20405,
Musée Militaire - Souvenir du Périgord,2011,AQUITAINE,PERIGUEUX,1911,487,2398,
Musée de Sarlat et du Périgord Noir,2011,AQUITAINE,SARLAT-LA-CANEDA,0,3200,3200,
Musée Historique de l'Hydravion,2011,AQUITAINE,BISCARROSSE,19019,2610,21629,
Musée Archéologique,2011,AQUITAINE,HASTINGUES,9407,6759,16166,
Musée Municipal du Lac,2011,AQUITAINE,SANGUINET,2023,153,2176,
Musée des Beaux-Arts,2011,AQUITAINE,AGEN,7366,16261,23627,
Musée National du Château,2011,AQUITAINE,PAU,76917,46222,123139,
Musée Bernadotte,2011,AQUITAINE,PAU,4119,0,4119,
Musée Municipal de Gannat,2011,AUVERGNE,GANNAT,1262,915,2177,
Musée des Arts D'Afrique et D'Asie,2011,AUVERGNE,VICHY,1932,1549,3481,
Musée d'Art et d'Archéologie,2011,AUVERGNE,AURILLAC,1976,19625,21601,
Musée d'art et d'histoire Alfred Douët,2011,AUVERGNE,SAINT-FLOUR,1354,1374,2728,
Musée de Paléontologie,2011,AUVERGNE,CHILHAC,2087,263,2350,
Musée Crozatier,2011,AUVERGNE,LE PUY-EN-VELAY,256,320,576,
Musée de la Dentelle,2011,AUVERGNE,ARLANC,1065,73,1138,
Musée des Peintres de l'Ecole de Murols,2011,AUVERGNE,MUROL,3803,0,3803,
Musée Bonaparte,2011,BOURGOGNE,AUXONNE,0,3084,3084,
Musée du Vin de Bourgogne,2011,BOURGOGNE,BEAUNE,16532,4382,20914,
Musée Buffon,2011,BOURGOGNE,MONTBARD,0,9771,9771,
Musée Municipal François Pompon,2011,BOURGOGNE,SAULIEU,3197,5658,8855,
Musée Saint-Nazaire,2011,BOURGOGNE,BOURBON-LANCY,21,1101,1122,
Musée des Ursulines,2011,BOURGOGNE,MACON,1808,18635,20443,
Musée Lamartine,2011,BOURGOGNE,MACON,1557,3445,5002,
Musée de l'Aventure du Son,2011,BOURGOGNE,SAINT-FARGEAU,4245,193,4438,
Musée d'Art et d'Histoire du Puisaye,2011,BOURGOGNE,VILLIERS-SAINT-BENOIT,279,1751,2030,
Musée de Pont-Aven,2011,BRETAGNE,PONT-AVEN,27305,12151,39456,
Musée International du Long-Cours Cap-Hornier,2011,BRETAGNE,SAINT-MALO,7268,3449,10717,
Ecomusée de l'Île de Groix,2011,BRETAGNE,ILE DE GROIX,6152,1003,7155,
Musée de la Compagnie des Indes,2011,BRETAGNE,PORT-LOUIS,41176,26649,67825,
Musée d'Histoire et d'Archéologie de Vannes,2011,BRETAGNE,VANNES,3315,4129,7444,
Musée du Berry,2011,CENTRE,BOURGES,0,14601,14601,
Musée d'Histoire Naturelle Gabriel Foucher,2011,CENTRE,BOURGES,18150,10174,28324,
Musée Emile Chénon,2011,CENTRE,CHATEAUMEILLANT,525,3655,4180,
Musée Municipal,2011,CENTRE,VIERZON,0,1134,1134,
Musée Marcel Proust,2011,CENTRE,ILLIERS-COMBRAY,5002,284,5286,
Château Musée,2011,CENTRE,AZAY-LE-FERRON,13144,3084,16228,
Musée Archéologique d'Argentomagus,2011,CENTRE,SAINT-MARCEL,5425,3294,8719,
Muséum d'Histoire Naturelle,2011,CENTRE,TOURS,9331,20733,30064,
Musée des Vins de Touraine,2011,CENTRE,TOURS,901,893,1794,
Musée du Compagnonnage,2011,CENTRE,TOURS,29275,15411,44686,
Musée des Beaux-Arts,2011,CENTRE,TOURS,18290,32950,51240,
Musée de Minerve,2011,CENTRE,YZEURES-SUR-CREUSE,0,950,950,
Musée de Sologne,2011,CENTRE,ROMORANTIN-LANTHENAY,6519,8867,15386,
Musée de Vendôme,2011,CENTRE,VENDOME,1169,7377,8546,
Musée Municipal Théâtre Forain et Archéologique,2011,CENTRE,ARTENAY,6112,3184,9296,
Château-Musée de Gien,2011,CENTRE,GIEN,14986,2331,17317,
Musée des Sciences Naturelles,2011,CENTRE,ORLEANS,7669,49115,56784,
Musée de la Maison de la Dernière Cartouche,2011,CHAMPAGNE-ARDENNES,BAZEILLES,1445,1143,2588,
Musée Paul Dubois-Alfred Boucher,2011,CHAMPAGNE-ARDENNES,NOGENT-SUR-SEINE,2131,2999,5130,
Musée de la Coutellerie,2011,CHAMPAGNE-ARDENNES,NOGENT,4649,1450,6099,
Musée Napoléonien,2011,CORSE,AJACCIO,6895,3090,9985,
Musée de la Maison Bonaparte,2011,CORSE,AJACCIO,45610,23432,69042,
Musée d'Histoire de Bastia,2011,CORSE,BASTIA,9232,10687,19919,
Musée de la Corse,2011,CORSE,CORTE,59980,8235,68215,
Musée Baron Martin,2011,FRANCHE-COMTE,GRAY,2474,3208,5682,
Musée Départemental de la Montagne Albert Demard,2011,FRANCHE-COMTE,LE HAUT-DU-THEM,4360,2925,7285,
Forge-Musée,2011,FRANCHE-COMTE,ETUEFFONT,1144,1145,2289,
Musée Municipal Saint-John Perse,2011,GUADELOUPE,POINTE-A-PITRE,2270,349,2619,
Musée des Cultures Guyanaises,2011,GUYANE,CAYENNE,1100,6309,7409,
Ecomusée Municipal d'Approuague-Kaw,2011,GUYANE,REGINA,2430,2720,5150,
Musée Français de la Photographie,2011,ILE-DE-FRANCE,BIEVRES,4097,1177,5274,
Fondation Arp,2011,ILE-DE-FRANCE,CLAMART,1321,269,1590,
Musée National des Châteaux de Malmaison et de Bois-Préau,2011,ILE-DE-FRANCE,RUEIL-MALMAISON,36350,34774,71124,
Musée des Avelines - Musée d'Art et d'Histoire,2011,ILE-DE-FRANCE,SAINT-CLOUD,388,16367,16755,
MUS - Musée d'Histoire Urbaine et Sociale,2011,ILE-DE-FRANCE,SURESNES,0,1721,1721,
Les Catacombes,2011,ILE-DE-FRANCE,PARIS,285264,32860,318124,
Musée National Eugène Delacroix,2011,ILE-DE-FRANCE,PARIS,35270,11684,46954,
Musée National Jean-Jacques Henner,2011,ILE-DE-FRANCE,PARIS,4778,2846,7624,
Musée des Arts d'Afrique et d'Océanie - Aquarium de la Porte Dorée,2011,ILE-DE-FRANCE,PARIS,125216,76505,201721,
"Musée Cernuschi, Musée des Arts de l'Asie de la ville de Paris",2011,ILE-DE-FRANCE,PARIS,17111,48799,65910,
Musée Nissim de Camondo (Les Arts Décoratifs),2011,ILE-DE-FRANCE,PARIS,38220,15792,54012,
Musée du Château de Fontainebleau,2011,ILE-DE-FRANCE,FONTAINEBLEAU,242941,194541,437482,
Musée Bossuet,2011,ILE-DE-FRANCE,MEAUX,13954,0,13954,
Château-musée de Nemours,2011,ILE-DE-FRANCE,NEMOURS,4471,6500,10971,
Musée de l'Air et de l'Espace,2011,ILE-DE-FRANCE,LE BOURGET,158144,159388,317532,
Musée d'Art et d'Histoire,2011,ILE-DE-FRANCE,SAINT-DENIS,5138,21389,26527,
Musée Adrien Mentienne,2011,ILE-DE-FRANCE,BRY-SUR-MARNE,0,4230,4230,
Musée Fragonard,2011,ILE-DE-FRANCE,MAISONS-ALFORT,3268,3747,7015,
Musée Promenade Marly/Louveciennes,2011,ILE-DE-FRANCE,LOUVECIENNES,9985,3097,13082,
Musée de l'Hôtel-Dieu,2011,ILE-DE-FRANCE,MANTES-LA-JOLIE,5803,2988,8791,
Musée Départemental Maurice Denis,2011,ILE-DE-FRANCE,SAINT-GERMAIN-EN-LAYE Cedex,10163,25672,35835,
Muséum Agricole et Industriel Stella Matutina,2011,LA REUNION,PITON-SAINT-LEU,5496,0,5496,
Musée Départemental de la Réunion - Musée Léon Dierx,2011,LA REUNION,SAINT-DENIS,3584,17638,21222,
Musée des Arts Décoratifs de l’Océan indien (MADOI),2011,LA REUNION,SAINT-LOUIS,0,17079,17079,
Musée du Vieux Nîmes,2011,LANGUEDOC-ROUSSILLON,NIMES,0,15510,15510,
Musée d'Histoire Naturelle et de Préhistoire,2011,LANGUEDOC-ROUSSILLON,NIMES,0,49958,49958,
Musée des Beaux-Arts,2011,LANGUEDOC-ROUSSILLON,NIMES,8304,15760,24064,
Musée Paul Raymond,2011,LANGUEDOC-ROUSSILLON,PONT-SAINT-ESPRIT,0,1458,1458,
Musée des Vallées Cévenoles,2011,LANGUEDOC-ROUSSILLON,SAINT-JEAN DU GARD,8567,5781,14348,
Musée National Adrien Dubouché,2011,LIMOUSIN,LIMOGES,5401,4798,10199,
Musée des Beaux-Arts de Nancy,2011,LORRAINE,NANCY,27364,47174,74538,
Musée Jules Bastien-Lepage - Musée de la Fortification,2011,LORRAINE,MONTMEDY,12272,1485,13757,
Musée de la Bière et du Pays de Stenay,2011,LORRAINE,STENAY,8211,10190,18401,
Centre Pompidou de Metz (collections nationales decentralisées),2011,LORRAINE,METZ,287040,264960,552000,
Musée Militaire et Erckmann-Chatrian,2011,LORRAINE,PHALSBOURG,702,46,748,
Musée du Pays de Sarrebourg,2011,LORRAINE,SARREBOURG,10920,10862,21782,
La Tour aux Puces - Musée du Pays Thionvillois,2011,LORRAINE,THIONVILLE,2427,10007,12434,
Musée Départemental Georges de la Tour,2011,LORRAINE,VIC-SUR-SEILLE,5618,6231,11849,
Musée Départemental d'Art Ancien et Contemporain,2011,LORRAINE,EPINAL,2298,10228,12526,
Musée de la Lutherie et de l'Archèterie Française,2011,LORRAINE,MIRECOURT,6179,3497,9676,
Musée du Textile et du Peigne en Corne,2011,MIDI-PYRENEES,LAVELANET,1479,550,2029,
Musée d'Archéologie,2011,MIDI-PYRENEES,MONTSEGUR,0,26762,26762,
Musée du Palais des Evêques,2011,MIDI-PYRENEES,SAINT-LIZIER,9099,2032,11131,
Musée Régional de Géologie Pierre Vetter,2011,MIDI-PYRENEES,DECAZEVILLE,2665,2944,5609,
Musée Municipal de Millau,2011,MIDI-PYRENEES,MILLAU,5406,13519,18925,
Musée du Charroi Rural et de l'Artisanat Traditionnel,2011,MIDI-PYRENEES,SALMIECH,101,1501,1602,
Musée Archéologique,2011,MIDI-PYRENEES,EAUZE,5119,1849,6968,
Musée d'Archéologie,2011,MIDI-PYRENEES,LECTOURE,1850,608,2458,
Musée Campanaire,2011,MIDI-PYRENEES,L'ISLE JOURDAIN,12539,0,12539,
Le Musée - Arts et Figures des Pyrénées Centrales,2011,MIDI-PYRENEES,SAINT-GAUDENS,0,1840,1840,
"Les Abattoirs, Musée d'Art Moderne et Contemporain",2011,MIDI-PYRENEES,TOULOUSE,36917,84912,121829,
Musée Paul Dupuy,2011,MIDI-PYRENEES,TOULOUSE,6905,8618,15523,
Musée des Augustins,2011,MIDI-PYRENEES,TOULOUSE,43735,80250,123985,
Musée Toulouse Lautrec,2011,MIDI-PYRENEES,ALBI,154479,25040,179519,
Musée Eugénie et Maurice Guérin,2011,MIDI-PYRENEES,ANDILLAC,1793,2508,4301,
Musée Théodore Calbet,2011,MIDI-PYRENEES,GRISOLLES,0,4289,4289,
Musée des arts et traditions populaires,2011,MIDI-PYRENEES,MOISSAC,4380,0,4380,
"Musée de la Mine, Centre Historique Minier",2011,NORD-PAS-DE-CALAIS,LEWARDE,133681,16850,150531,
Musée Municipal,2011,NORD-PAS-DE-CALAIS,SAINT-AMAND-LES-EAUX,0,9474,9474,
Musée Municipal Bruno Danvin,2011,NORD-PAS-DE-CALAIS,SAINT-POL-SUR-TERNOISE,0,4756,4756,
Musée du Débarquement,2011,BASSE-NORMANDIE,ARROMANCHES,319612,11530,331142,
Musée de Normandie,2011,BASSE-NORMANDIE,CAEN,38305,50484,88789,
Mémorial de Caen,2011,BASSE-NORMANDIE,CAEN,371000,0,371000,
Musée de la Meunerie - Moulin de Marcy,2011,BASSE-NORMANDIE,LE MOLAY-LITTRY,3501,3745,7246,
Musée du Château,2011,BASSE-NORMANDIE,PONTECOULANT,3755,1116,4871,
Musée Richard Anacréon,2011,BASSE-NORMANDIE,GRANVILLE,5339,4746,10085,
Musée du Vieux Granville,2011,BASSE-NORMANDIE,GRANVILLE,11323,0,11323,
Musée Régional du Cidre et du Calvados,2011,BASSE-NORMANDIE,VALOGNES,6850,1685,8535,
Musée Municipal - Musée du Jouet,2011,BASSE-NORMANDIE,LA FERTE-MACE,1013,337,1350,
Musée du Percheron,2011,BASSE-NORMANDIE,MORTAGNE-AU-PERCHE,0,778,778,
Musée Artisanal et Industriel d'Instruments à Vent,2011,HAUTE-NORMANDIE,LA COUTURE-BOUSSEY,3161,1563,4724,
Musée Louis-Philippe du Château d'Eu,2011,HAUTE-NORMANDIE,EU,10814,4944,15758,
Musée des Terres-Neuvas et de la Pêche,2011,HAUTE-NORMANDIE,FECAMP,16214,24998,41212,
Musée Départemental Pierre Corneille,2011,HAUTE-NORMANDIE,LE PETIT-COURONNE,804,2854,3658,
Musée Mathon-Durand,2011,HAUTE-NORMANDIE,NEUFCHATEL-EN-BRAY,755,1612,2367,
Musée Industriel de la Corderie Vallois,2011,HAUTE-NORMANDIE,NOTRE-DAME-DE-BONDEVILLE,2301,7489,9790,
Musée des Beaux-Arts,2011,HAUTE-NORMANDIE,ROUEN,31440,61283,92723,
Association de l'Horlogerie Aliermontaise,2011,HAUTE-NORMANDIE,SAINT-NICOLAS-D'ALIERMONT,4352,1950,6302,
Musée Victor Hugo,2011,HAUTE-NORMANDIE,VILLEQUIER,5267,7513,12780,
Musée du Château des Ducs de Bretagne,2011,PAYS DE LA LOIRE,NANTES,73647,87671,161318,
Musée du Chaume/Kerhinet - PNR Brière,2011,PAYS DE LA LOIRE,SAINT-LYPHARD,0,97656,97656,
Ecomusée de Saint-Nazaire,2011,PAYS DE LA LOIRE,SAINT-NAZAIRE,6829,15486,22315,
Musée du Textile,2011,PAYS DE LA LOIRE,CHOLET,6832,9141,15973,
Musée du Château de Mayenne,2011,PAYS DE LA LOIRE,MAYENNE,11876,9937,21813,
Musée Entomologique,2011,PICARDIE,SAINT-QUENTIN,3888,7373,11261,
Musée de la Résistance et de la Déportation,2011,PICARDIE,TERGNIER,21204,0,21204,
Musée Départemental de l'Oise,2011,PICARDIE,BEAUVAIS,0,27029,27029,
Musée de la Figurine Historique,2011,PICARDIE,COMPIEGNE,4072,3711,7783,
Musée Archéologique de l'Oise,2011,PICARDIE,VENDEUIL-CAPLY,982,1276,2258,
Musée des Arts du Cognac (Annexe musée municipal),2011,POITOU-CHARENTES,COGNAC,6739,5849,12588,
Musée Régional de Fouras,2011,POITOU-CHARENTES,FOURAS,5244,776,6020,
Musée Napoléonien et Africain,2011,POITOU-CHARENTES,ILE D'AIX,12571,10176,22747,
Musée du Nouveau Monde,2011,POITOU-CHARENTES,LA ROCHELLE,4111,9758,13869,
Musée de la Maison de Pierre Loti,2011,POITOU-CHARENTES,ROCHEFORT,16743,2453,19196,
Musée Dupuy-Mestreau,2011,POITOU-CHARENTES,SAINTES,1098,2336,3434,
Musée Ernest Cognacq,2011,POITOU-CHARENTES,SAINT-MARTIN-DE-RE,7139,4134,11273,
Musée de Bressuire,2011,POITOU-CHARENTES,BRESSUIRE,0,1675,1675,
Musée de la vallée,2011,PROVENCE-ALPES-CÔTE D'AZUR,BARCELONNETTE,11625,2462,14087,
Musée d'Histoire et d'Archéologie,2011,PROVENCE-ALPES-CÔTE D'AZUR,ANTIBES,4697,4274,8971,
Musée d'Histoire Locale,2011,PROVENCE-ALPES-CÔTE D'AZUR,BIOT,1483,1766,3249,
Musée d'Art et d'Histoire de Provence,2011,PROVENCE-ALPES-CÔTE D'AZUR,GRASSE,0,16371,16371,
Musée du Vieux-Logis de Nice,2011,PROVENCE-ALPES-CÔTE D'AZUR,NICE,0,293,293,
Musée Archéologique - Site de Terra Amata,2011,PROVENCE-ALPES-CÔTE D'AZUR,NICE,0,24098,24098,
Muséum d'Histoire Naturelle,2011,PROVENCE-ALPES-CÔTE D'AZUR,AIX-EN-PROVENCE,10910,25786,36696,
Musée- Atelier de Paul Cézanne,2011,PROVENCE-ALPES-CÔTE D'AZUR,AIX-EN-PROVENCE,59709,7380,67089,
Musée Grobet-Labadié,2011,PROVENCE-ALPES-CÔTE D'AZUR,MARSEILLE,2899,7489,10388,
Musée des Alpilles,2011,PROVENCE-ALPES-CÔTE D'AZUR,SAINT-REMY-DE-PROVENCE,2761,5608,8369,
Musée du Pays Brignolais,2011,PROVENCE-ALPES-CÔTE D'AZUR,BRIGNOLES,2547,2404,4951,
Musée Archéologique Gallo-Romaine du Var,2011,PROVENCE-ALPES-CÔTE D'AZUR,FREJUS,5338,935,6273,
Musée Jean Aicard,2011,PROVENCE-ALPES-CÔTE D'AZUR,LE POUVEREL LA GARDE,0,3719,3719,
Musée Calvet (et musée Lapidaire),2011,PROVENCE-ALPES-CÔTE D'AZUR,AVIGNON,36811,25001,61812,
Musée du Petit Palais,2011,PROVENCE-ALPES-CÔTE D'AZUR,AVIGNON,15967,14417,30384,
Musée Comtadin-Duplessis,2011,PROVENCE-ALPES-CÔTE D'AZUR,CARPENTRAS,321,2035,2356,
Musée Sobirats,2011,PROVENCE-ALPES-CÔTE D'AZUR,CARPENTRAS,200,1019,1219,
Musée-Bibliothèque François Pétrarque,2011,PROVENCE-ALPES-CÔTE D'AZUR,FONTAINE-DE-VAUCLUSE,2365,923,3288,
Musée Municipal Camille Pautet,2011,PROVENCE-ALPES-CÔTE D'AZUR,MAZAN,0,1912,1912,
Musée Municipal,2011,PROVENCE-ALPES-CÔTE D'AZUR,ORANGE,59302,0,59302,
Musée Archéologique Théo Desplans,2011,PROVENCE-ALPES-CÔTE D'AZUR,VAISON-LA-ROMAINE,61132,14724,75856,
Musée Archéologique,2011,RHONE-ALPES,IZERNORE,1289,1789,3078,
Musée du Bugey-Valmorey,2011,RHONE-ALPES,LOCHIEU,2906,2593,5499,
Musée du Vieux Pérouges,2011,RHONE-ALPES,PEROUGES,12560,1275,13835,
Musée Louis Jourdan,2011,RHONE-ALPES,SAINT-PAUL-DE-VARAX,200,100,300,
Musée Départemental du Revermont,2011,RHONE-ALPES,VAL-REVERMONT,2408,8809,11217,
Musée et Site Archéologiques,2011,RHONE-ALPES,SOYONS,12056,2050,14106,
Musée du Château des Adhémars,2011,RHONE-ALPES,MONTELIMAR,16158,0,16158,
Musée Alpin,2011,RHONE-ALPES,CHAMONIX,12608,7407,20015,
Musée d'Huez et de l'Oisans,2011,RHONE-ALPES,ALPE D'HUEZ,1479,399,1878,
Musée Gallo-Romain,2011,RHONE-ALPES,AOSTE,10372,2175,12547,
Musée Matheysin,2011,RHONE-ALPES,LA MURE,836,1424,2260,
Musée Lapidaire Saint-Pierre,2011,RHONE-ALPES,VIENNE,2987,4728,7715,
Musée Lucien Mainssieux,2011,RHONE-ALPES,VOIRON,0,4937,4937,
Musée de la Soierie,2011,RHONE-ALPES,CHARLIEU,4164,1942,6106,
Musée d'Allard,2011,RHONE-ALPES,MONTBRISON,3687,4604,8291,
Musée des Beaux-Arts et d'Archéologie J. Dechelette,2011,RHONE-ALPES,ROANNE,2020,13761,15781,
Musée Rural,2011,RHONE-ALPES,USSON-EN-FOREZ,3859,841,4700,
Musée d'Art Contemporain de Lyon,2011,RHONE-ALPES,LYON,118487,29272,147759,
Ecomusée du Haut Beaujolais,2011,RHONE-ALPES,THIZY-LES-BOURGS,0,1602,1602,
Musée archéologique et minéralogique Pierre Borrione,2011,RHONE-ALPES,AIME-EN-TARENTAISE,591,404,995,
Musée du docteur Faure,2011,RHONE-ALPES,AIX-LES-BAINS,6040,5212,11252,
Musée Municipal d'Albertville-Conflans,2011,RHONE-ALPES,ALBERTVILLE,2826,3938,6764,
Musée Savoisien,2011,RHONE-ALPES,CHAMBERY,14386,0,14386,
Musée de la Folie Marco,2012,ALSACE,BARR,1631,3219,4850,
Musée Alsacien,2012,ALSACE,HAGUENAU,1192,1069,2261,
Maison de l'Archéologie des Vosges du Nord,2012,ALSACE,NIEDERBRONN-LES-BAINS,4238,2610,6848,
Musée des Beaux-Arts,2012,ALSACE,STRASBOURG,19203,44885,64088,
Musée Lalique,2012,ALSACE,WINGEN-SUR-MODER,70803,12364,83167,
Musée Sundgauvien d'Altkirch,2012,ALSACE,ALTKIRCH,1793,1063,2856,
Musée de la Porte de Thann,2012,ALSACE,CERNAY,502,155,657,
Musée Bartholdi,2012,ALSACE,COLMAR,10561,5468,16029,
Musée Théodore Deck et des Pays du Florival,2012,ALSACE,GUEBWILLER,1696,3343,5039,
Musée d'Histoire Local,2012,ALSACE,KAYSERSBERG,404,310,714,
Musée des Beaux-Arts,2012,ALSACE,MULHOUSE,0,19935,19935,
Musée National de la Préhistoire,2012,AQUITAINE,LES EYZIES-DE-TAYAC,47702,41981,89683,
Musée Militaire - Souvenir du Périgord,2012,AQUITAINE,PERIGUEUX,1719,889,2608,
Muséum d'Histoire Naturelle de Bordeaux,2012,AQUITAINE,BORDEAUX,0,14062,14062,
Musée des Arts Décoratifs,2012,AQUITAINE,BORDEAUX,8008,36686,44694,
Musée Archéologique,2012,AQUITAINE,HASTINGUES,3333,8077,11410,
Musée de la Chalosse,2012,AQUITAINE,MONTFORT-EN-CHALOSSE,5656,2344,8000,
Musée Municipal Albert Marzelles,2012,AQUITAINE,MARMANDE,0,4856,4856,
Musée de Préhistoire Mésolithique Laurent Coulonges,2012,AQUITAINE,SAUVETERRE-LA-LEMANCE,3952,611,4563,
Musée Municipal des Beaux-Arts,2012,AQUITAINE,PAU,25611,0,25611,
Musée des Arts D'Afrique et D'Asie,2012,AUVERGNE,VICHY,2352,1398,3750,
Musée des Sciences,2012,AUVERGNE,AURILLAC,3767,7272,11039,
Musée d'art et d'histoire Alfred Douët,2012,AUVERGNE,SAINT-FLOUR,1423,718,2141,
Musée d'Archéologie Bargoin,2012,AUVERGNE,CLERMONT-FERRAND,4125,22322,26447,
Musée des Pénitents Blancs,2012,AUVERGNE,MARSAC-EN-LIVRADOIS,129,60,189,
Musée Francisque Mandet,2012,AUVERGNE,RIOM,4165,9374,13539,
Musée Régional d'Auvergne,2012,AUVERGNE,RIOM,326,1592,1918,
Musée des Beaux-Arts,2012,BOURGOGNE,BEAUNE,7617,2941,10558,
Musée du Pays Châtillonnais - Trésor de Vix,2012,BOURGOGNE,CHATILLON-SUR-SEINE,15216,5491,20707,
"Musée de la Vie Bourguignonne, Perrin de Puycousin",2012,BOURGOGNE,DIJON,0,46839,46839,
Musée Buffon,2012,BOURGOGNE,MONTBARD,0,9404,9404,
Musée Rolin,2012,BOURGOGNE,AUTUN,11215,7601,18816,
Musée Denon,2012,BOURGOGNE,CHALON-SUR-SAONE,0,10738,10738,
Musée de la Tour du Moulin,2012,BOURGOGNE,MARCIGNY,1630,491,2121,
Musée d'Art et d'Histoire,2012,BOURGOGNE,AUXERRE,7468,23740,31208,
Musée de l'Aventure du Son,2012,BOURGOGNE,SAINT-FARGEAU,3870,779,4649,
Musée du Château de Dinan,2012,BRETAGNE,DINAN,14347,7429,21776,
Musée d'Art et d'Histoire,2012,BRETAGNE,SAINT-BRIEUC,0,45921,45921,
Musée des Beaux-Arts de Brest,2012,BRETAGNE,BREST,7307,17075,24382,
Musée des Phares et Balises,2012,BRETAGNE,OUESSANT,11579,3155,14734,
Musée Bigouden,2012,BRETAGNE,PONT-L'ABBE,10203,4482,14685,
Musée des Beaux-Arts,2012,BRETAGNE,QUIMPER,29697,33110,62807,
Ecomusée de Saint-Dégan,2012,BRETAGNE,BREC'H,8216,3191,11407,
Musée du Faouët,2012,BRETAGNE,LE FAOUET,10121,3563,13684,
Musée de la Compagnie des Indes,2012,BRETAGNE,PORT-LOUIS,35168,33616,68784,
Musée de la Résistance Bretonne,2012,BRETAGNE,SAINT-MARCEL - MALESTROIT,17592,3314,20906,
Musée Estève,2012,CENTRE,BOURGES,0,18571,18571,
Musée Archéologique d'Argentomagus,2012,CENTRE,SAINT-MARCEL,8902,6124,15026,
Musée de Préhistoire du Grand Pressigny,2012,CENTRE,LE GRAND PRESSIGNY,8197,7558,15755,
Ecomusée du Véron,2012,CENTRE,SAVIGNY-EN-VERON,6275,3111,9386,
Musée du Compagnonnage,2012,CENTRE,TOURS,26981,17251,44232,
Musée des Beaux-Arts,2012,CENTRE,TOURS,23883,37856,61739,
Musée de la Corbillière,2012,CENTRE,MER,0,2931,2931,
Musée Archéologique,2012,CENTRE,THESEE,658,152,810,
Musée de la Marine de Loire,2012,CENTRE,CHATEAUNEUF-SUR-LOIRE,9362,3676,13038,
Musée des Sciences Naturelles,2012,CENTRE,ORLEANS,11850,53114,64964,
Musée Napoléon Ier,2012,CHAMPAGNE-ARDENNES,BRIENNE-LE-CHATEAU,3119,1398,4517,
Musée Paul Dubois-Alfred Boucher,2012,CHAMPAGNE-ARDENNES,NOGENT-SUR-SEINE,1970,3910,5880,
Pharmacie Musée de l'Hôtel-Dieu,2012,CHAMPAGNE-ARDENNES,TROYES,3066,5561,8627,
Musée d'Art et d'Histoire,2012,CHAMPAGNE-ARDENNES,LANGRES,7963,5173,13136,
Musée Hôtel le Vergeur,2012,CHAMPAGNE-ARDENNES,REIMS,7222,285,7507,
Musée d'Histoire de Bastia,2012,CORSE,BASTIA,15153,5735,20888,
Musée Départemental Pascal Paoli,2012,CORSE,MOROSAGLIA,4926,1795,6721,
Musée de la résistance et de la Déportation,2012,FRANCHE-COMTE,BESANCON,57142,0,57142,
Musée Beurnier-Rossel,2012,FRANCHE-COMTE,MONTBELIARD,654,3311,3965,
Musée Sarret de Grozon,2012,FRANCHE-COMTE,ARBOIS,314,1275,1589,
Musée du Jouet,2012,FRANCHE-COMTE,MOIRANS-EN-MONTAGNE,26138,6004,32142,
Musée Municipal Saint-John Perse,2012,GUADELOUPE,POINTE-A-PITRE,2170,345,2515,
Musée Départemental Albert-Kahn,2012,ILE-DE-FRANCE,BOULOGNE-BILLANCOURT,88329,37212,125541,
Musée des Années Trente,2012,ILE-DE-FRANCE,BOULOGNE-BILLANCOURT,36245,0,36245,
Musée Français de la Carte à Jouer,2012,ILE-DE-FRANCE,ISSY-LES-MOULINEAUX,4736,17329,22065,
Musée - Atelier Rodin (Annexe du musée de Paris),2012,ILE-DE-FRANCE,MEUDON,5426,7722,13148,
Musée de l'Île-de-France,2012,ILE-DE-FRANCE,SCEAUX,16507,11670,28177,
Musée de l'Armée,2012,ILE-DE-FRANCE,PARIS,842999,561740,1404739,
Crypte Archéologique du Parvis Notre-Dame,2012,ILE-DE-FRANCE,PARIS,44395,121780,166175,
Les Catacombes,2012,ILE-DE-FRANCE,PARIS,225344,36156,261500,
Musée de Montmartre,2012,ILE-DE-FRANCE,PARIS,57000,3000,60000,
Etablissement public du musée d'Orsay et de l'Orangerie - Musée d'Orsay,2012,ILE-DE-FRANCE,PARIS,2186025,1393105,3579130,
Institut du Monde Arabe,2012,ILE-DE-FRANCE,PARIS,151500,106499,257999,
"Musée des Transports Urbains, Interurbains et Ruraux",2012,ILE-DE-FRANCE,CHELLES,300,2000,2300,
Château-musée de Nemours,2012,ILE-DE-FRANCE,NEMOURS,4055,4331,8386,
Ecomusée,2012,ILE-DE-FRANCE,SAVIGNY-LE-TEMPLE,178,4912,5090,
Musée d'Art et d'Histoire,2012,ILE-DE-FRANCE,SAINT-DENIS,2612,18816,21428,
Musée de la Ville,2012,ILE-DE-FRANCE,MONTIGNY LE BRETONNEUX,2076,8105,10181,
Musée d'Archéologie Nationale (des origines à l'an mille) - Château de st-Germain-en-Laye,2012,ILE-DE-FRANCE,SAINT-GERMAIN-EN-LAYE,20892,77799,98691,
Musée des Beaux-Arts,2012,LANGUEDOC-ROUSSILLON,CARCASSONNE,0,51000,51000,
Musée Archéologique du Lauragais,2012,LANGUEDOC-ROUSSILLON,CASTELNAUDARY,396,400,796,
Musée Archéologique,2012,LANGUEDOC-ROUSSILLON,SALLELES D'AUDE,6393,345,6738,
Carré d'Art Musée d'Art Contemporain de Nîmes,2012,LANGUEDOC-ROUSSILLON,NIMES,14616,23460,38076,
Musée d'Histoire Naturelle et de Préhistoire,2012,LANGUEDOC-ROUSSILLON,NIMES,0,45784,45784,
Musée de l'Etang de Thau,2012,LANGUEDOC-ROUSSILLON,BOUZIGUES,14535,1679,16214,
Site Archéologique Lattara - Musée Henri Prades de Montpellier Agglomération,2012,LANGUEDOC-ROUSSILLON,LATTES,12174,11082,23256,
Musée de la Préhistoire des Matelles,2012,LANGUEDOC-ROUSSILLON,LES MATELLES,1284,0,1284,
Musée de Préhistoire Régionale et du Mégalithisme,2012,LANGUEDOC-ROUSSILLON,SAINT-PONS-DE-THOMIERES,1389,1267,2656,
Musée d'Art Moderne - Fonds Peskè,2012,LANGUEDOC-ROUSSILLON,COLLIOURE,11788,5055,16843,
Musée de Cerdagne,2012,LANGUEDOC-ROUSSILLON,SAINTE-LEOCADIE,2897,1063,3960,
Musée Labenche d'Art et d'Histoire,2012,LIMOUSIN,BRIVE-LA-GAILLARDE,2686,31539,34225,
Musée du Président Jacques Chirac,2012,LIMOUSIN,SARRAN,29157,8236,37393,
Musée Départemental d'Art Contemporain,2012,LIMOUSIN,ROCHECHOUART,7103,5698,12801,
Musée des Beaux-Arts de Nancy,2012,LORRAINE,NANCY,31562,57179,88741,
Musée Jules Bastien-Lepage - Musée de la Fortification,2012,LORRAINE,MONTMEDY,11263,2498,13761,
Musée de la Bière et du Pays de Stenay,2012,LORRAINE,STENAY,7576,12488,20064,
Centre Pompidou de Metz (collections nationales decentralisées),2012,LORRAINE,METZ,285859,190571,476430,
Musée du Pays de Sarrebourg,2012,LORRAINE,SARREBOURG,10004,10930,20934,
"Jardin d'Hiver, Musée de La Faïence",2012,LORRAINE,SARREGUEMINES,7060,3674,10734,
Musée Louis Français,2012,LORRAINE,PLOMBIERES-LES-BAINS,162,190,352,
Musée Charles Friry,2012,LORRAINE,REMIREMONT,357,956,1313,
Musée Pierre Noël - Musée de la Vie dans les Hautes-Vosges,2012,LORRAINE,SAINT-DIE-DES-VOSGES,3309,13592,16901,
Musée de La Canne,2012,MARTINIQUE,LES TROIS ILETS,10547,3348,13895,
Musée Municipal de Millau,2012,MIDI-PYRENEES,MILLAU,4051,12402,16453,
Musée Fenaille,2012,MIDI-PYRENEES,RODEZ,7302,9827,17129,
Musée Campanaire,2012,MIDI-PYRENEES,L'ISLE JOURDAIN,5823,1091,6914,
Musée Paul Dupuy,2012,MIDI-PYRENEES,TOULOUSE,3649,7229,10878,
Musée Massey,2012,MIDI-PYRENEES,TARBES,8340,9360,17700,
Musée Henri Martin,2012,MIDI-PYRENEES,CAHORS,4522,8882,13404,
"Musée Archéologique ""Armand-Viré""",2012,MIDI-PYRENEES,LUZECH,335,352,687,
Musée Gallo-Romain d'Uxellodunum,2012,MIDI-PYRENEES,MARTEL,493,63,556,
Musée Eugénie et Maurice Guérin,2012,MIDI-PYRENEES,ANDILLAC,1772,2820,4592,
Musée des Beaux-Arts,2012,MIDI-PYRENEES,GAILLAC,2037,2808,4845,
"Forum Antique de Bavay, Musée Archéologique du Département du Nord",2012,NORD-PAS-DE-CALAIS,BAVAY,25559,6647,32206,
Musée d'Archéologie et d'Histoire Locale,2012,NORD-PAS-DE-CALAIS,DENAIN,0,4500,4500,
Ecomusée de la Région,2012,NORD-PAS-DE-CALAIS,FOURMIES,25747,12681,38428,
Musée des Beaux-Arts,2012,NORD-PAS-DE-CALAIS,ROUBAIX,125349,123635,248984,
Musée des Beaux-Arts,2012,NORD-PAS-DE-CALAIS,VALENCIENNES,16294,23181,39475,
Musée d'Art Moderne de Lille Métropole,2012,NORD-PAS-DE-CALAIS,VILLENEUVE-D'ASCQ,108581,47537,156118,
Musée Quentovic,2012,NORD-PAS-DE-CALAIS,ETAPLES-SUR-MER,2307,721,3028,
Musée du Débarquement,2012,BASSE-NORMANDIE,ARROMANCHES,300950,12058,313008,
Musée des Beaux-Arts,2012,BASSE-NORMANDIE,CAEN,32164,32766,64930,
Musée de la Meunerie - Moulin de Marcy,2012,BASSE-NORMANDIE,LE MOLAY-LITTRY,3137,3517,6654,
Paléospace / Musée Paléontologique,2012,BASSE-NORMANDIE,VILLERS-SUR-MER,40016,5506,45522,
Musée de la Guerre et de la Libération,2012,BASSE-NORMANDIE,CHERBOURG-EN-COTENTIN,3473,6191,9664,
Muséum Emmanuel Liais,2012,BASSE-NORMANDIE,CHERBOURG-EN-COTENTIN,0,15284,15284,
Musée du Vieux Granville,2012,BASSE-NORMANDIE,GRANVILLE,10743,0,10743,
Musée du Château de Flers,2012,BASSE-NORMANDIE,FLERS,2247,4262,6509,
Musée Municipal,2012,HAUTE-NORMANDIE,BERNAY,1402,12350,13752,
Musée Artisanal et Industriel d'Instruments à Vent,2012,HAUTE-NORMANDIE,LA COUTURE-BOUSSEY,2994,1549,4543,
Musée Municipal,2012,HAUTE-NORMANDIE,LOUVIERS,334,8314,8648,
Musée Départemental Pierre Corneille,2012,HAUTE-NORMANDIE,LE PETIT-COURONNE,696,3495,4191,
Musée Mathon-Durand,2012,HAUTE-NORMANDIE,NEUFCHATEL-EN-BRAY,495,1796,2291,
Musée Le Secq des Tournelles,2012,HAUTE-NORMANDIE,ROUEN,5279,9426,14705,
Musée de la Céramique,2012,HAUTE-NORMANDIE,ROUEN,4222,7265,11487,
Musée Municipal des Ivoires,2012,HAUTE-NORMANDIE,YVETOT,780,462,1242,
Musée du Pays de Guérande et de la Porte Saint Michel,2012,PAYS DE LA LOIRE,GUERANDE,21671,7603,29274,
Muséum d'Histoire Naturelle de Nantes,2012,PAYS DE LA LOIRE,NANTES,27380,60137,87517,
Musée du Château des Ducs de Bretagne,2012,PAYS DE LA LOIRE,NANTES,78048,89559,167607,
Muséum des Sciences Naturelles,2012,PAYS DE LA LOIRE,ANGERS,3030,15808,18838,
Musée Joseph Denais,2012,PAYS DE LA LOIRE,BEAUFORT-EN-VALLEE,5010,4454,9464,
Musée Jules-Desbois,2012,PAYS DE LA LOIRE,PARCAY-LES-PINS,2293,2219,4512,
Musée de l'Ardoise,2012,PAYS DE LA LOIRE,TRELAZE,10776,4416,15192,
Musée Archéologique Départemental de Jublains,2012,PAYS DE LA LOIRE,JUBLAINS,8087,19930,28017,
Musée de l'Ardoise et de la Géologie,2012,PAYS DE LA LOIRE,RENAZE,994,338,1332,
Musée de la Reine Bérengère,2012,PAYS DE LA LOIRE,LE MANS,1887,4788,6675,
Bibliothèque-musée,2012,PAYS DE LA LOIRE,SAINT-CALAIS,0,944,944,
Musée de Fontenay-le-Comte,2012,PAYS DE LA LOIRE,FONTENAY-LE-COMTE,1884,3009,4893,
Musée ornithologique Charles-Payraudeau,2012,PAYS DE LA LOIRE,LA-CHAIZE-LE-VICOMTE,287,474,761,
Musée Clemenceau et de Lattre-de-Tassigny,2012,PAYS DE LA LOIRE,MOUILLERON-EN-PAREDS,1634,4466,6100,
Musée Municipal de Soissons,2012,PICARDIE,SOISSONS,0,30747,30747,
Musée d'Art et d'Archéologie,2012,PICARDIE,SENLIS,2062,6742,8804,
Musée-Historial de la Grande Guerre,2012,PICARDIE,PERONNE,59591,9452,69043,
Cité International de la Bande Dessinée et de l'Image - Musée de la Bande Dessinée,2012,POITOU-CHARENTES,ANGOULEME,13344,44239,57583,
Muséum d'Histoire Naturelle,2012,POITOU-CHARENTES,LA ROCHELLE,11703,42315,54018,
Musée Ernest Cognacq,2012,POITOU-CHARENTES,SAINT-MARTIN-DE-RE,6088,5653,11741,
Musée de Salagon,2012,PROVENCE-ALPES-CÔTE D'AZUR,MANE,38820,0,38820,
Musée de la Faïence,2012,PROVENCE-ALPES-CÔTE D'AZUR,MOUSTIERS-SAINTE-MARIE,2743,6028,8771,
Musée Renoir,2012,PROVENCE-ALPES-CÔTE D'AZUR,CAGNES-SUR-MER,976,311,1287,
Musée de Préhistoire Régionale,2012,PROVENCE-ALPES-CÔTE D'AZUR,MENTON,0,8904,8904,
Musée d'Art Naïf Anatole Jakovsky,2012,PROVENCE-ALPES-CÔTE D'AZUR,NICE,0,22499,22499,
Musée des Beaux-Arts Jules Chéret,2012,PROVENCE-ALPES-CÔTE D'AZUR,NICE,0,56120,56120,
Musée Matisse,2012,PROVENCE-ALPES-CÔTE D'AZUR,NICE,0,152811,152811,
Musée d'Art Moderne et d'Art Contemporain,2012,PROVENCE-ALPES-CÔTE D'AZUR,NICE,2657,138689,141346,
Musée Picasso la guerre et la paix à Vallauris,2012,PROVENCE-ALPES-CÔTE D'AZUR,VALLAURIS,19793,11213,31006,
Muséum d'Histoire Naturelle,2012,PROVENCE-ALPES-CÔTE D'AZUR,AIX-EN-PROVENCE,12052,26246,38298,
Musée Camarguais,2012,PROVENCE-ALPES-CÔTE D'AZUR,ARLES,8880,10012,18892,
Musée Réattu,2012,PROVENCE-ALPES-CÔTE D'AZUR,ARLES,32399,20834,53233,
Musée de l'Uniforme - Musée de la Légion Etrangère,2012,PROVENCE-ALPES-CÔTE D'AZUR,PUYLOUBIER,0,8418,8418,
Musée Folklorique du Vieux Lambesc,2012,PROVENCE-ALPES-CÔTE D'AZUR,LAMBESC,0,2060,2060,
Musée d'Art Contemporain - Galeries Contemporaines,2012,PROVENCE-ALPES-CÔTE D'AZUR,MARSEILLE,22393,0,22393,
Muséum d'Histoire Naturelle,2012,PROVENCE-ALPES-CÔTE D'AZUR,MARSEILLE,7669,43363,51032,
Musée Grobet-Labadié,2012,PROVENCE-ALPES-CÔTE D'AZUR,MARSEILLE,1936,8536,10472,
Musée Ziem,2012,PROVENCE-ALPES-CÔTE D'AZUR,MARTIGUES,0,13691,13691,
Musée des Alpilles,2012,PROVENCE-ALPES-CÔTE D'AZUR,SAINT-REMY-DE-PROVENCE,3674,12089,15763,
Musée de l'Artillerie,2012,PROVENCE-ALPES-CÔTE D'AZUR,DRAGUIGNAN,0,20420,20420,
Musée Archéologique Gallo-Romaine du Var,2012,PROVENCE-ALPES-CÔTE D'AZUR,FREJUS,4010,6398,10408,
Musée d'Art et d'Archéologie,2012,PROVENCE-ALPES-CÔTE D'AZUR,TOULON,0,14846,14846,
Muséum d'Histoire Naturelle Esprit Requien,2012,PROVENCE-ALPES-CÔTE D'AZUR,AVIGNON,0,13880,13880,
Musée Sobirats,2012,PROVENCE-ALPES-CÔTE D'AZUR,CARPENTRAS,223,568,791,
Musée Marc Deydier,2012,PROVENCE-ALPES-CÔTE D'AZUR,CUCURON,0,4383,4383,
Musée-Bibliothèque François Pétrarque,2012,PROVENCE-ALPES-CÔTE D'AZUR,FONTAINE-DE-VAUCLUSE,2128,762,2890,
Musée du Bugey-Valmorey,2012,RHONE-ALPES,LOCHIEU,2226,1966,4192,
Musée de la Résistance et de la Déportation de l'Ain,2012,RHONE-ALPES,NANTUA,6217,3583,9800,
Musée Chintreuil,2012,RHONE-ALPES,PONT-DE-VAUX,5704,1661,7365,
Musée Louis Jourdan,2012,RHONE-ALPES,SAINT-PAUL-DE-VARAX,180,100,280,
Musée des Vans,2012,RHONE-ALPES,LES VANS,470,622,1092,
Musée du Rhône,2012,RHONE-ALPES,TOURNON-SUR-RHÔNE,8896,9846,18742,
Musée d'Archéologie Tricastine,2012,RHONE-ALPES,SAINT-PAUL-TROIS-CHATEAUX,2956,2479,5435,
Musée des Vallées de Thônes,2012,RHONE-ALPES,THONES,670,1130,1800,
Musée du Chablais,2012,RHONE-ALPES,THONON-LES-BAINS,3636,2272,5908,
Musée d'Huez et de l'Oisans,2012,RHONE-ALPES,ALPE D'HUEZ,781,319,1100,
Muséum d'Histoire Naturelle de Grenoble,2012,RHONE-ALPES,GRENOBLE,15395,56151,71546,
Maison du Patrimoine de Hières-sur-Amby,2012,RHONE-ALPES,HIERES SUR AMBY,5381,1226,6607,
Musée Hector Berlioz,2012,RHONE-ALPES,LA-COTE-SAINT-ANDRE,0,12968,12968,
Musée des Beaux-Arts et d'Archéologie,2012,RHONE-ALPES,VIENNE,1860,3502,5362,
Musée Lucien Mainssieux,2012,RHONE-ALPES,VOIRON,0,6106,6106,
Musée d'Allard,2012,RHONE-ALPES,MONTBRISON,2322,7733,10055,
Musée d'Art Moderne et Contemporain,2012,RHONE-ALPES,SAINT-ETIENNE,29263,25121,54384,
Musée des Beaux-Arts,2012,RHONE-ALPES,LYON,123999,203689,327688,
Musée des Confluences,2012,RHONE-ALPES,LYON,0,23042,23042,
Musée Archéologique,2012,RHONE-ALPES,SAINT-ROMAIN-EN-GAL,19907,54402,74309,
Ecomusée du Haut Beaujolais,2012,RHONE-ALPES,THIZY-LES-BOURGS,0,993,993,
Musée des Charmettes,2012,RHONE-ALPES,CHAMBERY,1031,22306,23337,
Musée Municipal,2012,ST PIERRE ET MIQUELON,SAINT-PIERRE ET MIQUELON,2590,781,3371,
Musée de la Poterie,2013,ALSACE,BETSCHDORF,1844,200,2044,
Maison de l'Archéologie des Vosges du Nord,2013,ALSACE,NIEDERBRONN-LES-BAINS,1616,3525,5141,
Musée Alsacien,2013,ALSACE,STRASBOURG,30492,31869,62361,
Musée des Beaux-Arts,2013,ALSACE,STRASBOURG,29946,25888,55834,
Musée d'Unterlinden,2013,ALSACE,COLMAR,127745,23133,150878,
Musée des Amis de Thann,2013,ALSACE,THANN,597,1325,1922,
Musée des Beaux-Arts et d'Archéologie,2013,AQUITAINE,LIBOURNE,0,15089,15089,
Musée Historique de l'Hydravion,2013,AQUITAINE,BISCARROSSE,14414,609,15023,
Musée Despiau-Wlérick,2013,AQUITAINE,MONT-DE-MARSAN,0,27557,27557,
Ecomusée de la Grande Lande,2013,AQUITAINE,SABRES,58741,12197,70938,
Musée d'Art et d'Histoire du Cap de Gascogne,2013,AQUITAINE,SAINT-SEVER,0,837,837,
Musée des Beaux-Arts,2013,AQUITAINE,AGEN,8465,15599,24064,
Musée Municipal Albert Marzelles,2013,AQUITAINE,MARMANDE,0,4933,4933,
Muséum d'Histoire Naturelle,2013,AQUITAINE,BAYONNE,0,21372,21372,
Musée Basque et de l'Histoire de Bayonne,2013,AQUITAINE,BAYONNE,16196,21884,38080,
Musée Edmond Rostand,2013,AQUITAINE,CAMBO-LES-BAINS,72065,11321,83386,
Musée Charles-Louis Philippe,2013,AUVERGNE,CERILLY,192,141,333,
Musée Rieckotter,2013,AUVERGNE,NERIS-LES-BAINS,702,343,1045,
Musée Paléontologique,2013,AUVERGNE,MENAT,407,70,477,
Musée des Peintres de l'Ecole de Murols,2013,AUVERGNE,MUROL,3913,203,4116,
Musée Municipal de la Coutellerie,2013,AUVERGNE,THIERS,19964,4243,24207,
Musée Alésia - Centre d'Interprétation,2013,BOURGOGNE,ALISE-SAINTE-REINE,86154,15231,101385,
Musée Noisot,2013,BOURGOGNE,FIXIN,197,181,378,
Musée Municipal,2013,BOURGOGNE,SEMUR-EN-AUXOIS,1148,5677,6825,
Musée du Costume,2013,BOURGOGNE,CHATEAU-CHINON,3881,1527,5408,
Musée d'Art et d'Histoire Romain Rolland,2013,BOURGOGNE,CLAMECY,2218,2048,4266,
Musée de la Mine,2013,BOURGOGNE,BLANZY,9663,1953,11616,
Ecomusée de la Communauté Le Creusot-Monceau-Les-Mines,2013,BOURGOGNE,LE CREUSOT,4662,6517,11179,
"L'Atelier d'un Journal"" de Louhans - Musée Municipal",2013,BOURGOGNE,LOUHANS,1635,4174,5809,
Musée de la Tour du Moulin,2013,BOURGOGNE,MARCIGNY,1096,327,1423,
Ecomusée de la Bresse Bourguignonne,2013,BOURGOGNE,PIERRE-DE-BRESSE,25249,17980,43229,
Musée des Arts Naïfs et Populaires de Noyers sur Serein,2013,BOURGOGNE,NOYERS-SUR-SEREIN,2024,737,2761,
Musée du Château de Dinan,2013,BRETAGNE,DINAN,13773,6574,20347,
Ecomusée d'Ouessant - Vivre sur une Ile,2013,BRETAGNE,OUESSANT,7195,1171,8366,
Ecomusée du Pays de Rennes,2013,BRETAGNE,RENNES,14363,37050,51413,
Musée de Bretagne,2013,BRETAGNE,RENNES,14381,36150,50531,
Musée d'Histoire et d'Archéologie de Vannes,2013,BRETAGNE,VANNES,2162,4507,6669,
Musée de Préhistoire du Grand Pressigny,2013,CENTRE,LE GRAND PRESSIGNY,8992,9131,18123,
Musée Balzac,2013,CENTRE,SACHE,25214,14160,39374,
Musée Municipal Théâtre Forain et Archéologique,2013,CENTRE,ARTENAY,7847,3299,11146,
Musée du Château-Fort,2013,CHAMPAGNE-ARDENNES,SEDAN,50794,1777,52571,
Musée Municipal,2013,CHAMPAGNE-ARDENNES,BOURBONNE-LES-BAINS,0,2403,2403,
Musée d'Art et d'Histoire,2013,CHAMPAGNE-ARDENNES,LANGRES,4373,807,5180,
Musée Napoléonien,2013,CORSE,AJACCIO,5244,2573,7817,
Musée de Plein Air des Maisons Comtoises,2013,FRANCHE-COMTE,NANCRAY,32397,12633,45030,
Musée de Pontarlier,2013,FRANCHE-COMTE,PONTARLIER,1170,6350,7520,
Musée Baron Martin,2013,FRANCHE-COMTE,GRAY,3548,2658,6206,
Musée Départemental de la Montagne Albert Demard,2013,FRANCHE-COMTE,LE HAUT-DU-THEM,3890,2952,6842,
Musée Sarret de Grozon,2013,FRANCHE-COMTE,ARBOIS,958,1324,2282,
Musée des Salines,2013,FRANCHE-COMTE,SALINS-LES-BAINS,68194,6371,74565,
Musée Départemental Albert-Kahn,2013,ILE-DE-FRANCE,BOULOGNE-BILLANCOURT,67035,38348,105383,
Musée des Années Trente,2013,ILE-DE-FRANCE,BOULOGNE-BILLANCOURT,9866,13479,23345,
Musée Roybet Fould,2013,ILE-DE-FRANCE,COURBEVOIE,0,11654,11654,
Cité de la céramique - Sèvres & Limoges,2013,ILE-DE-FRANCE,SEVRES,23858,22331,46189,
Musée du Moyen Age-Thermes et Hôtel de Cluny,2013,ILE-DE-FRANCE,PARIS,148232,152258,300490,
Crypte Archéologique du Parvis Notre-Dame,2013,ILE-DE-FRANCE,PARIS,68662,154737,223399,
Maison de Balzac,2013,ILE-DE-FRANCE,PARIS,616,43422,44038,
Etablissement public du musée d'Orsay et de l'Orangerie - Musée de l'Orangerie,2013,ILE-DE-FRANCE,PARIS,627768,285041,912809,
Musée du Louvre,2013,ILE-DE-FRANCE,PARIS,5635387,3498880,9134267,
Musée National Eugène Delacroix,2013,ILE-DE-FRANCE,PARIS,42756,21652,64408,
Musée de la Chasse et de la Nature,2013,ILE-DE-FRANCE,PARIS,21003,29269,50272,
Musée des Arts Décoratifs (Union Centrale des Arts Décoratifs),2013,ILE-DE-FRANCE,PARIS,245239,236193,481432,
Musée Nissim de Camondo (UCAD),2013,ILE-DE-FRANCE,PARIS,37146,14815,51961,
Musée National des Techniques,2013,ILE-DE-FRANCE,PARIS,134156,155230,289386,
Institut du Monde Arabe,2013,ILE-DE-FRANCE,PARIS,182806,99694,282500,
Musée de Provins et du Provinois,2013,ILE-DE-FRANCE,PROVINS,15640,5578,21218,
Musée d'Art et d'Histoire,2013,ILE-DE-FRANCE,SAINT-DENIS,2759,17182,19941,
Musée Fragonard,2013,ILE-DE-FRANCE,MAISONS-ALFORT,3314,4928,8242,
Musée de la Ville,2013,ILE-DE-FRANCE,MONTIGNY LE BRETONNEUX,4241,3759,8000,
Muséum d'Histoire Naturelle,2013,LA REUNION,SAINT-DENIS,0,47182,47182,
Musée Historique de Villèle,2013,LA REUNION,SAINT-GILLES-LES-HAUTS,17113,26445,43558,
Musée-Bibliothèque Pierre-André Benoît,2013,LANGUEDOC-ROUSSILLON,ALES,5572,17054,22626,
Musée Cévenol,2013,LANGUEDOC-ROUSSILLON,LE VIGAN,1840,2782,4622,
Musée des Beaux-Arts,2013,LANGUEDOC-ROUSSILLON,NIMES,3264,12886,16150,
Musée Départemental d'Art Sacré du Gard,2013,LANGUEDOC-ROUSSILLON,PONT-SAINT-ESPRIT,152,9041,9193,
Musée de l'Etang de Thau,2013,LANGUEDOC-ROUSSILLON,BOUZIGUES,14489,1904,16393,
Musée Fabre,2013,LANGUEDOC-ROUSSILLON,MONTPELLIER,195794,86275,282069,
Musée de Cerdagne,2013,LANGUEDOC-ROUSSILLON,SAINTE-LEOCADIE,4162,662,4824,
Musée de Tautavel,2013,LANGUEDOC-ROUSSILLON,TAUTAVEL,56568,9101,65669,
Musée de la Mémoire et des Industries Tullistes,2013,LIMOUSIN,TULLE,0,3787,3787,
Musée René Baubérot,2013,LIMOUSIN,CHATEAUPONSAC,2327,562,2889,
Musée Départemental d'Art Contemporain,2013,LIMOUSIN,ROCHECHOUART,7124,5875,12999,
Les Sources d'Hercule,2013,LORRAINE,DENEUVRE,2926,578,3504,
Musée de l'Ecole de Nancy,2013,LORRAINE,NANCY,24411,19700,44111,
Musée Départemental du Sel,2013,LORRAINE,MARSAL,3876,9979,13855,
"Jardin d'Hiver, Musée de La Faïence",2013,LORRAINE,SARREGUEMINES,5338,6162,11500,
Musée Départemental Georges de la Tour,2013,LORRAINE,VIC-SUR-SEILLE,8259,11772,20031,
Musée Départemental d'Archéologie Précolombienne et de Préhistoire de la Martinique,2013,MARTINIQUE,FORT-DE-FRANCE,4887,2878,7765,
Musée de La Canne,2013,MARTINIQUE,LES TROIS ILETS,10763,2855,13618,
Musée du Textile et du Peigne en Corne,2013,MIDI-PYRENEES,LAVELANET,1396,507,1903,
Musée d'Archéologie,2013,MIDI-PYRENEES,MONTSEGUR,0,17599,17599,
Musée Joseph Vaylet,2013,MIDI-PYRENEES,ESPALION,2462,1560,4022,
Musée de l'Armagnac,2013,MIDI-PYRENEES,CONDOM,2445,445,2890,
Musée Archéologique,2013,MIDI-PYRENEES,EAUZE,4319,1863,6182,
Musée des Beaux-Arts et des Arts Décoratifs,2013,MIDI-PYRENEES,MIRANDE,519,340,859,
Muséum d'Histoire Naturelle,2013,MIDI-PYRENEES,TOULOUSE,124863,118569,243432,
Musée Georges Labit,2013,MIDI-PYRENEES,TOULOUSE,5696,12102,17798,
Musée Saint-Raymond,2013,MIDI-PYRENEES,TOULOUSE,12606,39337,51943,
Musée Massey,2013,MIDI-PYRENEES,TARBES,5853,7261,13114,
Musée de l'Automate,2013,MIDI-PYRENEES,SOUILLAC,15952,3151,19103,
Musée Eugénie et Maurice Guérin,2013,MIDI-PYRENEES,ANDILLAC,1460,2405,3865,
Musée Départemental du Textile,2013,MIDI-PYRENEES,LA-BASTIDE-ROUAIROUX,2735,3231,5966,
Musée du Pays Rabastinois,2013,MIDI-PYRENEES,RABASTENS,743,3272,4015,
Musée Théodore Calbet,2013,MIDI-PYRENEES,GRISOLLES,0,5061,5061,
Musée Portuaire,2013,NORD-PAS-DE-CALAIS,DUNKERQUE,28590,32399,60989,
Musée d'Histoire Locale de Marchiennes,2013,NORD-PAS-DE-CALAIS,MARCHIENNES,212,292,504,
Musée d'Art Moderne de Lille Métropole,2013,NORD-PAS-DE-CALAIS,VILLENEUVE-D'ASCQ,103670,48217,151887,
Musée Quentovic,2013,NORD-PAS-DE-CALAIS,ETAPLES-SUR-MER,3020,726,3746,
Musée d'Histoire et d'Archéologie,2013,NORD-PAS-DE-CALAIS,HARNES,0,2891,2891,
Musée Municipal,2013,NORD-PAS-DE-CALAIS,LE TOUQUET-PARIS-PLAGE,3336,3490,6826,
Musée des Beaux-Arts,2013,BASSE-NORMANDIE,CAEN,102162,64354,166516,
Musée d'Art et d'Histoire de Lisieux,2013,BASSE-NORMANDIE,LISIEUX,23,3042,3065,
Musée de la Guerre et de la Libération,2013,BASSE-NORMANDIE,CHERBOURG-EN-COTENTIN,3311,6076,9387,
Musée Richard Anacréon,2013,BASSE-NORMANDIE,GRANVILLE,9796,6613,16409,
Musée du Vieux Granville,2013,BASSE-NORMANDIE,GRANVILLE,5702,6929,12631,
Musée Christian Dior,2013,BASSE-NORMANDIE,GRANVILLE,48238,0,48238,
Musée des Beaux-Arts,2013,BASSE-NORMANDIE,SAINT-LO,9077,0,9077,
Musée Municipal - Musée du Jouet,2013,BASSE-NORMANDIE,LA FERTE-MACE,226,7,233,
Musée du Verre et de la Pierre,2013,HAUTE-NORMANDIE,CONCHES-EN-OUCHE,2312,2935,5247,
Musée Municipal,2013,HAUTE-NORMANDIE,LOUVIERS,0,10403,10403,
Musée Alfred Canel,2013,HAUTE-NORMANDIE,PONT-AUDEMER,324,6145,6469,
Musée des Terres-Neuvas et de la Pêche,2013,HAUTE-NORMANDIE,FECAMP,2498,1543,4041,
Musée des Traditions et Arts Normands,2013,HAUTE-NORMANDIE,MARTAINVILLE-EPREVILLE,9483,17190,26673,
Musée-Maison Natale Pierre Corneille,2013,HAUTE-NORMANDIE,ROUEN,0,5717,5717,
MUNAE - Musée National de l'Education,2013,HAUTE-NORMANDIE,ROUEN,3733,5562,9295,
Musée Flaubert et d'Histoire de la Médecine,2013,HAUTE-NORMANDIE,ROUEN,4318,3055,7373,
Musée du Chaume/Kerhinet - PNR Brière,2013,PAYS DE LA LOIRE,SAINT-LYPHARD,2398,88881,91279,
Galerie David d'Angers,2013,PAYS DE LA LOIRE,ANGERS,6804,15572,22376,
Musée du Textile,2013,PAYS DE LA LOIRE,CHOLET,5801,6563,12364,
Musée Jules-Desbois,2013,PAYS DE LA LOIRE,PARCAY-LES-PINS,3492,2292,5784,
Musée des Sciences - CCSTI,2013,PAYS DE LA LOIRE,LAVAL,9403,33604,43007,
Musée Vert Véron-de-Forbonnais,2013,PAYS DE LA LOIRE,LE MANS,9392,8801,18193,
Centre Minier de Faymoreau,2013,PAYS DE LA LOIRE,FAYMOREAU,14749,6792,21541,
Musée de Fontenay-le-Comte,2013,PAYS DE LA LOIRE,FONTENAY-LE-COMTE,2497,3085,5582,
Ecomusée du Marais Breton Vendéen,2013,PAYS DE LA LOIRE,LA BARRE-DE-MONTS,15733,7273,23006,
Musée du Château,2013,PAYS DE LA LOIRE,NOIRMOUTIER-EN-L'ILE,33212,5483,38695,
Musée Jean de la Fontaine,2013,PICARDIE,CHATEAU-THIERRY,11841,2145,13986,
Musée des Beaux-Arts Antoine Lecuyer,2013,PICARDIE,SAINT-QUENTIN,2218,3464,5682,
Musée Gallé-Juillet,2013,PICARDIE,CREIL,2067,5130,7197,
Musée de la Vénerie,2013,PICARDIE,SENLIS,1691,3001,4692,
Musée de Picardie,2013,PICARDIE,AMIENS,6015,29002,35017,
Musée Lombart,2013,PICARDIE,DOULLENS,261,4958,5219,
Musée Régional de Fouras,2013,POITOU-CHARENTES,FOURAS,6145,1184,7329,
Musée Municipal des Cordeliers,2013,POITOU-CHARENTES,SAINT-JEAN-D'ANGELY,807,4482,5289,
Collection d'Histoire Naturelle,2013,POITOU-CHARENTES,POITIERS,19930,25110,45040,
Musée d'Histoire Locale,2013,PROVENCE-ALPES-CÔTE D'AZUR,BIOT,3275,0,3275,
Villa-Musée Jean-Honoré Fragonard,2013,PROVENCE-ALPES-CÔTE D'AZUR,GRASSE,0,5931,5931,
Musée Départemental des Arts Asiatiques,2013,PROVENCE-ALPES-CÔTE D'AZUR,NICE,0,72475,72475,
Musée d'Art Naïf Anatole Jakovsky,2013,PROVENCE-ALPES-CÔTE D'AZUR,NICE,0,18162,18162,
Musée du Vieux-Logis de Nice,2013,PROVENCE-ALPES-CÔTE D'AZUR,NICE,0,229,229,
Musée Municipal Méditerranéen de Cassis A.T.P.,2013,PROVENCE-ALPES-CÔTE D'AZUR,CASSIS,45,9776,9821,
Muséum d'Histoire Naturelle,2013,PROVENCE-ALPES-CÔTE D'AZUR,MARSEILLE,8425,36247,44672,
Musée Grobet-Labadié,2013,PROVENCE-ALPES-CÔTE D'AZUR,MARSEILLE,16683,0,16683,
Musée Ziem,2013,PROVENCE-ALPES-CÔTE D'AZUR,MARTIGUES,14083,9661,23744,
Musée Suffren et du Vieux Saint-Cannat,2013,PROVENCE-ALPES-CÔTE D'AZUR,SAINT-CANNAT,0,2436,2436,
Muséum d'Histoire Naturelle de Toulon et du Var,2013,PROVENCE-ALPES-CÔTE D'AZUR,TOULON,0,77454,77454,
Musée National de la Marine de Toulon,2013,PROVENCE-ALPES-CÔTE D'AZUR,TOULON,25513,39777,65290,
Muséum d'Histoire Naturelle Esprit Requien,2013,PROVENCE-ALPES-CÔTE D'AZUR,AVIGNON,0,13206,13206,
Musée du Petit Palais,2013,PROVENCE-ALPES-CÔTE D'AZUR,AVIGNON,14359,10724,25083,
Musée Municipal Camille Pautet,2013,PROVENCE-ALPES-CÔTE D'AZUR,MAZAN,0,1786,1786,
Musée des Vans,2013,RHONE-ALPES,LES VANS,340,631,971,
Musée d'Histoire et d'Archéologie,2013,RHONE-ALPES,DIE,976,1055,2031,
Musée du Chablais,2013,RHONE-ALPES,THONON-LES-BAINS,1223,1913,3136,
Musée Archéologique Grenoble Saint-Laurent,2013,RHONE-ALPES,GRENOBLE,0,39777,39777,
Musée Dauphinois,2013,RHONE-ALPES,GRENOBLE,0,67630,67630,
Musée Hector Berlioz,2013,RHONE-ALPES,LA-COTE-SAINT-ANDRE,0,13099,13099,
Musée Lucien Mainssieux,2013,RHONE-ALPES,VOIRON,0,6102,6102,
Musée de la Mine / Site Couriot,2013,RHONE-ALPES,SAINT-ETIENNE,28471,27520,55991,
Château de la Bastie d'Urfé,2013,RHONE-ALPES,SAINT-ETIENNE-LE-MOLARD,15157,9999,25156,
Musée des Civilisations : Daniel Pouget,2013,RHONE-ALPES,SAINT-JUST-SAINT-RAMBERT,3655,5222,8877,
Musée des Sapeurs-Pompiers de Lyon,2013,RHONE-ALPES,LYON,3233,1813,5046,
Musée Archéologique,2013,RHONE-ALPES,SAINT-ROMAIN-EN-GAL,21758,60495,82253,
Ecomusée du Haut Beaujolais,2013,RHONE-ALPES,THIZY-LES-BOURGS,261,990,1251,
Musée Savoisien,2013,RHONE-ALPES,CHAMBERY,2183,23612,25795,
Musée Historique,2014,ALSACE,HAGUENAU,3353,12000,15353,
Musée du Château des Rohan,2014,ALSACE,SAVERNE,4327,4156,8483,
Musée Archéologique,2014,ALSACE,STRASBOURG,18845,31711,50556,
Musée Alsacien,2014,ALSACE,STRASBOURG,37249,26111,63360,
Musée Tomi Ungerer,2014,ALSACE,STRASBOURG,20175,20566,40741,
Musée Sundgauvien d'Altkirch,2014,ALSACE,ALTKIRCH,546,3420,3966,
Musée Bartholdi,2014,ALSACE,COLMAR,12006,6429,18435,
Musée du Vignoble et des Vins d'Alsace,2014,ALSACE,KAYSERSBERG VIGNOBLE,3267,0,3267,
Musée des Beaux-Arts,2014,ALSACE,MULHOUSE,0,19548,19548,
Musée EDF Electropolis,2014,ALSACE,MULHOUSE,28011,12477,40488,
Musée Fernand Desmoulin,2014,AQUITAINE,BRANTOME,20348,2115,22463,
Musée Municipal Albert Marzelles,2014,AQUITAINE,MARMANDE,0,5571,5571,
Musée de Préhistoire Mésolithique Laurent Coulonges,2014,AQUITAINE,SAUVETERRE-LA-LEMANCE,2709,206,2915,
Musée Bonnat-Helleu - Musée des Beaux-Arts de Bayonne,2014,AQUITAINE,BAYONNE,0,1716,1716,
Musée Basque et de l'Histoire de Bayonne,2014,AQUITAINE,BAYONNE,15793,21809,37602,
Musée Municipal de Guéthary,2014,AQUITAINE,GUETHARY,1156,2139,3295,
Musée National du Château,2014,AQUITAINE,PAU,42315,44333,86648,
Musée d'Art et d'Archéologie,2014,AUVERGNE,AURILLAC Cedex,1773,19094,20867,
Musée d'art et d'histoire Alfred Douët,2014,AUVERGNE,SAINT-FLOUR,934,1352,2286,
Musée d'Histoire et d'Archéologie,2014,AUVERGNE,DIE,821,2960,3781,
Musée des Beaux-Arts,2014,BOURGOGNE,BEAUNE,5567,2319,7886,
Musée du Pays Châtillonnais - Trésor de Vix,2014,BOURGOGNE,CHATILLON-SUR-SEINE,13265,6315,19580,
Musée François Rude,2014,BOURGOGNE,DIJON,0,60071,60071,
Musée d'Art Sacré,2014,BOURGOGNE,DIJON,0,7082,7082,
Musée de la Faïence et des Beaux-Arts,2014,BOURGOGNE,NEVERS,10630,9777,20407,
Museum d'Histoire Naturelle Jacques de La Comble,2014,BOURGOGNE,AUTUN,1453,2137,3590,
Musée d'Art et d'Archéologie,2014,BOURGOGNE,CLUNY,11227,2855,14082,
Musée Eucharistique du Hiéron,2014,BOURGOGNE,PARAY-LE-MONIAL,4955,5122,10077,
Hôtel Dieu - Musée Greuze,2014,BOURGOGNE,TOURNUS,8384,1639,10023,
Muséum - Maison de l'Eau,2014,BOURGOGNE,AUXERRE,0,16659,16659,
Musée d'Art et d'Histoire,2014,BOURGOGNE,AUXERRE,0,43185,43185,
Musée Colette,2014,BOURGOGNE,SAINT-SAUVEUR-EN-PUISAYE,4442,1590,6032,
Musée Muncipal,2014,BOURGOGNE,SENS,6066,25735,31801,
Musée des Phares et Balises,2014,BRETAGNE,OUESSANT,13877,2812,16689,
Musée Départemental Breton,2014,BRETAGNE,QUIMPER,22749,23724,46473,
Ecomusée de Saint-Dégan,2014,BRETAGNE,BREC'H,7431,1962,9393,
Musée Estève,2014,CENTRE,BOURGES,0,15725,15725,
Musée des Arts Décoratifs,2014,CENTRE,BOURGES,0,18628,18628,
Musée du Berry,2014,CENTRE,BOURGES,0,16313,16313,
Musée Emile Chénon,2014,CENTRE,CHATEAUMEILLANT,429,709,1138,
Musée des Beaux-Arts et d'Histoire Naturelle,2014,CENTRE,CHATEAUDUN,3136,5348,8484,
Musée de l'Histoire du Perche,2014,CENTRE,NOGENT-LE-ROTROU,9234,11429,20663,
Musée George Sand et de la Vallée Noire,2014,CENTRE,LA CHATRE,9800,0,9800,
Musée de l'Hôtel des Communes,2014,CENTRE,AMBOISE,0,6929,6929,
Musée Balzac,2014,CENTRE,SACHE,12639,7526,20165,
Ecomusée du Véron,2014,CENTRE,SAVIGNY-EN-VERON,0,2125,2125,
Musée de Sologne,2014,CENTRE,ROMORANTIN-LANTHENAY,5136,17559,22695,
Musée Gaston Couté,2014,CENTRE,MEUNG-SUR-LOIRE,0,3669,3669,
Musée Napoléon Ier,2014,CHAMPAGNE-ARDENNES,BRIENNE-LE-CHATEAU,3643,2096,5739,
Musée des Beaux-Arts et d'Archéologie,2014,CHAMPAGNE-ARDENNES,CHAUMONT,1163,1462,2625,
Musée du Breuil de Saint-Germain,2014,CHAMPAGNE-ARDENNES,LANGRES,8065,5821,13886,
Musée Municipal,2014,CHAMPAGNE-ARDENNES,CHALONS-EN-CHAMPAGNE,1551,11012,12563,
Musée d'archéologie d'Aleria - Jérôme Carcopino,2014,CORSE,ALERIA,32268,19972,52240,
Musée de la résistance et de la Déportation,2014,FRANCHE-COMTE,BESANCON,53441,0,53441,
Musée Beurnier-Rossel,2014,FRANCHE-COMTE,MONTBELIARD,2195,3234,5429,
Musée Baron Martin,2014,FRANCHE-COMTE,GRAY,3443,3175,6618,
Musée Georges Garret,2014,FRANCHE-COMTE,VESOUL,0,4875,4875,
Musée Municipal d'Archéologie,2014,FRANCHE-COMTE,CHAMPAGNOLE,323,295,618,
Musée des Beaux-Arts,2014,FRANCHE-COMTE,LONS-LE-SAUNIER,897,2542,3439,
Musée des Salines,2014,FRANCHE-COMTE,SALINS-LES-BAINS,63837,5873,69710,
Musée d'Art et d'Histoire,2014,FRANCHE-COMTE,BELFORT,24158,0,24158,
Donation Maurice Jardot,2014,FRANCHE-COMTE,BELFORT,8236,0,8236,
Musée Départemental Victor Schoelcher,2014,GUADELOUPE,POINTE-A-PITRE,4191,4471,8662,
Ecomusée Municipal d'Approuague-Kaw,2014,GUYANE,REGINA,2258,2774,5032,
Fondation Arp,2014,ILE-DE-FRANCE,CLAMART,1303,449,1752,
Musée d'Art et d'Histoire,2014,ILE-DE-FRANCE,MEUDON,2115,7958,10073,
Grande Galerie de l'Evolution (Muséum National d'Histoire Naturelle),2014,ILE-DE-FRANCE,PARIS,401799,367931,769730,
Galerie d'Anatomie Comparée et de Paléontologie (Muséum d'Histoire Naturelle),2014,ILE-DE-FRANCE,PARIS,121711,196071,317782,
Musée Carnavalet-Histoire de Paris,2014,ILE-DE-FRANCE,PARIS,77550,360234,437784,
Etablissement public du musée d'Orsay et de l'Orangerie - Musée de l'Orangerie,2014,ILE-DE-FRANCE,PARIS,565736,236052,801788,
Musée Galliera - Musée de la Mode de la ville de Paris,2014,ILE-DE-FRANCE,PARIS,160135,56726,216861,
Établissement Public de la Porte Dorée - Musée de National de l’Histoire de l’Immigration,2014,ILE-DE-FRANCE,PARIS,52785,57958,110743,
Musée National Eugène Delacroix,2014,ILE-DE-FRANCE,PARIS,42085,26331,68416,
Musée National Picasso,2014,ILE-DE-FRANCE,PARIS,113366,97452,210818,
Musée du Quai Branly,2014,ILE-DE-FRANCE,PARIS,422920,765194,1188114,
Musée du Château de Fontainebleau,2014,ILE-DE-FRANCE,FONTAINEBLEAU,257286,259625,516911,
Musée Bossuet,2014,ILE-DE-FRANCE,MEAUX,7990,2832,10822,
Musée de la Grande Guerre du Pays de Meaux,2014,ILE-DE-FRANCE,MEAUX,113000,20000,133000,
Musée des Pays de Seine-et-Marne,2014,ILE-DE-FRANCE,SAINT-CYR-SUR-MORIN,2916,5015,7931,
Musée Adrien Mentienne,2014,ILE-DE-FRANCE,BRY-SUR-MARNE,0,1200,1200,
Musée de Nogent-Sur-Marne,2014,ILE-DE-FRANCE,NOGENT-SUR-MARNE,0,7126,7126,
Musée du Vieux Nîmes,2014,LANGUEDOC-ROUSSILLON,NIMES,1698,16035,17733,
Musée des Cultures Taurines (Annexe du Vieux Nîmes),2014,LANGUEDOC-ROUSSILLON,NIMES,838,8136,8974,
Musée Municipal Georges Borias,2014,LANGUEDOC-ROUSSILLON,UZES,1437,1267,2704,
Musée des Beaux-Arts de Béziers,2014,LANGUEDOC-ROUSSILLON,BEZIERS,3521,19953,23474,
Musée Archéologique,2014,LANGUEDOC-ROUSSILLON,MINERVE,4035,0,4035,
Musée Archéologique Paul Soyris,2014,LANGUEDOC-ROUSSILLON,MURVIEL-LES-MONTPELLIER,117,332,449,
Ecomusée du Mont Lozère,2014,LANGUEDOC-ROUSSILLON,LE PONT DE MONTVERT,2324,1967,4291,
Musée Labenche d'Art et d'Histoire,2014,LIMOUSIN,BRIVE-LA-GAILLARDE,2078,36701,38779,
Musée du Président Jacques Chirac,2014,LIMOUSIN,SARRAN,17301,4931,22232,
Musée du Cloître de Tulle André Mazeyrie,2014,LIMOUSIN,TULLE,0,9278,9278,
Musée de la Mémoire et des Industries Tullistes,2014,LIMOUSIN,TULLE,0,4140,4140,
Musée d'Art et d'Archéologie,2014,LIMOUSIN,GUERET,4280,4592,8872,
Musée René Baubérot,2014,LIMOUSIN,CHATEAUPONSAC,2646,542,3188,
Muséum- Aquarium de Nancy,2014,LORRAINE,NANCY,28086,60259,88345,
"Musée ""au Fil du Papier""",2014,LORRAINE,PONT-A-MOUSSON,2417,2187,4604,
Musée d'Art et d'Histoire de Toul,2014,LORRAINE,TOUL,0,6658,6658,
Musée Barrois,2014,LORRAINE,BAR-LE-DUC,2093,8701,10794,
Musée Jules Bastien-Lepage - Musée de la Fortification,2014,LORRAINE,MONTMEDY,12517,2776,15293,
"Jardin d'Hiver, Musée de La Faïence",2014,LORRAINE,SARREGUEMINES,5089,4979,10068,
Musée Départemental Georges de la Tour,2014,LORRAINE,VIC-SUR-SEILLE,3758,6614,10372,
Musée Régional de Géologie Pierre Vetter,2014,MIDI-PYRENEES,DECAZEVILLE,3025,2384,5409,
Musée Archéologique,2014,MIDI-PYRENEES,EAUZE,7138,2112,9250,
Le Musée - Arts et Figures des Pyrénées Centrales,2014,MIDI-PYRENEES,SAINT-GAUDENS,0,5218,5218,
Musée Salies,2014,MIDI-PYRENEES,BAGNERES-DE-BIGORRE,2889,0,2889,
Musée-château Gaston Phébus,2014,MIDI-PYRENEES,MAUVEZIN,26980,700,27680,
Musée Massey,2014,MIDI-PYRENEES,TARBES,4744,5674,10418,
Musée Henri Martin,2014,MIDI-PYRENEES,CAHORS,4122,7753,11875,
Musée Champollion - Les Ecriture du Monde,2014,MIDI-PYRENEES,FIGEAC,32146,9140,41286,
Musée Jean Jaurès,2014,MIDI-PYRENEES,CASTRES,3897,9400,13297,
Musée Départemental du Textile,2014,MIDI-PYRENEES,LA-BASTIDE-ROUAIROUX,2555,3568,6123,
Musée des arts et traditions populaires,2014,MIDI-PYRENEES,MOISSAC,0,437,437,
Musée Benoît de Puydt,2014,NORD-PAS-DE-CALAIS,BAILLEUL,4082,557,4639,
Musée de l'Ostrevant,2014,NORD-PAS-DE-CALAIS,BOUCHAIN,106,315,421,
Musée Municipal d'Escaudain,2014,NORD-PAS-DE-CALAIS,ESCAUDAIN,0,374,374,
Musée Municipal d'Hazebrouck,2014,NORD-PAS-DE-CALAIS,HAZEBROUCK,5423,0,5423,
"Musée de la Mine, Centre Historique Minier",2014,NORD-PAS-DE-CALAIS,LEWARDE,142427,13256,155683,
Musée d'Histoire Naturelle et de Géologie,2014,NORD-PAS-DE-CALAIS,LILLE,89675,0,89675,
La Piscine - Musée d'Art et d'Industrie André Diligent de Roubaix,2014,NORD-PAS-DE-CALAIS,ROUBAIX,124728,79091,203819,
Musée Communautaire Opale-Sud,2014,NORD-PAS-DE-CALAIS,BERCK-SUR-MER,2378,5202,7580,
Musée Régional d'Ethnologie,2014,NORD-PAS-DE-CALAIS,BETHUNE,0,4858,4858,
Musée des Beaux-Arts et de la Dentelle,2014,NORD-PAS-DE-CALAIS,CALAIS,9053,9230,18283,
Louvre-Lens (collections nationales decentralisées),2014,NORD-PAS-DE-CALAIS,LENS,196754,295130,491884,
Musée Baron Gérard,2014,BASSE-NORMANDIE,BAYEUX,18917,9860,28777,
Musée de Normandie,2014,BASSE-NORMANDIE,CAEN,19357,72772,92129,
Château de Saint-Germain de Livet,2014,BASSE-NORMANDIE,SAINT-GERMAIN DE LIVET,10572,6559,17131,
Musée de la Bataille de Tilly-Sur-Seulles 1944,2014,BASSE-NORMANDIE,TILLY-SUR-SEULLES,1299,833,2132,
Musée de l'Abbaye,2014,BASSE-NORMANDIE,CERISY-LA-FORET,5501,597,6098,
Musée de la Guerre et de la Libération,2014,BASSE-NORMANDIE,CHERBOURG-EN-COTENTIN,4418,8651,13069,
Ferme-Musée du Cotentin,2014,BASSE-NORMANDIE,SAINTE-MERE-EGLISE,8247,3622,11869,
Musée Départemental d'Art Sacré,2014,BASSE-NORMANDIE,SEES,374,421,795,
Musée des Terres-Neuvas et de la Pêche,2014,HAUTE-NORMANDIE,FECAMP,0,2000,2000,
Musée d'Art Moderne André Malraux - MuMa,2014,HAUTE-NORMANDIE,LE HAVRE,82258,56815,139073,
Muséum d'Histoire Naturelle,2014,HAUTE-NORMANDIE,LE HAVRE,0,41533,41533,
Musée des Sapeurs-Pompiers de France,2014,HAUTE-NORMANDIE,MONTVILLE,5064,4306,9370,
Musée Flaubert et d'Histoire de la Médecine,2014,HAUTE-NORMANDIE,ROUEN,3888,4096,7984,
Musée des Marais Salant,2014,PAYS DE LA LOIRE,BATZ-SUR-MER,13528,5155,18683,
Musée du Vignoble Nantais,2014,PAYS DE LA LOIRE,LE PALLET,3468,2592,6060,
Ecomusée de Saint-Nazaire,2014,PAYS DE LA LOIRE,SAINT-NAZAIRE,31631,17862,49493,
Musée Jean Lurcat et de la Tapisserie Contemporaine,2014,PAYS DE LA LOIRE,ANGERS,15966,45130,61096,
Musée Jules-Desbois,2014,PAYS DE LA LOIRE,PARCAY-LES-PINS,2903,1891,4794,
Musée de la Vigne et du Vin d'Anjou,2014,PAYS DE LA LOIRE,SAINT LAMBERT-DU-LATTAY - VAL-DU-LAYON,5337,1779,7116,
Musée de l'Ardoise,2014,PAYS DE LA LOIRE,TRELAZE,8220,1810,10030,
Musée de l'Ardoise et de la Géologie,2014,PAYS DE LA LOIRE,RENAZE,1419,401,1820,
Musée du Château,2014,PAYS DE LA LOIRE,NOIRMOUTIER-EN-L'ILE,35643,4456,40099,
Musée Milcendeau Jean-Yole,2014,PAYS DE LA LOIRE,SOULLANS,3340,913,4253,
Musée Alexandre Dumas,2014,PICARDIE,VILLERS COTTERETS,669,984,1653,
Musée Boucher-de-Perthes,2014,PICARDIE,ABBEVILLE,8589,0,8589,
Musée de Picardie,2014,PICARDIE,AMIENS,6706,35819,42525,
Atelier - Musée du Papier,2014,POITOU-CHARENTES,ANGOULEME,590,20762,21352,
Musée des Arts du Cognac (Annexe musée municipal),2014,POITOU-CHARENTES,COGNAC,6143,5285,11428,
Muséum d'Histoire Naturelle,2014,POITOU-CHARENTES,LA ROCHELLE,10116,34856,44972,
Musée Protestant,2014,POITOU-CHARENTES,LA ROCHELLE,1238,267,1505,
Musée de l'Echevinage,2014,POITOU-CHARENTES,SAINTES,0,7015,7015,
Musée ethnographique et archéologique du Donjon,2014,POITOU-CHARENTES,NIORT,9564,9403,18967,
Musée des Traditions Populaires et d'Archéologie,2014,POITOU-CHARENTES,CHAUVIGNY,6519,2414,8933,
Musée Municipal de la Maison-Dieu,2014,POITOU-CHARENTES,MONTMORILLON,0,6602,6602,
Musée Sainte-Croix,2014,POITOU-CHARENTES,POITIERS,5635,22882,28517,
Musée de la vallée,2014,PROVENCE-ALPES-CÔTE D'AZUR,BARCELONNETTE,9702,2982,12684,
Musée de Salagon,2014,PROVENCE-ALPES-CÔTE D'AZUR,MANE,29433,6233,35666,
Musée archéologique,2014,PROVENCE-ALPES-CÔTE D'AZUR,VACHERES,643,388,1031,
Musée Picasso,2014,PROVENCE-ALPES-CÔTE D'AZUR,ANTIBES,113493,44483,157976,
Musée International de la Parfumerie,2014,PROVENCE-ALPES-CÔTE D'AZUR,GRASSE,61062,29248,90310,
Musée des Beaux-Arts,2014,PROVENCE-ALPES-CÔTE D'AZUR,MENTON,0,15795,15795,
Musée Jean Cocteau Collection Séverin Wunderman,2014,PROVENCE-ALPES-CÔTE D'AZUR,MENTON,41413,16492,57905,
Musée Départemental des Arts Asiatiques,2014,PROVENCE-ALPES-CÔTE D'AZUR,NICE,0,60382,60382,
Musée Archéologique - Site de Terra Amata,2014,PROVENCE-ALPES-CÔTE D'AZUR,NICE,0,19826,19826,
Musées de la Citadelle,2014,PROVENCE-ALPES-CÔTE D'AZUR,VILLEFRANCHE-SUR-MER,0,77262,77262,
Muséum d'Histoire Naturelle,2014,PROVENCE-ALPES-CÔTE D'AZUR,AIX-EN-PROVENCE,2047,23470,25517,
Musée- Atelier de Paul Cézanne,2014,PROVENCE-ALPES-CÔTE D'AZUR,AIX-EN-PROVENCE,58721,8774,67495,
Musée Municipal Méditerranéen de Cassis A.T.P.,2014,PROVENCE-ALPES-CÔTE D'AZUR,CASSIS,95,7678,7773,
Musée Ciotaden,2014,PROVENCE-ALPES-CÔTE D'AZUR,LA CIOTAT,1684,3438,5122,
Musée Folklorique du Vieux Lambesc,2014,PROVENCE-ALPES-CÔTE D'AZUR,LAMBESC,0,4320,4320,
Musée des Docks Romains,2014,PROVENCE-ALPES-CÔTE D'AZUR,MARSEILLE,39,12217,12256,
Musée d'Archéologie Méditerranéenne,2014,PROVENCE-ALPES-CÔTE D'AZUR,MARSEILLE,71251,43880,115131,
Musée des Beaux-Arts de Marseille,2014,PROVENCE-ALPES-CÔTE D'AZUR,MARSEILLE,17163,43313,60476,
Musée Grobet-Labadié,2014,PROVENCE-ALPES-CÔTE D'AZUR,MARSEILLE,0,2943,2943,
Musée Municipal Paul Lafran,2014,PROVENCE-ALPES-CÔTE D'AZUR,SAINT-CHAMAS,0,4385,4385,
Musée Départemental des Hautes-Alpes,2014,PROVENCE-ALPES-CÔTE D'AZUR,GAP,0,19383,19383,
Musée Archéologique Gallo-Romaine du Var,2014,PROVENCE-ALPES-CÔTE D'AZUR,FREJUS,5986,0,5986,
Musée des Troupes de Marine,2014,PROVENCE-ALPES-CÔTE D'AZUR,FREJUS,0,17793,17793,
Musée Municipal,2014,PROVENCE-ALPES-CÔTE D'AZUR,HYERES,4744,6694,11438,
Musée du Vêtement Provençal (Jean Aicard),2014,PROVENCE-ALPES-CÔTE D'AZUR,SOLLIES-VILLE,0,5278,5278,
Musée d'Art et d'Archéologie,2014,PROVENCE-ALPES-CÔTE D'AZUR,TOULON,0,26803,26803,
Musée d'Apt,2014,PROVENCE-ALPES-CÔTE D'AZUR,APT,2762,6523,9285,
Synagogue Musée Juif Comtadin,2014,PROVENCE-ALPES-CÔTE D'AZUR,CAVAILLON,3108,1758,4866,
Musée Archéologique,2014,RHONE-ALPES,IZERNORE,1160,1860,3020,
Musée du Peigne et de la Plasturgie,2014,RHONE-ALPES,OYONNAX,2408,2716,5124,
Musée Louis Jourdan,2014,RHONE-ALPES,SAINT-PAUL-DE-VARAX,139,54,193,
Musée du Rhône,2014,RHONE-ALPES,TOURNON-SUR-RHÔNE,17131,15436,32567,
Musée Alpin,2014,RHONE-ALPES,CHAMONIX,11572,6010,17582,
Musée Alice Taverne,2014,RHONE-ALPES,AMBIERLE,3302,920,4222,
Musée des Beaux-Arts et d'Archéologie J. Dechelette,2014,RHONE-ALPES,ROANNE,4380,7125,11505,
Musée d'Art et d'Industrie,2014,RHONE-ALPES,SAINT-ETIENNE,27126,21317,48443,
Musée des Confluences,2014,RHONE-ALPES,LYON,47426,4000,51426,
Musée Gallo-Romain,2015,ALSACE,BIESHEIM,638,1311,1949,
Musée Bartholdi,2015,ALSACE,COLMAR,13573,7449,21022,
Musée d'Unterlinden,2015,ALSACE,COLMAR,129744,29767,159511,
Musée Théodore Deck et des Pays du Florival,2015,ALSACE,GUEBWILLER,1534,3961,5495,
Musée du Vignoble et des Vins d'Alsace,2015,ALSACE,KAYSERSBERG VIGNOBLE,2911,40,2951,
Musée EDF Electropolis,2015,ALSACE,MULHOUSE,21445,10978,32423,
Musée Minéralogique de la Société Industrielle de Mulhouse,2015,ALSACE,MULHOUSE,0,100,100,
Musée des Amis de Thann,2015,ALSACE,THANN,382,1683,2065,
Musée du Sapeur Pompier d'Alsace,2015,ALSACE,VIEUX FERRETTE,5111,1165,6276,
Musée d'Art et Traditions Populaires,2015,AQUITAINE,VILLEFRANCHE-DE-LONCHAT,0,2675,2675,
Musée d'Aquitaine,2015,AQUITAINE,BORDEAUX,43245,95982,139227,
CAPC Musée d'Art Contemporain de Bordeaux,2015,AQUITAINE,BORDEAUX,45846,53283,99129,
Musée Municipal Albert Marzelles,2015,AQUITAINE,MARMANDE,0,4467,4467,
Musée du Château Henri IV,2015,AQUITAINE,NERAC,14102,9112,23214,
Musée Municipal de Guéthary,2015,AQUITAINE,GUETHARY,526,2770,3296,
Musée Charles-Louis Philippe,2015,AUVERGNE,CERILLY,100,101,201,
Musée Municipal de Gannat,2015,AUVERGNE,GANNAT,604,918,1522,
Musée de la Haute Auvergne,2015,AUVERGNE,SAINT-FLOUR,1891,3223,5114,
Musée d'art et d'histoire Alfred Douët,2015,AUVERGNE,SAINT-FLOUR,1000,1035,2035,
Musée d'Art Roger-Quillot,2015,AUVERGNE,CLERMONT-FERRAND,3478,20299,23777,
Muséum d'Histoire Naturelle Henri-Lecoq,2015,AUVERGNE,CLERMONT-FERRAND,5005,24745,29750,
Musée d'Art Sacré,2015,BOURGOGNE,DIJON,0,6911,6911,
Musée Municipal,2015,BOURGOGNE,NUITS-SAINT-GEORGES,0,3277,3277,
Musée de la Loire,2015,BOURGOGNE,COSNE-SUR-LOIRE,948,5434,6382,
Musée de la Faïence et des Beaux-Arts,2015,BOURGOGNE,NEVERS,6667,5645,12312,
Musée du Grès de Puisaye,2015,BOURGOGNE,SAINT-AMAND-EN-PUISAYE,1934,0,1934,
Musée Auguste Grasset,2015,BOURGOGNE,VARZY,1903,0,1903,
Musée Rolin,2015,BOURGOGNE,AUTUN,9422,5316,14738,
Museum d'Histoire Naturelle Jacques de La Comble,2015,BOURGOGNE,AUTUN,1244,2275,3519,
Musée de la Mine,2015,BOURGOGNE,BLANZY,9339,1173,10512,
Musée Denon,2015,BOURGOGNE,CHALON-SUR-SAONE,0,11418,11418,
Musée des Ursulines,2015,BOURGOGNE,MACON,2272,21590,23862,
Musée Départemental du Compagnonnage,2015,BOURGOGNE,ROMANECHE-THORINS,2060,2119,4179,
Musée des Arts Naïfs et Populaires de Noyers sur Serein,2015,BOURGOGNE,NOYERS-SUR-SEREIN,2129,1368,3497,
Musée Mathurin Meheut,2015,BRETAGNE,LAMBALLE,7731,1430,9161,
Musée de la Pêche,2015,BRETAGNE,CONCARNEAU,21899,19762,41661,
Musée Bigouden,2015,BRETAGNE,PONT-L'ABBE,10464,2472,12936,
Ecomusée de Saint-Dégan,2015,BRETAGNE,BREC'H,8339,2362,10701,
Musée de la Résistance Bretonne,2015,BRETAGNE,SAINT-MARCEL - MALESTROIT,12373,1304,13677,
Musée d'Histoire et d'Archéologie de Vannes,2015,BRETAGNE,VANNES,1910,4063,5973,
Musée des Arts Décoratifs,2015,CENTRE,BOURGES,0,11017,11017,
Musée du Château Charles VII,2015,CENTRE,MEHUN-SUR-YEVRE,8359,0,8359,
Musée des Beaux-Arts et d'Histoire Naturelle,2015,CENTRE,CHATEAUDUN,7592,0,7592,
Musée d'Art et d'Histoire Marcel Dessal,2015,CENTRE,DREUX,6468,0,6468,
Musée Marcel Proust,2015,CENTRE,ILLIERS-COMBRAY,3923,923,4846,
Château Musée,2015,CENTRE,AZAY-LE-FERRON,14446,5075,19521,
Musée de l'Hospice Saint-Roch,2015,CENTRE,ISSOUDUN,479,16649,17128,
Musée Ornithologique (Ecomusée de la Brenne),2015,CENTRE,LE BLANC,1993,2125,4118,
Musée de l'Hôtel des Communes,2015,CENTRE,AMBOISE,0,8900,8900,
Musée Lansyer,2015,CENTRE,LOCHES,3154,1492,4646,
Musée de l'Hôtel de Ville,2015,CENTRE,RICHELIEU,2314,406,2720,
Musée de Sologne,2015,CENTRE,ROMORANTIN-LANTHENAY,4081,7894,11975,
Musée Arthur Rimbaud,2015,CHAMPAGNE-ARDENNES,CHARLEVILLE-MEZIERES,1614,22699,24313,
Musée du Feutre,2015,CHAMPAGNE-ARDENNES,MOUZON,2714,1159,3873,
Maison de l'Outil  et de la Pensée Ouvrière,2015,CHAMPAGNE-ARDENNES,TROYES,11111,4465,15576,
Musée des Beaux-Arts,2015,CHAMPAGNE-ARDENNES,TROYES,7797,12354,20151,
Musée d'Art et d'Histoire,2015,CHAMPAGNE-ARDENNES,LANGRES,2408,6949,9357,
Musée Saint-Rémi,2015,CHAMPAGNE-ARDENNES,REIMS,4330,19229,23559,
Musée des Beaux-Arts de Saint-Denis,2015,CHAMPAGNE-ARDENNES,REIMS,18651,17887,36538,
Musée de la Maison Bonaparte,2015,CORSE,AJACCIO,46750,23808,70558,
Muséum de Besançon,2015,FRANCHE-COMTE,BESANCON,222148,0,222148,
Musée Beurnier-Rossel,2015,FRANCHE-COMTE,MONTBELIARD,2024,3037,5061,
Musée Départemental Victor Schoelcher,2015,GUADELOUPE,POINTE-A-PITRE,3533,4876,8409,
Musée Municipal d'Art et d'Histoire,2015,ILE-DE-FRANCE,COLOMBES,0,6330,6330,
Musée Roybet Fould,2015,ILE-DE-FRANCE,COURBEVOIE,0,11849,11849,
Grande Galerie de l'Evolution (Muséum National d'Histoire Naturelle),2015,ILE-DE-FRANCE,PARIS,414944,276628,691572,
Galerie d'Anatomie Comparée et de Paléontologie (Muséum d'Histoire Naturelle),2015,ILE-DE-FRANCE,PARIS,119627,179439,299066,
Galerie de Botanique (Muséum National National d'Histoire Naturelle),2015,ILE-DE-FRANCE,PARIS,3866,5896,9762,
Galerie de Minéralogie et de Géologie (Muséum d'Histoire Naturelle),2015,ILE-DE-FRANCE,PARIS,64726,14207,78933,
Musée de la Vie Romantique,2015,ILE-DE-FRANCE,PARIS,13826,74522,88348,
Maison de Balzac,2015,ILE-DE-FRANCE,PARIS,9049,18523,27572,
Établissement Public de la Porte Dorée - Musée de National de l’Histoire de l’Immigration,2015,ILE-DE-FRANCE,PARIS,55916,55714,111630,
Musée National Picasso,2015,ILE-DE-FRANCE,PARIS,529067,237697,766764,
Musée Départemental de Préhistoire d'Île de France,2015,ILE-DE-FRANCE,NEMOURS,5498,22009,27507,
Musée des Pays de Seine-et-Marne,2015,ILE-DE-FRANCE,SAINT-CYR-SUR-MORIN,1231,6737,7968,
Ecomusée du Val de Bièvre,2015,ILE-DE-FRANCE,FRESNES,0,8894,8894,
Musée Tavet Delacour,2015,ILE-DE-FRANCE,PONTOISE,2337,3211,5548,
Musée Camille Pissarro,2015,ILE-DE-FRANCE,PONTOISE,0,4414,4414,
Musée de la Toile de Jouy,2015,ILE-DE-FRANCE,JOUY-EN-JOSAS,8306,3696,12002,
Musée du Jouet Pierre Pinel,2015,ILE-DE-FRANCE,POISSY,10316,4822,15138,
Etablissement Public du Musée et du Domaine National de Versailles,2015,ILE-DE-FRANCE,VERSAILLES,5891323,1541478,7432801,
Musée des Beaux-Arts,2015,LANGUEDOC-ROUSSILLON,CARCASSONNE,0,70412,70412,
Musée Petiet,2015,LANGUEDOC-ROUSSILLON,LIMOUX,846,1808,2654,
Musée Léon Alègre,2015,LANGUEDOC-ROUSSILLON,BAGNOLS-SUR-CEZE,0,1257,1257,
Carré d'Art Musée d'Art Contemporain de Nîmes,2015,LANGUEDOC-ROUSSILLON,NIMES,12043,28962,41005,
Musée Départemental d'Art Sacré du Gard,2015,LANGUEDOC-ROUSSILLON,PONT-SAINT-ESPRIT,447,9891,10338,
Musée de l'Etang de Thau,2015,LANGUEDOC-ROUSSILLON,BOUZIGUES,12772,1964,14736,
Musée Archéologique,2015,LANGUEDOC-ROUSSILLON,MINERVE,4278,0,4278,
Musée Fabre,2015,LANGUEDOC-ROUSSILLON,MONTPELLIER,111200,80524,191724,
Ecomusée du Mont Lozère,2015,LANGUEDOC-ROUSSILLON,LE PONT DE MONTVERT,2369,2111,4480,
Musée départemental d'Art Moderne,2015,LANGUEDOC-ROUSSILLON,CERET,43020,28680,71700,
Musée d'Art Moderne - Fonds Peskè,2015,LANGUEDOC-ROUSSILLON,COLLIOURE,7206,1680,8886,
Musée du Château de Lunéville,2015,LORRAINE,LUNEVILLE,92397,60259,152656,
Musée de l'Ecole de Nancy,2015,LORRAINE,NANCY,25840,14812,40652,
Musée Jules Bastien-Lepage - Musée de la Fortification,2015,LORRAINE,MONTMEDY,11212,2517,13729,
Maison du Verre et du Cristal,2015,LORRAINE,MEISENTHAL,16725,3133,19858,
Centre Pompidou de Metz (collections nationales decentralisées),2015,LORRAINE,METZ,198430,132286,330716,
Musée des Mines de fer de Lorraine,2015,LORRAINE,NEUFCHEF,16736,1579,18315,
La Tour aux Puces - Musée du Pays Thionvillois,2015,LORRAINE,THIONVILLE,576,10515,11091,
Ecomusée de la Martinique,2015,MARTINIQUE,RIVIERE-PILOTE,5015,2856,7871,
Musée Volcanologique Franck Arnold Perret,2015,MARTINIQUE,SAINT-PIERRE,23675,595,24270,
Musée de la Forge,2015,MIDI-PYRENEES,MONTGAILHARD,27732,0,27732,
Musée du Palais des Evêques,2015,MIDI-PYRENEES,SAINT-LIZIER,7966,1160,9126,
Musée de Préhistoire,2015,MIDI-PYRENEES,AURIGNAC,6289,1470,7759,
Musée des Transports et des Communications,2015,MIDI-PYRENEES,TOULOUSE,0,222,222,
Musée Saint-Raymond,2015,MIDI-PYRENEES,TOULOUSE,21394,32774,54168,
Musée de Préhistoire Amédée Lémozi,2015,MIDI-PYRENEES,CABRERETS,78891,0,78891,
Musée Murat,2015,MIDI-PYRENEES,CŒUR DE CAUSSE,790,53,843,
"Musée Archéologique ""Armand-Viré""",2015,MIDI-PYRENEES,LUZECH,614,181,795,
Musée de l'Abbaye Saint-Michel,2015,MIDI-PYRENEES,GAILLAC,1240,751,1991,
Musée des arts et traditions populaires,2015,MIDI-PYRENEES,MOISSAC,472,2067,2539,
Musée Municipal de Cambrai,2015,NORD-PAS-DE-CALAIS,CAMBRAI,1792,9551,11343,
Musée de la Chartreuse,2015,NORD-PAS-DE-CALAIS,DOUAI,5821,32107,37928,
Musée des Beaux-Arts,2015,NORD-PAS-DE-CALAIS,DUNKERQUE,0,1905,1905,
Musée du Dessin et de l'Estampe Originale,2015,NORD-PAS-DE-CALAIS,GRAVELINES,780,13183,13963,
MUba - Musée des Beaux-Arts Eugène Leroy de Tourcoing,2015,NORD-PAS-DE-CALAIS,TOURCOING,13940,12724,26664,
Musée des Beaux-Arts et de la Dentelle,2015,NORD-PAS-DE-CALAIS,CALAIS,5313,10712,16025,
Musée des Beaux-Arts,2015,BASSE-NORMANDIE,CAEN,21583,41075,62658,
Musée Eugène Boudin,2015,BASSE-NORMANDIE,HONFLEUR,19172,2856,22028,
Musée d'Art et d'Histoire de Lisieux,2015,BASSE-NORMANDIE,LISIEUX,89,4480,4569,
Musée du Château,2015,BASSE-NORMANDIE,PONTECOULANT,3004,1621,4625,
Musée et Sites archéologiques de Vieux-la-Romaine,2015,BASSE-NORMANDIE,VIEUX,11695,6205,17900,
Paléospace / Musée Paléontologique,2015,BASSE-NORMANDIE,VILLERS-SUR-MER,48901,7785,56686,
Musée Départemental d'Art Sacré,2015,BASSE-NORMANDIE,SEES,535,467,1002,
Musée Municipal Nicolas Poussin,2015,HAUTE-NORMANDIE,LES ANDELYS,958,1271,2229,
Musée des Antiquités de la Seine-Maritime,2015,HAUTE-NORMANDIE,ROUEN,2362,26398,28760,
Musée-Maison Natale Pierre Corneille,2015,HAUTE-NORMANDIE,ROUEN,0,7092,7092,
Muséum d'Histoire Naturelle,2015,HAUTE-NORMANDIE,ROUEN,5186,31087,36273,
Musée du Vignoble Nantais,2015,PAYS DE LA LOIRE,LE PALLET,3492,5691,9183,
Muséum des Sciences Naturelles,2015,PAYS DE LA LOIRE,ANGERS,3898,18005,21903,
Château-Musée,2015,PAYS DE LA LOIRE,SAUMUR,68373,13266,81639,
Musée des Sciences - CCSTI,2015,PAYS DE LA LOIRE,LAVAL,5444,32283,37727,
Musée Vert Véron-de-Forbonnais,2015,PAYS DE LA LOIRE,LE MANS,8738,11330,20068,
Musée de Fontenay-le-Comte,2015,PAYS DE LA LOIRE,FONTENAY-LE-COMTE,2162,3326,5488,
Historial de la Vendée,2015,PAYS DE LA LOIRE,LES LUCS-SUR-BOULOGNE,22477,32819,55296,
Musée de La Thiérache,2015,PICARDIE,VERVINS,0,8046,8046,
Musée Antoine Vivenel,2015,PICARDIE,COMPIEGNE,1458,11793,13251,
Musée Boucher-de-Perthes,2015,PICARDIE,ABBEVILLE,9219,0,9219,
Musée Alfred Danicourt,2015,PICARDIE,PERONNE,0,2468,2468,
Musée Archéologique et Historique,2015,POITOU-CHARENTES,ANGOULEME,89,373,462,
Musée Napoléonien et Africain,2015,POITOU-CHARENTES,ILE D'AIX,11447,10125,21572,
Hôtel Hèbre de Saint-Clément - Musée d'Art et d'Histoire,2015,POITOU-CHARENTES,ROCHEFORT,5933,10053,15986,
Musée des Tumulus de Bougon,2015,POITOU-CHARENTES,BOUGON,14190,5401,19591,
Musée Municipal de Civray,2015,POITOU-CHARENTES,CIVRAY,0,137,137,
Musée de Préhistoire Raymond Touchard,2015,POITOU-CHARENTES,LUSSAC-LES-CHATEAUX,2520,4241,6761,
Musée Picasso,2015,PROVENCE-ALPES-CÔTE D'AZUR,ANTIBES,97365,43719,141084,
Musée d'Histoire et d'Archéologie,2015,PROVENCE-ALPES-CÔTE D'AZUR,ANTIBES,4988,4872,9860,
Musée d'Histoire Locale,2015,PROVENCE-ALPES-CÔTE D'AZUR,BIOT,2530,0,2530,
Musée de la Castre,2015,PROVENCE-ALPES-CÔTE D'AZUR,CANNES,12584,14226,26810,
Musée Départemental des Arts Asiatiques,2015,PROVENCE-ALPES-CÔTE D'AZUR,NICE,986,45948,46934,
Musée Archéologique - Site de  Cimiez,2015,PROVENCE-ALPES-CÔTE D'AZUR,NICE,12188,12245,24433,
Musée d'Art Naïf Anatole Jakovsky,2015,PROVENCE-ALPES-CÔTE D'AZUR,NICE,9020,3054,12074,
Musée National Marc Chagall,2015,PROVENCE-ALPES-CÔTE D'AZUR,NICE,86745,45008,131753,
Musée Matisse,2015,PROVENCE-ALPES-CÔTE D'AZUR,NICE,89442,42281,131723,
Musée des Tapisseries,2015,PROVENCE-ALPES-CÔTE D'AZUR,AIX-EN-PROVENCE,3299,14322,17621,
Musée Camarguais,2015,PROVENCE-ALPES-CÔTE D'AZUR,ARLES,12665,4730,17395,
Musée d'Archéologie Méditerranéenne,2015,PROVENCE-ALPES-CÔTE D'AZUR,MARSEILLE,52124,62920,115044,
Musée Grobet-Labadié,2015,PROVENCE-ALPES-CÔTE D'AZUR,MARSEILLE,0,7434,7434,
Musée de la Société d’Etudes Scientifiques et Achéologiques,2015,PROVENCE-ALPES-CÔTE D'AZUR,DRAGUIGNAN,0,505,505,
Musée de l'Artillerie,2015,PROVENCE-ALPES-CÔTE D'AZUR,DRAGUIGNAN,0,14281,14281,
Musée d'Art et d'Archéologie,2015,PROVENCE-ALPES-CÔTE D'AZUR,TOULON,0,28696,28696,
Musée-Bibliothèque François Pétrarque,2015,PROVENCE-ALPES-CÔTE D'AZUR,FONTAINE-DE-VAUCLUSE,1949,862,2811,
Musée du Bugey-Valmorey,2015,RHONE-ALPES,LOCHIEU,2449,2344,4793,
Musée de la Résistance et de la Déportation de l'Ain,2015,RHONE-ALPES,NANTUA,3893,1979,5872,
Musée du Château des Adhémars,2015,RHONE-ALPES,MONTELIMAR,10496,8074,18570,
Musée d'Archéologie Tricastine,2015,RHONE-ALPES,SAINT-PAUL-TROIS-CHATEAUX,3330,4442,7772,
Musée Alpin,2015,RHONE-ALPES,CHAMONIX,25304,15656,40960,
"Notre histoire, Musée de Rumilly",2015,RHONE-ALPES,RUMILLY,1346,1178,2524,
Musée Jadis Allevard,2015,RHONE-ALPES,ALLEVARD-LES-BAINS,741,4039,4780,
Musée de Grenoble,2015,RHONE-ALPES,GRENOBLE,65524,102167,167691,
Conservatoire - Musée des Industries Hydroélectriques,2015,RHONE-ALPES,VAUJANY,0,9700,9700,
Musée Lapidaire Saint-Pierre,2015,RHONE-ALPES,VIENNE,4607,7317,11924,
Musée Alice Taverne,2015,RHONE-ALPES,AMBIERLE,3542,907,4449,
Musée Hospitalier,2015,RHONE-ALPES,CHARLIEU,2152,1019,3171,
Musée d'Histoire du  20ème Siècle - Résistance et Déportation,2015,RHONE-ALPES,ESTIVAREILLES,2247,1090,3337,
Musée des Civilisations : Daniel Pouget,2015,RHONE-ALPES,SAINT-JUST-SAINT-RAMBERT,6399,4750,11149,
Musée d'Art Moderne et Contemporain de Saint-Etienne Métropole,2015,RHONE-ALPES,SAINT-PRIEST-EN-JAREZ,53749,0,53749,
Musée Paul Dini,2015,RHONE-ALPES,VILLEFRANCHE-SUR-SAONE,4850,15486,20336,
Musée Municipal d'Albertville-Conflans,2015,RHONE-ALPES,ALBERTVILLE,2952,2170,5122,
Musée de la Résistance et de la Déportation,2016,AUVERGNE-RHONE-ALPES,NANTUA,786,244,1030,
Musée Anne de Beaujeu,2016,AUVERGNE-RHONE-ALPES,MOULINS,14178,14784,28962,
Centre National du Costume de Scène et de la Scénographie,2016,AUVERGNE-RHONE-ALPES,MOULINS,54153,18745,72898,
MuséAL - Musée Archéologique d'Alba,2016,AUVERGNE-RHONE-ALPES,ALBA-LA-ROMAINE,12758,2983,15741,
Musée du Rhône,2016,AUVERGNE-RHONE-ALPES,TOURNON-SUR-RHÔNE,14892,11091,25983,
Musée des Sciences,2016,AUVERGNE-RHONE-ALPES,AURILLAC,2685,7993,10678,
Musée du site Préhistorique,2016,AUVERGNE-RHONE-ALPES,VASSIEUX-EN-VERCORS,10500,0,10500,
Musée Alpin,2016,AUVERGNE-RHONE-ALPES,CHAMONIX,22485,13262,35747,
Musée Léon Marès,2016,AUVERGNE-RHONE-ALPES,LOVAGNY,19259,0,19259,
"Notre histoire, Musée de Rumilly",2016,AUVERGNE-RHONE-ALPES,RUMILLY,3071,1089,4160,
Musée Gallo-Romain,2016,AUVERGNE-RHONE-ALPES,AOSTE,4939,1983,6922,
Muséum d'Histoire Naturelle de Grenoble,2016,AUVERGNE-RHONE-ALPES,GRENOBLE,26733,67334,94067,
Musée Stendhal,2016,AUVERGNE-RHONE-ALPES,GRENOBLE,854,972,1826,
Musée Matheysin,2016,AUVERGNE-RHONE-ALPES,LA MURE,615,1621,2236,
Musée de la Grande Chartreuse,2016,AUVERGNE-RHONE-ALPES,SAINT-PIERRE-DE-CHARTREUSE,35311,1873,37184,
Conservatoire - Musée des Industries Hydroélectriques,2016,AUVERGNE-RHONE-ALPES,VAUJANY,0,7375,7375,
Musée des Beaux-Arts et d'Archéologie,2016,AUVERGNE-RHONE-ALPES,VIENNE,2227,3212,5439,
Musée Alice Taverne,2016,AUVERGNE-RHONE-ALPES,AMBIERLE,3493,741,4234,
Musée d'Histoire du  20ème Siècle - Résistance et Déportation,2016,AUVERGNE-RHONE-ALPES,ESTIVAREILLES,2251,1133,3384,
Musée de la Dentelle,2016,AUVERGNE-RHONE-ALPES,ARLANC,1096,73,1169,
Musée Départemental de la Céramique Gallo-Romaine,2016,AUVERGNE-RHONE-ALPES,LEZOUX,5910,5178,11088,
Musée des Pénitents Blancs,2016,AUVERGNE-RHONE-ALPES,MARSAC-EN-LIVRADOIS,108,6,114,
Musée des Peintres de l'Ecole de Murols,2016,AUVERGNE-RHONE-ALPES,MUROL,5048,222,5270,
Musée Francisque Mandet,2016,AUVERGNE-RHONE-ALPES,RIOM,4687,11292,15979,
Musée Régional d'Auvergne,2016,AUVERGNE-RHONE-ALPES,RIOM,0,2610,2610,
Musée Municipal Marcel Sahut,2016,AUVERGNE-RHONE-ALPES,VOLVIC,906,0,906,
Musée Folklorique et Traditions Populaires Marius Audin,2016,AUVERGNE-RHONE-ALPES,BEAUJEU,2717,435,3152,
Musée Historique des Tissus,2016,AUVERGNE-RHONE-ALPES,LYON,40980,19411,60391,
Musée d'Art Contemporain de Lyon,2016,AUVERGNE-RHONE-ALPES,LYON,59265,75735,135000,
Musée des Sapeurs-Pompiers de Lyon,2016,AUVERGNE-RHONE-ALPES,LYON,3776,5477,9253,
Ecomusée du Haut Beaujolais,2016,AUVERGNE-RHONE-ALPES,THIZY-LES-BOURGS,271,343,614,
"Musée de la Vie Bourguignonne, Perrin de Puycousin",2016,BOURGOGNE-FRANCHE-COMTE,DIJON,0,40741,40741,
Musée Noisot,2016,BOURGOGNE-FRANCHE-COMTE,FIXIN,209,76,285,
Musée des Beaux-Arts,2016,BOURGOGNE-FRANCHE-COMTE,MONTBARD,0,120,120,
Musée Municipal François Pompon,2016,BOURGOGNE-FRANCHE-COMTE,SAULIEU,3147,6109,9256,
Musée du Château des Ducs de Wurtemberg,2016,BOURGOGNE-FRANCHE-COMTE,MONTBELIARD,6874,10843,17717,
Musée de Plein Air des Maisons Comtoises,2016,BOURGOGNE-FRANCHE-COMTE,NANCRAY,31663,8994,40657,
Musée Départemental Albert-et-Félicie Demard - ATP,2016,BOURGOGNE-FRANCHE-COMTE,CHAMPLITTE,3737,7526,11263,
Musée Sarret de Grozon,2016,BOURGOGNE-FRANCHE-COMTE,ARBOIS,525,1602,2127,
Musée de la Vigne et du Vin,2016,BOURGOGNE-FRANCHE-COMTE,ARBOIS,3596,1607,5203,
Viséum-Musée de la Lunette,2016,BOURGOGNE-FRANCHE-COMTE,MOREZ HAUTS DE BIENNE,11087,6243,17330,
Musée du Septennat,2016,BOURGOGNE-FRANCHE-COMTE,CHATEAU-CHINON,6967,2339,9306,
Musée du Costume,2016,BOURGOGNE-FRANCHE-COMTE,CHATEAU-CHINON,2934,1021,3955,
Musée Auguste Grasset,2016,BOURGOGNE-FRANCHE-COMTE,VARZY,1794,0,1794,
Musée de la Mine,2016,BOURGOGNE-FRANCHE-COMTE,BLANZY,9286,1902,11188,
Musée d'Art et d'Archéologie,2016,BOURGOGNE-FRANCHE-COMTE,CLUNY,43811,0,43811,
Musée du Terroir,2016,BOURGOGNE-FRANCHE-COMTE,ROMENAY,2139,1141,3280,
Donation Maurice Jardot,2016,BOURGOGNE-FRANCHE-COMTE,BELFORT,1007,6216,7223,
Musée des Arts Naïfs et Populaires de Noyers sur Serein,2016,BOURGOGNE-FRANCHE-COMTE,NOYERS-SUR-SEREIN,1882,778,2660,
Musée de l'Aventure du Son,2016,BOURGOGNE-FRANCHE-COMTE,SAINT-FARGEAU,3127,269,3396,
Musée d'Art et d'Histoire du Puisaye,2016,BOURGOGNE-FRANCHE-COMTE,VILLIERS-SAINT-BENOIT,679,380,1059,
Musée des Beaux-Arts de Brest,2016,BRETAGNE,BREST,4660,14323,18983,
Musée National de la Marine,2016,BRETAGNE,BREST,31119,39232,70351,
Musée de la Pêche,2016,BRETAGNE,CONCARNEAU,18654,16301,34955,
Le Port-Musée,2016,BRETAGNE,DOUARNENEZ,31375,21411,52786,
Musée du Faouët,2016,BRETAGNE,LE FAOUET,12585,2898,15483,
Musée du Berry,2016,CENTRE-VAL DE LOIRE,BOURGES,0,14160,14160,
Musée d'Histoire Naturelle Gabriel Foucher,2016,CENTRE-VAL DE LOIRE,BOURGES,12290,22016,34306,
Musée Emile Chénon,2016,CENTRE-VAL DE LOIRE,CHATEAUMEILLANT,1204,873,2077,
Musées de Châteauroux - Hôtel Bertrand,2016,CENTRE-VAL DE LOIRE,CHATEAUROUX,9938,11967,21905,
Musée de l'Hospice Saint-Roch,2016,CENTRE-VAL DE LOIRE,ISSOUDUN,276,22544,22820,
Musée George Sand et de la Vallée Noire,2016,CENTRE-VAL DE LOIRE,LA CHATRE,5742,6978,12720,
Musée Archéologique d'Argentomagus,2016,CENTRE-VAL DE LOIRE,SAINT-MARCEL,6547,3877,10424,
Musée - Hôtel Morin,2016,CENTRE-VAL DE LOIRE,AMBOISE,0,8098,8098,
Muséum d'Histoire Naturelle,2016,CENTRE-VAL DE LOIRE,TOURS,7999,21310,29309,
Muséum d'Histoire Naturelle,2016,CENTRE-VAL DE LOIRE,BLOIS,6467,7636,14103,
Musée Napoléonien,2016,CORSE,AJACCIO,3826,1697,5523,
Musée d'archéologie d'Aleria - Jérôme Carcopino,2016,CORSE,ALERIA,30167,1609,31776,
Musée du Feutre,2016,GRAND EST,MOUZON,3184,950,4134,
Maison de l'Outil  et de la Pensée Ouvrière,2016,GRAND EST,TROYES,12205,5169,17374,
Musée des Beaux-Arts (Musée Pic Saint-Loup),2016,GRAND EST,TROYES,5803,22674,28477,
Musée de la Chartreuse,2016,GRAND EST,MOLSHEIM,4199,2239,6438,
Musée du Fer,2016,GRAND EST,REICHSHOFFEN,878,1836,2714,
Musée Archéologique,2016,GRAND EST,STRASBOURG,19361,27291,46652,
Musée des Beaux-Arts,2016,GRAND EST,STRASBOURG,29610,30636,60246,
Musée Alsacien,2016,GRAND EST,STRASBOURG,35165,27531,62696,
Musée Municipal,2016,GRAND EST,BOURBONNE-LES-BAINS,0,2094,2094,
Maison des Lumières Denis Diderot,2016,GRAND EST,LANGRES,4175,6578,10753,
Musée d'Art et d'Histoire,2016,GRAND EST,LANGRES,3666,5643,9309,
Musée Théodore Deck et des Pays du Florival,2016,GRAND EST,GUEBWILLER,791,5094,5885,
Musée des Beaux-Arts,2016,GRAND EST,MULHOUSE,0,14664,14664,
Musée du Dolder,2016,GRAND EST,RIQUEWIHR,1821,524,2345,
Musée Saint-Rémi,2016,GRAND EST,REIMS,4692,14270,18962,
"Musée ""au Fil du Papier""",2016,GRAND EST,PONT-A-MOUSSON,2556,2267,4823,
Musée de la Céramique et de l'Ivoire,2016,GRAND EST,COMMERCY,613,2774,3387,
Musée Départemental Raymond Poincaré,2016,GRAND EST,SAMPIGNY,0,3747,3747,
Musée Départemental de la Guerre de 70,2016,GRAND EST,GRAVELOTTE,8380,6192,14572,
Musées de la Cour d'Or,2016,GRAND EST,METZ,32184,10163,42347,
Musée de la Lutherie et de l'Archèterie Française,2016,GRAND EST,MIRECOURT,5482,3622,9104,
Musée Charles Friry,2016,GRAND EST,REMIREMONT,397,2077,2474,
Musée Précolombien Edgar Clerc,2016,GUADELOUPE,LE MOULE,0,10695,10695,
Musée Jean de la Fontaine,2016,HAUTS-DE-FRANCE,CHATEAU-THIERRY,12038,3040,15078,
Musée de la Résistance et de la Déportation,2016,HAUTS-DE-FRANCE,TERGNIER,3964,1650,5614,
Musée Alexandre Dumas,2016,HAUTS-DE-FRANCE,VILLERS COTTERETS,675,758,1433,
Musée de l'Ostrevant,2016,HAUTS-DE-FRANCE,BOUCHAIN,140,687,827,
Ecomusée de la Région,2016,HAUTS-DE-FRANCE,FOURMIES,20903,10212,31115,
Musée du Dessin et de l'Estampe Originale,2016,HAUTS-DE-FRANCE,GRAVELINES,1331,10967,12298,
Musée Départemental Matisse,2016,HAUTS-DE-FRANCE,LE CATEAU-CAMBRESIS,15550,38410,53960,
Musée d'Histoire Locale de Marchiennes,2016,HAUTS-DE-FRANCE,MARCHIENNES,175,382,557,
Musée Jean Calvin,2016,HAUTS-DE-FRANCE,NOYON,1929,647,2576,
Musée Archéologique de l'Oise,2016,HAUTS-DE-FRANCE,VENDEUIL-CAPLY,2403,3015,5418,
Musée de Picardie,2016,HAUTS-DE-FRANCE,AMIENS,6048,24808,30856,
Musée Lombart,2016,HAUTS-DE-FRANCE,DOULLENS,185,3970,4155,
Musée Dunoyer de Segonzac,2016,ILE-DE-FRANCE,BOUSSY-SAINT-ANTOINE,0,20,20,
"Albert-Kahn, Musée et Jardin Départementaux",2016,ILE-DE-FRANCE,BOULOGNE-BILLANCOURT,40220,26801,67021,
Musée du Domaine Départemental de Sceaux,2016,ILE-DE-FRANCE,SCEAUX,20844,13946,34790,
MUS - Musée d'Histoire Urbaine et Sociale,2016,ILE-DE-FRANCE,SURESNES,3850,4793,8643,
Etablissement public du musée d'Orsay et de l'Orangerie - Musée d'Orsay,2016,ILE-DE-FRANCE,PARIS,1592022,1405603,2997625,
Musée du Louvre,2016,ILE-DE-FRANCE,PARIS,4557028,2481376,7038404,
Les Catacombes,2016,ILE-DE-FRANCE,PARIS,427575,84709,512284,
Galerie d'Anatomie Comparée et de Paléontologie (Muséum d'Histoire Naturelle),2016,ILE-DE-FRANCE,PARIS,113003,172357,285360,
Musée de l'Assistance Publique - Hôpitaux de Paris,2016,ILE-DE-FRANCE,PARIS,86,1418,1504,
Musée National de la Légion d'Honneur et des Ordres de Chevalerie,2016,ILE-DE-FRANCE,PARIS,0,48651,48651,
Etablissement public de la Porte Dorée - Aquarium Tropical,2016,ILE-DE-FRANCE,PARIS,130440,47190,177630,
Musée National Jean-Jacques Henner,2016,ILE-DE-FRANCE,PARIS,9140,7370,16510,
Musée de Montmartre,2016,ILE-DE-FRANCE,PARIS,107161,8999,116160,
Musée National des Techniques,2016,ILE-DE-FRANCE,PARIS,77225,128544,205769,
Musée National d'Art Moderne (Centre National d'Art et de Culture Georges Pompidou),2016,ILE-DE-FRANCE,PARIS,2461390,967298,3428688,
Musée du Service de Santé des Armées du Val-de-Grâce,2016,ILE-DE-FRANCE,PARIS,5841,21513,27354,
Musée Gatien Bonnet,2016,ILE-DE-FRANCE,LAGNY-SUR-MARNE,0,5941,5941,
Musée de l'Histoire Vivante,2016,ILE-DE-FRANCE,MONTREUIL-SOUS-BOIS,978,4954,5932,
Musée de la Résistance Nationale,2016,ILE-DE-FRANCE,CHAMPIGNY-SUR-MARNE,7017,220,7237,
Musée de la Renaissance - Château d'Ecouen,2016,ILE-DE-FRANCE,ECOUEN,17471,42517,59988,
Musée d'Art et d'Histoire Louis Senlecq,2016,ILE-DE-FRANCE,L'ISLE-ADAM,819,4222,5041,
Musée de la Toile de Jouy,2016,ILE-DE-FRANCE,JOUY-EN-JOSAS,6877,3213,10090,
Musée de l'Hôtel-Dieu,2016,ILE-DE-FRANCE,MANTES-LA-JOLIE,3099,1360,4459,
Musée Historique de Villèle,2016,LA REUNION,SAINT-GILLES-LES-HAUTS,17616,20347,37963,
Musée Baron Gérard,2016,NORMANDIE,BAYEUX,31424,5245,36669,
Musée d'Initiation à la Nature,2016,NORMANDIE,CAEN,0,6614,6614,
Musée de la Meunerie - Moulin de Marcy,2016,NORMANDIE,LE MOLAY-LITTRY,1863,2143,4006,
Musée de Trouville - Villa Montebello,2016,NORMANDIE,TROUVILLE-SUR-MER,13641,0,13641,
Musée Municipal,2016,NORMANDIE,BERNAY,2578,9098,11676,
Musée Thomas Henry,2016,NORMANDIE,CHERBOURG-EN-COTENTIN,5401,12834,18235,
Ferme-Musée du Cotentin,2016,NORMANDIE,SAINTE-MERE-EGLISE,6749,3499,10248,
Musée du Granit,2016,NORMANDIE,SAINT-MICHEL-DE-MONTJOIE,37,1763,1800,
Musée Barbey d'Aurevilly,2016,NORMANDIE,SAINT-SAUVEUR-LE-VICOMTE,629,372,1001,
Château-Musée de Dieppe,2016,NORMANDIE,DIEPPE,18197,14343,32540,
Musée Mathon-Durand,2016,NORMANDIE,NEUFCHATEL-EN-BRAY,1127,834,1961,
Ecomusée de la Basse-Seine,2016,NORMANDIE,NOTRE-DAME-DE-BLIQUETUIT,26909,4381,31290,
MUNAE - Musée National de l'Education,2016,NORMANDIE,ROUEN,3145,14050,17195,
Musée Le Secq des Tournelles,2016,NORMANDIE,ROUEN,1674,17351,19025,
Musée de la Céramique,2016,NORMANDIE,ROUEN,1108,8531,9639,
Musée de la Mytiliculture,2016,NOUVELLE-AQUITAINE,ESNANDES,4497,577,5074,
Musée Régional de Fouras,2016,NOUVELLE-AQUITAINE,FOURAS,6924,1586,8510,
Musée des Beaux-Arts,2016,NOUVELLE-AQUITAINE,LA ROCHELLE,4212,11963,16175,
Musée Municipal des Cordeliers,2016,NOUVELLE-AQUITAINE,SAINT-JEAN-D'ANGELY,962,7649,8611,
Musée de l'Ile d'Oléron,2016,NOUVELLE-AQUITAINE,ST-PIERRE D'OLERON,8892,3413,12305,
Musée Labenche d'Art et d'Histoire,2016,NOUVELLE-AQUITAINE,BRIVE-LA-GAILLARDE,1692,43247,44939,
Musée du Pays d'Ussel,2016,NOUVELLE-AQUITAINE,USSEL,477,1772,2249,
Musée Fernand Desmoulin,2016,NOUVELLE-AQUITAINE,BRANTOME,21466,3138,24604,
Musée Paul Reclus,2016,NOUVELLE-AQUITAINE,DOMME,454,18403,18857,
Musée Gallo-Romain de Vesunna,2016,NOUVELLE-AQUITAINE,PERIGUEUX,20718,13676,34394,
Muséum d'Histoire Naturelle de Bordeaux,2016,NOUVELLE-AQUITAINE,BORDEAUX,0,20936,20936,
Musée de la Voiture à Cheval. Au temps des calèches,2016,NOUVELLE-AQUITAINE,BOURG-SUR-GIRONDE,1101,1395,2496,
Musée Municipal,2016,NOUVELLE-AQUITAINE,VILLANDRAUT,182,100,282,
Musée René Baubérot,2016,NOUVELLE-AQUITAINE,CHATEAUPONSAC,1814,291,2105,
Musée Municipal des Beaux-Arts de Limoges - Palais de l'Evêché,2016,NOUVELLE-AQUITAINE,LIMOGES,8903,20438,29341,
Musée de Borda,2016,NOUVELLE-AQUITAINE,DAX,3473,7693,11166,
Musée Despiau-Wlérick,2016,NOUVELLE-AQUITAINE,MONT-DE-MARSAN,0,35443,35443,
Musée de la Chalosse,2016,NOUVELLE-AQUITAINE,MONTFORT-EN-CHALOSSE,5854,3891,9745,
Musée Municipal du Lac,2016,NOUVELLE-AQUITAINE,SANGUINET,1962,1109,3071,
"Musée de la Moto, de l'Automobile et du Vélo",2016,NOUVELLE-AQUITAINE,CHATELLERAULT,5263,5731,10994,
Musée de Préhistoire Raymond Touchard,2016,NOUVELLE-AQUITAINE,LUSSAC-LES-CHATEAUX,2600,4063,6663,
Musée Municipal de la Maison-Dieu,2016,NOUVELLE-AQUITAINE,MONTMORILLON,0,4206,4206,
Musée Départemental de l'Ariège,2016,OCCITANIE,FOIX,81231,7110,88341,
Musée Joseph Vaylet,2016,OCCITANIE,ESPALION,2452,2850,5302,
Musée des Beaux-Arts Denys Puech,2016,OCCITANIE,RODEZ,0,7963,7963,
Musée du Charroi Rural et de l'Artisanat Traditionnel,2016,OCCITANIE,SALMIECH,0,950,950,
Musée du Colombier,2016,OCCITANIE,ALES,733,10479,11212,
Musée Albert André,2016,OCCITANIE,BAGNOLS-SUR-CEZE,78,5072,5150,
Musée Municipal de la Vignasse,2016,OCCITANIE,BEAUCAIRE,418,1719,2137,
Musée des Jacobins,2016,OCCITANIE,AUCH,5305,9567,14872,
Musée Paul Dupuy,2016,OCCITANIE,TOULOUSE,6680,13268,19948,
Musée Georges Labit,2016,OCCITANIE,TOULOUSE,7334,17954,25288,
Musée Pyrénéen,2016,OCCITANIE,LOURDES,65584,8232,73816,
Musée-château Gaston Phébus,2016,OCCITANIE,MAUVEZIN,25230,0,25230,
Musée des Beaux-Arts de Béziers,2016,OCCITANIE,BEZIERS,2763,12142,14905,
Musée du Biterrois,2016,OCCITANIE,BEZIERS,1849,25172,27021,
Musée de la Cloche et de la Sonnaille,2016,OCCITANIE,HEREPIAN,2599,1678,4277,
Site Archéologique Lattara - Musée Henri Prades de Montpellier Agglomération,2016,OCCITANIE,LATTES,18604,11783,30387,
Maison des Consuls - Musée d’Arts et d’Archéologie,2016,OCCITANIE,LES MATELLES,2904,2360,5264,
Musée Archéologique,2016,OCCITANIE,MINERVE,3982,0,3982,
Musée d'Histoire de Figeac,2016,OCCITANIE,FIGEAC,368,350,718,
Musée de l'Automate,2016,OCCITANIE,SOUILLAC,12335,3126,15461,
Musée Municipal,2016,OCCITANIE,VAYRAC,106,0,106,
Musée départemental d'Art Moderne,2016,OCCITANIE,CERET,50591,21301,71892,
Musée d'Art Moderne - Fonds Peskè,2016,OCCITANIE,COLLIOURE,6184,2212,8396,
Musée du Castillet Casa Pairal,2016,OCCITANIE,PERPIGNAN,14619,14049,28668,
Musée des Beaux-Arts,2016,OCCITANIE,GAILLAC,2100,2776,4876,
Musée de Préhistoire,2016,OCCITANIE,SAINT-ANTONIN-NOBLE-VAL,30,200,230,
"Musée de la Fève, Crèches et Traditions Populaires",2016,PAYS DE LA LOIRE,BLAIN,829,221,1050,
Ecomusée de Saint-Nazaire,2016,PAYS DE LA LOIRE,SAINT-NAZAIRE,29086,9587,38673,
Musée Jean Lurcat et de la Tapisserie Contemporaine,2016,PAYS DE LA LOIRE,ANGERS,15361,40994,56355,
Muséum des Sciences Naturelles,2016,PAYS DE LA LOIRE,ANGERS,3607,17432,21039,
Musée d'Art et d'Histoire,2016,PAYS DE LA LOIRE,CHOLET,1796,14977,16773,
Musée d'Art et d'Archéologie Hôtel Fouquet,2016,PAYS DE LA LOIRE,CHATEAU-GONTIER,144,1521,1665,
Musée des Traditions de l'Île,2016,PAYS DE LA LOIRE,LA GUERINIERE,4335,897,5232,
Musée Gassendi,2016,PROVENCE-ALPES-CÔTE D'AZUR,DIGNE-LES-BAINS,2206,16493,18699,
Musée de Salagon,2016,PROVENCE-ALPES-CÔTE D'AZUR,MANE,25666,5634,31300,
Musée-Château de Cagnes,2016,PROVENCE-ALPES-CÔTE D'AZUR,CAGNES-SUR-MER,14179,9451,23630,
Muséum d'Histoire Naturelle,2016,PROVENCE-ALPES-CÔTE D'AZUR,NICE,1426,2895,4321,
Musée d'Art Moderne et d'Art Contemporain,2016,PROVENCE-ALPES-CÔTE D'AZUR,NICE,64612,91129,155741,
Musée du Pavillon de Vendôme,2016,PROVENCE-ALPES-CÔTE D'AZUR,AIX-EN-PROVENCE,4435,15085,19520,
Musée des Tapisseries,2016,PROVENCE-ALPES-CÔTE D'AZUR,AIX-EN-PROVENCE,3499,13869,17368,
Musée Camarguais,2016,PROVENCE-ALPES-CÔTE D'AZUR,ARLES,8462,4400,12862,
Musée Réattu,2016,PROVENCE-ALPES-CÔTE D'AZUR,ARLES,10673,50232,60905,
Musée Ciotaden,2016,PROVENCE-ALPES-CÔTE D'AZUR,LA CIOTAT,2775,3234,6009,
Musée Borély,2016,PROVENCE-ALPES-CÔTE D'AZUR,MARSEILLE,20164,8598,28762,
Musée des Beaux-Arts de Marseille,2016,PROVENCE-ALPES-CÔTE D'AZUR,MARSEILLE,12330,17075,29405,
Muséum d'Histoire Naturelle,2016,PROVENCE-ALPES-CÔTE D'AZUR,MARSEILLE,14276,55173,69449,
Musée Municipal Paul Lafran,2016,PROVENCE-ALPES-CÔTE D'AZUR,SAINT-CHAMAS,0,4008,4008,
Musée de l'Empéri de Salon et de la Crau,2016,PROVENCE-ALPES-CÔTE D'AZUR,SALON-DE-PROVENCE,4017,19611,23628,
Musée des Arts et d’Histoire,2016,PROVENCE-ALPES-CÔTE D'AZUR,BORMES-LES-MIMOSAS,0,27294,27294,
Musée Municipal,2016,PROVENCE-ALPES-CÔTE D'AZUR,DRAGUIGNAN,0,6927,6927,
Musée des A.T.P. de Moyenne Provence,2016,PROVENCE-ALPES-CÔTE D'AZUR,DRAGUIGNAN,1937,8878,10815,
Musée Archéologique Théo Desplans,2016,PROVENCE-ALPES-CÔTE D'AZUR,VAISON-LA-ROMAINE,62574,13580,76154,
Musée Départemental du Cartonnage et de l'Imprimerie,2016,PROVENCE-ALPES-CÔTE D'AZUR,VALREAS,3656,940,4596,
Musée Archéologique,2017,AUVERGNE-RHONE-ALPES,IZERNORE,1047,1679,2726,
Musée Anne de Beaujeu,2017,AUVERGNE-RHONE-ALPES,MOULINS,14721,14400,29121,
Musée des Arts D'Afrique et D'Asie,2017,AUVERGNE-RHONE-ALPES,VICHY,1200,3600,4800,
MuséAL - Musée Archéologique d'Alba,2017,AUVERGNE-RHONE-ALPES,ALBA-LA-ROMAINE,9841,3299,13140,
Musée Vivarois César Filhol,2017,AUVERGNE-RHONE-ALPES,ANNONAY,0,225,225,
Cité de Préhistoire,2017,AUVERGNE-RHONE-ALPES,ORGNAC-L'AVEN,161500,0,161500,
Musée de la Batellerie du Rhône,2017,AUVERGNE-RHONE-ALPES,SERRIERES,817,153,970,
Musée d'art et d'histoire Alfred Douët,2017,AUVERGNE-RHONE-ALPES,SAINT-FLOUR,1280,1751,3031,
Musée des Beaux-Arts,2017,AUVERGNE-RHONE-ALPES,VALENCE,14982,31598,46580,
Musée des Arts et Traditions Populaires de Haute Loire,2017,AUVERGNE-RHONE-ALPES,LAVAUDIEU,9575,236,9811,
Musée Jadis Allevard,2017,AUVERGNE-RHONE-ALPES,ALLEVARD-LES-BAINS,4353,69,4422,
Musée Gallo-Romain,2017,AUVERGNE-RHONE-ALPES,AOSTE,4496,1475,5971,
Musée de la Résistance de la Déportation de l'Isère,2017,AUVERGNE-RHONE-ALPES,GRENOBLE,0,27661,27661,
Musée Matheysin,2017,AUVERGNE-RHONE-ALPES,LA MURE,834,1275,2109,
Musée d'Art et d'Industrie,2017,AUVERGNE-RHONE-ALPES,SAINT-ETIENNE,19927,20586,40513,
Château de la Bastie d'Urfé,2017,AUVERGNE-RHONE-ALPES,SAINT-ETIENNE-LE-MOLARD,7721,18079,25800,
Muséum d'Histoire Naturelle Henri-Lecoq,2017,AUVERGNE-RHONE-ALPES,CLERMONT-FERRAND,7645,37141,44786,
Musée Municipal Marcel Sahut,2017,AUVERGNE-RHONE-ALPES,VOLVIC,406,756,1162,
Musée des Beaux-Arts,2017,AUVERGNE-RHONE-ALPES,LYON,194583,161786,356369,
Musée Henri Malartre,2017,AUVERGNE-RHONE-ALPES,ROCHETAILLEE-SUR-SAONE,15179,15607,30786,
Muséum d'histoire naturelle,2017,AUVERGNE-RHONE-ALPES,CHAMBERY,0,4034,4034,
Musée François Rude,2017,BOURGOGNE-FRANCHE-COMTE,DIJON,0,85291,85291,
Musée d'Art Sacré,2017,BOURGOGNE-FRANCHE-COMTE,DIJON,0,8549,8549,
Muséum de Besançon,2017,BOURGOGNE-FRANCHE-COMTE,BESANCON,104632,95187,199819,
Musée Comtois,2017,BOURGOGNE-FRANCHE-COMTE,BESANCON,13467,19352,32819,
Musée des Beaux-Arts et d'Archéologie,2017,BOURGOGNE-FRANCHE-COMTE,BESANCON,0,8930,8930,
Musée de la Tour des Echevins,2017,BOURGOGNE-FRANCHE-COMTE,LUXEUIL-LES-BAINS,2743,891,3634,
Musée Georges Garret,2017,BOURGOGNE-FRANCHE-COMTE,VESOUL,0,4878,4878,
Musée des Beaux-Arts,2017,BOURGOGNE-FRANCHE-COMTE,DOLE,0,22149,22149,
Musée de l'Artisanat Jurassien,2017,BOURGOGNE-FRANCHE-COMTE,VOITEUR,0,16000,16000,
Musée Archéologique du Nivernais (Porte du Croux),2017,BOURGOGNE-FRANCHE-COMTE,NEVERS,198,580,778,
Musée du Grès de Puisaye,2017,BOURGOGNE-FRANCHE-COMTE,SAINT-AMAND-EN-PUISAYE,2085,0,2085,
Musée Rolin,2017,BOURGOGNE-FRANCHE-COMTE,AUTUN,11172,7032,18204,
Musée du Prieuré de Charolles,2017,BOURGOGNE-FRANCHE-COMTE,CHAROLLES,1064,1437,2501,
Musée des Ursulines,2017,BOURGOGNE-FRANCHE-COMTE,MACON,2620,20925,23545,
Musée de la Tour du Moulin,2017,BOURGOGNE-FRANCHE-COMTE,MARCIGNY,1290,612,1902,
Musée Départemental de Préhistoire de Solutré,2017,BOURGOGNE-FRANCHE-COMTE,SOLUTRE-POUILLY,12135,8294,20429,
Forge-Musée,2017,BOURGOGNE-FRANCHE-COMTE,ETUEFFONT,573,440,1013,
Musée d'Art et d'Histoire du Puisaye,2017,BOURGOGNE-FRANCHE-COMTE,VILLIERS-SAINT-BENOIT,650,609,1259,
Musée d'Art et d'Histoire,2017,BRETAGNE,SAINT-BRIEUC,0,28501,28501,
Musée de Morlaix,2017,BRETAGNE,MORLAIX,13461,4588,18049,
Musée de Pont-Aven,2017,BRETAGNE,PONT-AVEN,89287,29330,118617,
Musée Bigouden,2017,BRETAGNE,PONT-L'ABBE,10648,4050,14698,
Musée d'Histoire de la Ville de Saint-Malo,2017,BRETAGNE,SAINT-MALO,17366,13888,31254,
Ecomusée de l'Île de Groix,2017,BRETAGNE,ILE DE GROIX,6186,2624,8810,
Musée du Berry,2017,CENTRE-VAL DE LOIRE,BOURGES,6007,2597,8604,
Musée d'Histoire Naturelle Gabriel Foucher,2017,CENTRE-VAL DE LOIRE,BOURGES,17068,13904,30972,
Musée Emile Chénon,2017,CENTRE-VAL DE LOIRE,CHATEAUMEILLANT,821,845,1666,
Musée Municipal,2017,CENTRE-VAL DE LOIRE,VIERZON,1315,5262,6577,
Muséum des Sciences Naturelles et de Préhistoire,2017,CENTRE-VAL DE LOIRE,CHARTRES,0,10000,10000,
Musée d'Art et d'Histoire Marcel Dessal,2017,CENTRE-VAL DE LOIRE,DREUX,765,10520,11285,
Musée du Château Saint-Jean,2017,CENTRE-VAL DE LOIRE,NOGENT-LE-ROTROU,5803,7577,13380,
Château Musée,2017,CENTRE-VAL DE LOIRE,AZAY-LE-FERRON,16035,4482,20517,
Musée de l'Hospice Saint-Roch,2017,CENTRE-VAL DE LOIRE,ISSOUDUN,0,27033,27033,
Musée Ornithologique (Ecomusée de la Brenne),2017,CENTRE-VAL DE LOIRE,LE BLANC,1353,941,2294,
"Le Carroi, Musée d’Arts et d’Histoire",2017,CENTRE-VAL DE LOIRE,CHINON,2262,887,3149,
"""Maison Musée"" René Descartes",2017,CENTRE-VAL DE LOIRE,DESCARTES,1267,665,1932,
Musée Lansyer,2017,CENTRE-VAL DE LOIRE,LOCHES,5415,2204,7619,
Ecomusée du Véron,2017,CENTRE-VAL DE LOIRE,SAVIGNY-EN-VERON,4996,2563,7559,
Musée du Compagnonnage,2017,CENTRE-VAL DE LOIRE,TOURS,22511,17525,40036,
Musée du Feutre,2017,GRAND EST,MOUZON,2659,1360,4019,
Pharmacie Musée de l'Hôtel-Dieu,2017,GRAND EST,TROYES,4437,7961,12398,
Musée Lalique,2017,GRAND EST,WINGEN-SUR-MODER,35706,11568,47274,
Musée Westercamp,2017,GRAND EST,WISSEMBOURG,0,398,398,
Musée de la Bataille du 6 Août 1870,2017,GRAND EST,WOERTH,2243,1569,3812,
Musée Municipal,2017,GRAND EST,BOURBONNE-LES-BAINS,0,1702,1702,
Musée Théodore Deck et des Pays du Florival,2017,GRAND EST,GUEBWILLER,1906,4590,6496,
Musée Historique et Militaire de Huningue,2017,GRAND EST,HUNINGE,220,104,324,
Musée EDF Electropolis,2017,GRAND EST,MULHOUSE,11746,28224,39970,
Musée du Papier Peint,2017,GRAND EST,RIXHEIM,6287,5156,11443,
Musée Municipal,2017,GRAND EST,CHALONS-EN-CHAMPAGNE,1361,9810,11171,
Musée Hôtel le Vergeur,2017,GRAND EST,REIMS,9597,0,9597,
Musée de l'Ecole de Nancy,2017,GRAND EST,NANCY,27916,14668,42584,
Palais des ducs de Lorraine - Musée Historique Lorrain,2017,GRAND EST,NANCY,12508,35454,47962,
Musée d'Art et d'Histoire de Toul,2017,GRAND EST,TOUL,0,10385,10385,
Musée Départemental Raymond Poincaré,2017,GRAND EST,SAMPIGNY,0,4693,4693,
Musée de la Princerie,2017,GRAND EST,VERDUN,1866,3761,5627,
Musées de la Cour d'Or,2017,GRAND EST,METZ,22607,23256,45863,
Centre Pompidou de Metz (collections nationales decentralisées),2017,GRAND EST,METZ,169007,176542,345549,
Musée Militaire et Erckmann-Chatrian,2017,GRAND EST,PHALSBOURG,513,464,977,
Musée Départemental Georges de la Tour,2017,GRAND EST,VIC-SUR-SEILLE,3637,2284,5921,
Musée Départemental d'Art Ancien et Contemporain,2017,GRAND EST,EPINAL,2776,12477,15253,
Musée Charles Friry,2017,GRAND EST,REMIREMONT,390,1616,2006,
Musée Charles de Bruyères,2017,GRAND EST,REMIREMONT,469,1660,2129,
Musée Pierre Noël - Musée de la Vie dans les Hautes-Vosges,2017,GRAND EST,SAINT-DIE-DES-VOSGES,3155,11001,14156,
Musée Franco-Américain du Château de Blérancourt,2017,HAUTS-DE-FRANCE,BLERANCOURT,4237,5041,9278,
Musée Jean de la Fontaine,2017,HAUTS-DE-FRANCE,CHATEAU-THIERRY,10557,3292,13849,
Familistère de Guise,2017,HAUTS-DE-FRANCE,GUISE,60128,12239,72367,
Musée d'Art et d'Archéologie,2017,HAUTS-DE-FRANCE,LAON,1651,2676,4327,
Musée de La Thiérache,2017,HAUTS-DE-FRANCE,VERVINS,0,6054,6054,
Lieu d'Art et Action Contemporaine de Dunkerque - LAAC,2017,HAUTS-DE-FRANCE,DUNKERQUE,5984,19121,25105,
"LAM - Lille Métropole Musée d'Art Moderne, d'Art Contemporain et d'Art Brut",2017,HAUTS-DE-FRANCE,VILLENEUVE-D'ASCQ,94094,41696,135790,
MUDO - Musée de l'Oise,2017,HAUTS-DE-FRANCE,BEAUVAIS,0,54858,54858,
Musée Pillon,2017,HAUTS-DE-FRANCE,CHAUMONT-EN-VEXIN,0,750,750,
Musée Gallé-Juillet,2017,HAUTS-DE-FRANCE,CREIL,2820,4845,7665,
Musée Jean Calvin,2017,HAUTS-DE-FRANCE,NOYON,2778,782,3560,
Musée du Noyonnais,2017,HAUTS-DE-FRANCE,NOYON,927,1576,2503,
Musée d'Art et d'Archéologie,2017,HAUTS-DE-FRANCE,SENLIS,3830,9006,12836,
Musée des Beaux-Arts,2017,HAUTS-DE-FRANCE,ARRAS,26000,49370,75370,
Musée de la Céramique,2017,HAUTS-DE-FRANCE,DESVRES,7478,1397,8875,
Musée d'Art et d'Histoire Roger Rodière,2017,HAUTS-DE-FRANCE,MONTREUIL-SUR-MER,16816,6761,23577,
Musée Alfred Danicourt,2017,HAUTS-DE-FRANCE,PERONNE,0,2352,2352,
MUS - Musée d'Histoire Urbaine et Sociale,2017,ILE-DE-FRANCE,SURESNES,5411,3835,9246,
Grande Galerie de l'Evolution (Muséum National d'Histoire Naturelle),2017,ILE-DE-FRANCE,PARIS,338684,352704,691388,
Musée National de la Marine,2017,ILE-DE-FRANCE,PARIS,10075,18735,28810,
Etablissement public du musée national J.J. Henner et du musée national G. Moreau / Musée National Gustave Moreau,2017,ILE-DE-FRANCE,PARIS,19399,19839,39238,
Musée de l'Assistance Publique - Hôpitaux de Paris,2017,ILE-DE-FRANCE,PARIS,302,0,302,
Maison de Balzac,2017,ILE-DE-FRANCE,PARIS,26751,0,26751,
Musée Nissim de Camondo (Les Arts Décoratifs),2017,ILE-DE-FRANCE,PARIS,51214,14261,65475,
Musée Zadkine,2017,ILE-DE-FRANCE,PARIS,30801,0,30801,
Musée d'Ennery,2017,ILE-DE-FRANCE,PARIS,0,758,758,
Musée National Auguste Rodin,2017,ILE-DE-FRANCE,PARIS,396578,179858,576436,
Etablissement public de la Porte Dorée - Aquarium Tropical,2017,ILE-DE-FRANCE,PARIS,128538,44110,172648,
Musée National des Techniques,2017,ILE-DE-FRANCE,PARIS,98987,134688,233675,
Musée National d'Art Moderne (Centre National d'Art et de Culture Georges Pompidou),2017,ILE-DE-FRANCE,PARIS,2484190,1014669,3498859,
Institut du Monde Arabe,2017,ILE-DE-FRANCE,PARIS,397952,13763,411715,
"Musée des Transports Urbains, Interurbains et Ruraux",2017,ILE-DE-FRANCE,CHELLES,2176,2200,4376,
Musée Municipal des Capucins,2017,ILE-DE-FRANCE,COULOMMIERS,909,1430,2339,
Musée Bossuet,2017,ILE-DE-FRANCE,MEAUX,3669,6924,10593,
Musée départemental Stéphane Mallarmé,2017,ILE-DE-FRANCE,VULAINES-SUR-SEINE,1511,2564,4075,
Musée de l'Air et de l'Espace,2017,ILE-DE-FRANCE,LE BOURGET,115058,164875,279933,
ARCHEA - Archéologie en Pays de France,2017,ILE-DE-FRANCE,LOUVRES,6590,4112,10702,
Musée jean-Jacques Rousseau,2017,ILE-DE-FRANCE,MONTMORENCY,913,838,1751,
Musée Tavet Delacour,2017,ILE-DE-FRANCE,PONTOISE,2876,2482,5358,
Musée National de Port Royal des Champs,2017,ILE-DE-FRANCE,MAGNY-LES-HAMEAUX,6170,18975,25145,
Musée du Jouet Pierre Pinel,2017,ILE-DE-FRANCE,POISSY,358,3867,4225,
Musée Lambinet,2017,ILE-DE-FRANCE,VERSAILLES,9196,8475,17671,
Muséum d'Histoire Naturelle,2017,LA REUNION,SAINT-DENIS,4919,21133,26052,
Musée Départemental d'Archéologie Précolombienne et de Préhistoire de la Martinique,2017,MARTINIQUE,FORT-DE-FRANCE,3132,6115,9247,
Tapisserie de Bayeux - MAHB Musée d'Art et d'Histoire Baron Gérard,2017,NORMANDIE,BAYEUX,18514,12138,30652,
Musée de Normandie,2017,NORMANDIE,CAEN,20155,37414,57569,
Musée de la Mine,2017,NORMANDIE,LE MOLAY-LITTRY,1920,457,2377,
Musée de la Meunerie - Moulin de Marcy,2017,NORMANDIE,LE MOLAY-LITTRY,2122,2000,4122,
Musée Municipal,2017,NORMANDIE,ORBEC,0,1007,1007,
Musée de la Bataille de Tilly-Sur-Seulles 1944,2017,NORMANDIE,TILLY-SUR-SEULLES,747,489,1236,
Musée de l'Ancien Evêché,2017,NORMANDIE,EVREUX,0,27633,27633,
Musée du Poiré,2017,NORMANDIE,BARENTON,1116,4184,5300,
Musée Maritime de l'Ile de Tatihou,2017,NORMANDIE,SAINT-VAAST-LA-HOUGUE,66109,3192,69301,
Musée Régional du Cidre et du Calvados,2017,NORMANDIE,VALOGNES,1414,624,2038,
Musée de la Poeslerie,2017,NORMANDIE,VILLEDIEU-LES-POELES-ROUFFIGNY,4292,1527,5819,
Musée Municipal d'Archéologie,2017,NORMANDIE,L'AIGLE,483,948,1431,
Musée Départemental des Arts et Traditions Populaires du Perche,2017,NORMANDIE,SAINT-CYR LA ROSIERE,12071,11814,23885,
Musée Municipal,2017,NORMANDIE,BARENTIN,0,200,200,
Maison des Templiers,2017,NORMANDIE,CAUDEBEC-EN-CAUX,0,300,300,
Musée d'Art Moderne André Malraux - MuMa,2017,NORMANDIE,LE HAVRE,76993,62036,139029,
Musée Le Secq des Tournelles,2017,NORMANDIE,ROUEN,14055,15010,29065,
MUNAE - Musée National de l'Education,2017,NORMANDIE,ROUEN,9604,10666,20270,
Atelier - Musée du Papier,2017,NOUVELLE-AQUITAINE,ANGOULEME,11746,20540,32286,
Musée Municipal de Cognac,2017,NOUVELLE-AQUITAINE,COGNAC,2787,2663,5450,
Musée du Nouveau Monde,2017,NOUVELLE-AQUITAINE,LA ROCHELLE,5696,12396,18092,
Musée des Beaux-Arts,2017,NOUVELLE-AQUITAINE,LA ROCHELLE,5534,10753,16287,
Muséum d'Histoire Naturelle,2017,NOUVELLE-AQUITAINE,LA ROCHELLE,13179,41732,54911,
Musée de l'Echevinage,2017,NOUVELLE-AQUITAINE,SAINTES,1507,3120,4627,
Musée Dupuy-Mestreau,2017,NOUVELLE-AQUITAINE,SAINTES,748,823,1571,
Musée de l'Ile d'Oléron,2017,NOUVELLE-AQUITAINE,ST-PIERRE D'OLERON,9830,3279,13109,
Musée Labenche d'Art et d'Histoire,2017,NOUVELLE-AQUITAINE,BRIVE-LA-GAILLARDE,1655,32820,34475,
Musée du Cloître de Tulle André Mazeyrie,2017,NOUVELLE-AQUITAINE,TULLE,0,7532,7532,
Musée de la Mémoire et des Industries Tullistes,2017,NOUVELLE-AQUITAINE,TULLE,0,3707,3707,
Musée d'Art et d'Histoire Georges Turpin,2017,NOUVELLE-AQUITAINE,PARTHENAY,0,6770,6770,
Musée Fernand Desmoulin,2017,NOUVELLE-AQUITAINE,BRANTOME,26000,3000,29000,
Musée Paul Reclus,2017,NOUVELLE-AQUITAINE,DOMME,436,20485,20921,
Muséum d'Histoire Naturelle de Bordeaux,2017,NOUVELLE-AQUITAINE,BORDEAUX,0,14469,14469,
Musée des Arts Décoratifs et du Design,2017,NOUVELLE-AQUITAINE,BORDEAUX,22651,49401,72052,
Musée Gallo-Romain de Claracq,2017,NOUVELLE-AQUITAINE,CLARACQ,2254,629,2883,
Musée Municipal de Civray,2017,NOUVELLE-AQUITAINE,CIVRAY,0,98,98,
Musée du baptistère Saint-Jean,2017,NOUVELLE-AQUITAINE,POITIERS,10626,1331,11957,
Musée de la Préhistoire,2017,OCCITANIE,LE MAS D'AZIL,10741,565,11306,
Musée de la Forge,2017,OCCITANIE,MONTGAILHARD,31123,0,31123,
"Musée des Mœurs et Coutumes, Musée du Rouergue",2017,OCCITANIE,ESPALION,547,548,1095,
Musée Municipal de Millau,2017,OCCITANIE,MILLAU,4774,6339,11113,
Musée des Arts et Métiers Traditionnels,2017,OCCITANIE,SALLES-LA-SOURCE,4344,2287,6631,
Musée Municipal Georges Borias,2017,OCCITANIE,UZES,1408,1373,2781,
Musée Archéologique,2017,OCCITANIE,EAUZE,5904,1879,7783,
Musée Campanaire,2017,OCCITANIE,L'ISLE JOURDAIN,9762,0,9762,
Musée Joseph Abeilhé,2017,OCCITANIE,MARCIAC,273,112,385,
Musée du Biterrois,2017,OCCITANIE,BEZIERS,731,3740,4471,
Musée de Lodève - Hôtel du cardinal de Fleury,2017,OCCITANIE,LODEVE,11956,5605,17561,
Musée Paul Valéry,2017,OCCITANIE,SETE,40483,9183,49666,
Musée Goya,2017,OCCITANIE,CASTRES,20216,5897,26113,
Musée des Beaux-Arts,2017,OCCITANIE,GAILLAC,1208,3556,4764,
Musée de l'Abbaye Saint-Michel,2017,OCCITANIE,GAILLAC,1534,737,2271,
Musée Raymond Lafage,2017,OCCITANIE,LISLE-SUR-TARN,1460,5590,7050,
Ecomusée de Saint-Nazaire,2017,PAYS DE LA LOIRE,SAINT-NAZAIRE,36929,11876,48805,
Musée d'Art et d'Histoire,2017,PAYS DE LA LOIRE,BAUGE,0,4653,4653,
Musée Jules-Desbois,2017,PAYS DE LA LOIRE,PARCAY-LES-PINS,2831,1491,4322,
Musée de la Vigne et du Vin d'Anjou,2017,PAYS DE LA LOIRE,SAINT LAMBERT-DU-LATTAY - VAL-DU-LAYON,3627,795,4422,
Musée des Sciences - CCSTI,2017,PAYS DE LA LOIRE,LAVAL,14076,0,14076,
Musée de la Reine Bérengère,2017,PAYS DE LA LOIRE,LE MANS,2334,8777,11111,
Musée de l'Abbaye de Sainte-Croix,2017,PAYS DE LA LOIRE,LES SABLES D'OLONNE,7377,16330,23707,
Musée Clemenceau et de Lattre-de-Tassigny,2017,PAYS DE LA LOIRE,MOUILLERON-EN-PAREDS,1420,3455,4875,
Musée départemental de préhistoire,2017,PROVENCE-ALPES-CÔTE D'AZUR,QUINSON,63151,10851,74002,
Musée de la Castre,2017,PROVENCE-ALPES-CÔTE D'AZUR,CANNES,14172,15632,29804,
Musée Archéologique - Site de  Cimiez,2017,PROVENCE-ALPES-CÔTE D'AZUR,NICE,18840,11102,29942,
Musée du Palais Lascaris,2017,PROVENCE-ALPES-CÔTE D'AZUR,NICE,24565,15729,40294,
Musée d'Art et d'Histoire,2017,PROVENCE-ALPES-CÔTE D'AZUR,NICE,19759,33776,53535,
Musée du Parlement de Provence et du Vieil Aix,2017,PROVENCE-ALPES-CÔTE D'AZUR,AIX-EN-PROVENCE,7615,9065,16680,
Musée des Tapisseries,2017,PROVENCE-ALPES-CÔTE D'AZUR,AIX-EN-PROVENCE,2687,15449,18136,
Musée Réattu,2017,PROVENCE-ALPES-CÔTE D'AZUR,ARLES,8251,28865,37116,
Musée Municipal Méditerranéen de Cassis A.T.P.,2017,PROVENCE-ALPES-CÔTE D'AZUR,CASSIS,0,6693,6693,
Musée d'Histoire et d'Archéologie des Baux-de-Provence,2017,PROVENCE-ALPES-CÔTE D'AZUR,LES BAUX DE PROVENCE,270000,0,270000,
Musée des Docks Romains,2017,PROVENCE-ALPES-CÔTE D'AZUR,MARSEILLE,0,13771,13771,
Musée d'Histoire de Marseille,2017,PROVENCE-ALPES-CÔTE D'AZUR,MARSEILLE,26084,47782,73866,
Musée Grobet-Labadié,2017,PROVENCE-ALPES-CÔTE D'AZUR,MARSEILLE,0,1485,1485,
Musée Estrine - Présence Van Gogh,2017,PROVENCE-ALPES-CÔTE D'AZUR,SAINT-REMY-DE-PROVENCE,7695,4363,12058,
Musée de Salon et de la Crau,2017,PROVENCE-ALPES-CÔTE D'AZUR,SALON-DE-PROVENCE,0,5653,5653,
Musée des Arts et d’Histoire,2017,PROVENCE-ALPES-CÔTE D'AZUR,BORMES-LES-MIMOSAS,0,5041,5041,
Musée de l'Annonciade,2017,PROVENCE-ALPES-CÔTE D'AZUR,SAINT-TROPEZ,24617,4994,29611,
Musée d'Art et d'Archéologie,2017,PROVENCE-ALPES-CÔTE D'AZUR,TOULON,0,49657,49657,
Musée Lapidaire (Collection archéologique de la Fondation Calvet),2017,PROVENCE-ALPES-CÔTE D'AZUR,AVIGNON,6632,15664,22296,
Musée de l'Arche,2017,ST PIERRE ET MIQUELON,SAINT-PIERRE ET MIQUELON,3235,1476,4711,
Musée de la Résistance et de la Déportation de l'Ain,2018,AUVERGNE-RHONE-ALPES,NANTUA,7851,5096,12947,
Musée Départemental du Revermont,2018,AUVERGNE-RHONE-ALPES,VAL-REVERMONT,2961,8545,11506,
Musée des Musiques Populaires - MuPop,2018,AUVERGNE-RHONE-ALPES,MONTLUCON,17011,5663,22674,
Musée du Rhône,2018,AUVERGNE-RHONE-ALPES,TOURNON-SUR-RHÔNE,17378,11134,28512,
Château de Grignan,2018,AUVERGNE-RHONE-ALPES,GRIGNAN,119785,23653,143438,
Musée d'Art Sacré,2018,AUVERGNE-RHONE-ALPES,MOURS SAINT-EUSEBE,100,250,350,
Musée de Paléontologie,2018,AUVERGNE-RHONE-ALPES,CHILHAC,1630,60,1690,
Musée du Chablais,2018,AUVERGNE-RHONE-ALPES,THONON-LES-BAINS,1179,1656,2835,
Musée d'Huez et de l'Oisans,2018,AUVERGNE-RHONE-ALPES,ALPE D'HUEZ,0,6949,6949,
Musée de la Résistance de la Déportation de l'Isère,2018,AUVERGNE-RHONE-ALPES,GRENOBLE,0,36163,36163,
Musée Matheysin,2018,AUVERGNE-RHONE-ALPES,LA MURE,919,1230,2149,
Musée Hector Berlioz,2018,AUVERGNE-RHONE-ALPES,LA-COTE-SAINT-ANDRE,0,15158,15158,
Musée Lapidaire Saint-Pierre,2018,AUVERGNE-RHONE-ALPES,VIENNE,3650,9429,13079,
Musée de la Soierie,2018,AUVERGNE-RHONE-ALPES,CHARLIEU,4949,2286,7235,
Musée des Beaux-Arts et d'Archéologie J. Dechelette,2018,AUVERGNE-RHONE-ALPES,ROANNE,6462,6291,12753,
Musée de la Dentelle,2018,AUVERGNE-RHONE-ALPES,ARLANC,967,119,1086,
Musée d'Archéologie Bargoin,2018,AUVERGNE-RHONE-ALPES,CLERMONT-FERRAND,3096,19947,23043,
Musée d'Art Roger-Quillot,2018,AUVERGNE-RHONE-ALPES,CLERMONT-FERRAND,9993,18934,28927,
Musée des Peintres de l'Ecole de Murols,2018,AUVERGNE-RHONE-ALPES,MUROL,3635,130,3765,
Musée Folklorique et Traditions Populaires Marius Audin,2018,AUVERGNE-RHONE-ALPES,BEAUJEU,454,494,948,
Musées Gadagne,2018,AUVERGNE-RHONE-ALPES,LYON,31545,47317,78862,
Lugdunum - Musée et Théâtres Romains,2018,AUVERGNE-RHONE-ALPES,LYON,41500,83522,125022,
Musée de l'Imprimerie et de la Communication Graphique,2018,AUVERGNE-RHONE-ALPES,LYON,23530,20865,44395,
Musée des Sapeurs-Pompiers de Lyon,2018,AUVERGNE-RHONE-ALPES,LYON,5439,5241,10680,
Musée d'Art Contemporain de Lyon,2018,AUVERGNE-RHONE-ALPES,LYON,37451,34861,72312,
Musée Archéologique,2018,AUVERGNE-RHONE-ALPES,SAINT-ROMAIN-EN-GAL,22722,53684,76406,
Musée Archéologique,2018,AUVERGNE-RHONE-ALPES,AIX-LES-BAINS,200,300,500,
Musée des Charmettes,2018,AUVERGNE-RHONE-ALPES,CHAMBERY,0,13806,13806,
Musée d'Art Sacré,2018,BOURGOGNE-FRANCHE-COMTE,DIJON,0,12018,12018,
Muséum - Jardin des Sciences,2018,BOURGOGNE-FRANCHE-COMTE,DIJON,14169,105374,119543,
Musée des Beaux-Arts,2018,BOURGOGNE-FRANCHE-COMTE,DIJON,0,152739,152739,
Musée Buffon,2018,BOURGOGNE-FRANCHE-COMTE,MONTBARD,461,8942,9403,
Musée Comtois,2018,BOURGOGNE-FRANCHE-COMTE,BESANCON,34270,0,34270,
Musée de la résistance et de la Déportation,2018,BOURGOGNE-FRANCHE-COMTE,BESANCON,48967,0,48967,
Musée des Beaux-Arts et d'Archéologie,2018,BOURGOGNE-FRANCHE-COMTE,BESANCON,0,31215,31215,
Musée de Plein Air des Maisons Comtoises,2018,BOURGOGNE-FRANCHE-COMTE,NANCRAY,30796,13127,43923,
Musée de Pontarlier,2018,BOURGOGNE-FRANCHE-COMTE,PONTARLIER,731,7244,7975,
Musée Baron Martin,2018,BOURGOGNE-FRANCHE-COMTE,GRAY,1514,2094,3608,
Musée Sarret de Grozon,2018,BOURGOGNE-FRANCHE-COMTE,ARBOIS,1297,1714,3011,
Viséum-Musée de la Lunette,2018,BOURGOGNE-FRANCHE-COMTE,MOREZ HAUTS DE BIENNE,8531,4046,12577,
Musée de l'Abbaye/Donations Guy Bardone - René Genis,2018,BOURGOGNE-FRANCHE-COMTE,SAINT-CLAUDE,5762,2589,8351,
Ecomusée de la Communauté Le Creusot-Monceau-Les-Mines,2018,BOURGOGNE-FRANCHE-COMTE,LE CREUSOT,12135,10004,22139,
"L'Atelier d'un Journal"" de Louhans - Musée Municipal",2018,BOURGOGNE-FRANCHE-COMTE,LOUHANS,2016,3583,5599,
Musée du Terroir,2018,BOURGOGNE-FRANCHE-COMTE,ROMENAY,2083,873,2956,
Musée Leblanc-Duvernois,2018,BOURGOGNE-FRANCHE-COMTE,AUXERRE,0,1508,1508,
Musée de l'Avallonnais Jean Després,2018,BOURGOGNE-FRANCHE-COMTE,AVALLON,3046,1028,4074,
Musée des Arts Naïfs et Populaires de Noyers sur Serein,2018,BOURGOGNE-FRANCHE-COMTE,NOYERS-SUR-SEREIN,1624,541,2165,
Ecomusée des Monts d'Arrée - Moulins de Kerouat,2018,BRETAGNE,COMMANA,12864,2339,15203,
Musée de l'Ancienne Abbaye de Landévennec,2018,BRETAGNE,LANDEVENNEC,24412,3955,28367,
Musée de Pont-Aven,2018,BRETAGNE,PONT-AVEN,69795,24282,94077,
Musée Départemental Breton,2018,BRETAGNE,QUIMPER,22271,23159,45430,
Musée du Château de Vitré,2018,BRETAGNE,VITRE,17597,4321,21918,
Ecomusée de Saint-Dégan,2018,BRETAGNE,BREC'H,8815,3009,11824,
Musée de la Compagnie des Indes,2018,BRETAGNE,PORT-LOUIS,38691,32753,71444,
Musée de la Résistance Bretonne,2018,BRETAGNE,SAINT-MARCEL - MALESTROIT,11362,2488,13850,
Musée des Arts Décoratifs,2018,CENTRE-VAL DE LOIRE,BOURGES,5731,1394,7125,
Musée du Berry,2018,CENTRE-VAL DE LOIRE,BOURGES,5953,1197,7150,
Musée des Meilleurs Ouvriers de France,2018,CENTRE-VAL DE LOIRE,BOURGES,10157,1095,11252,
Musée Municipal,2018,CENTRE-VAL DE LOIRE,VIERZON,1634,5190,6824,
Musée d'Art et d'Histoire de Dreux,2018,CENTRE-VAL DE LOIRE,DREUX,993,10467,11460,
Musée Marcel Proust,2018,CENTRE-VAL DE LOIRE,ILLIERS-COMBRAY,3693,348,4041,
Musées de Châteauroux - Hôtel Bertrand,2018,CENTRE-VAL DE LOIRE,CHATEAUROUX,3804,12494,16298,
Musée Ornithologique (Ecomusée de la Brenne),2018,CENTRE-VAL DE LOIRE,LE BLANC,1846,1547,3393,
"Le Carroi, Musée d’Arts et d’Histoire",2018,CENTRE-VAL DE LOIRE,CHINON,2284,1425,3709,
Musée de Préhistoire du Grand Pressigny,2018,CENTRE-VAL DE LOIRE,LE GRAND PRESSIGNY,13212,3262,16474,
Musée François Rabelais,2018,CENTRE-VAL DE LOIRE,SEUILLY,10110,2665,12775,
Muséum d'Histoire Naturelle,2018,CENTRE-VAL DE LOIRE,BLOIS,6970,8464,15434,
Musée de la Maison Bonaparte,2018,CORSE,AJACCIO,59664,29410,89074,
Musée d'archéologie d'Aleria - Jérôme Carcopino,2018,CORSE,ALERIA,29404,9171,38575,
Musée Camille Claudel,2018,GRAND EST,NOGENT-SUR-SEINE,21442,11939,33381,
Musée Vauluisant - Musée de la Bonneterie,2018,GRAND EST,TROYES,4403,8016,12419,
Musée du Pays de Hanau - Histoire et Vies d’un Territoire,2018,GRAND EST,BOUXWILLER,1803,5646,7449,
Musée du Fer,2018,GRAND EST,REICHSHOFFEN,574,1410,1984,
Musée d'Art Moderne et Contemporain de Strasbourg,2018,GRAND EST,STRASBOURG,54017,101402,155419,
Musée Archéologique,2018,GRAND EST,STRASBOURG,26663,30681,57344,
Musée Zoologique de Strasbourg,2018,GRAND EST,STRASBOURG,8792,32854,41646,
Musée de l'Œuvre Notre-Dame,2018,GRAND EST,STRASBOURG,19856,32103,51959,
Musée des Beaux-Arts,2018,GRAND EST,STRASBOURG,34512,39061,73573,
Musée Tomi Ungerer,2018,GRAND EST,STRASBOURG,25000,25000,50000,
Musée J.F. Oberlin,2018,GRAND EST,WALDERSBACH,15197,7662,22859,
Musée Municipal,2018,GRAND EST,BOURBONNE-LES-BAINS,0,1799,1799,
Maison des Lumières Denis Diderot,2018,GRAND EST,LANGRES,4418,6457,10875,
Musée Gallo-Romain,2018,GRAND EST,BIESHEIM,756,1626,2382,
Musée National de l'Automobile - Collection Schlumpf,2018,GRAND EST,MULHOUSE,157271,24702,181973,
Ecomusée d'Alsace,2018,GRAND EST,UNGERSHEIM,155543,15548,171091,
Musée du Sapeur Pompier d'Alsace,2018,GRAND EST,VIEUX FERRETTE,3590,1082,4672,
Musée Municipal,2018,GRAND EST,CHALONS-EN-CHAMPAGNE,2133,9696,11829,
Musée Hôtel le Vergeur,2018,GRAND EST,REIMS,12330,0,12330,
Les Sources d'Hercule,2018,GRAND EST,DENEUVRE,1796,587,2383,
Musée de l'Ecole de Nancy,2018,GRAND EST,NANCY,24843,14384,39227,
Musée Départemental Raymond Poincaré,2018,GRAND EST,SAMPIGNY,0,3731,3731,
Musée de la Princerie,2018,GRAND EST,VERDUN,1496,4367,5863,
Musée Départemental de la Guerre de 70,2018,GRAND EST,GRAVELOTTE,8636,4735,13371,
Musée des Mines de fer de Lorraine,2018,GRAND EST,NEUFCHEF,15234,1460,16694,
La Tour aux Puces - Musée du Pays Thionvillois,2018,GRAND EST,THIONVILLE,1006,9968,10974,
Musée de l'Image,2018,GRAND EST,EPINAL,12469,1765,14234,
Musée Jeanne d'Aboville,2018,HAUTS-DE-FRANCE,LA FERE,542,1067,1609,
Musée Entomologique,2018,HAUTS-DE-FRANCE,SAINT-QUENTIN,4776,10715,15491,
Musée Départemental de Flandre,2018,HAUTS-DE-FRANCE,CASSEL,28900,15628,44528,
Palais des Beaux-Arts de Lille,2018,HAUTS-DE-FRANCE,LILLE,107831,149995,257826,
MUba - Musée des Beaux-Arts Eugène Leroy de Tourcoing,2018,HAUTS-DE-FRANCE,TOURCOING,31065,12471,43536,
Musée Pillon,2018,HAUTS-DE-FRANCE,CHAUMONT-EN-VEXIN,0,782,782,
Musée de la Vénerie,2018,HAUTS-DE-FRANCE,SENLIS,1303,3355,4658,
Musée Archéologique de l'Oise,2018,HAUTS-DE-FRANCE,VENDEUIL-CAPLY,8140,1500,9640,
Musée Alfred Danicourt,2018,HAUTS-DE-FRANCE,PERONNE,0,2263,2263,
Musée Municipal Robert Dubois-Corneau,2018,ILE-DE-FRANCE,BRUNOY,139,2555,2694,
Musée Municipal d'Art et d'Histoire,2018,ILE-DE-FRANCE,COLOMBES,0,6428,6428,
Musée du Domaine Départemental de Sceaux,2018,ILE-DE-FRANCE,SCEAUX,12397,11584,23981,
Musée de l'Homme (Muséum National d'Histoire Naturelle),2018,ILE-DE-FRANCE,PARIS,167058,82740,249798,
Galerie de Minéralogie et de Géologie (Muséum d'Histoire Naturelle),2018,ILE-DE-FRANCE,PARIS,28588,40134,68722,
Musée d'Ennery,2018,ILE-DE-FRANCE,PARIS,0,721,721,
Maison de Balzac,2018,ILE-DE-FRANCE,PARIS,0,12700,12700,
"Musée Cernuschi, Musée des Arts de l'Asie de la ville de Paris",2018,ILE-DE-FRANCE,PARIS,68136,24975,93111,
Musée d'Art et d'Histoire de l'Hôpital Sainte-Anne,2018,ILE-DE-FRANCE,PARIS,0,7025,7025,
Institut du Monde Arabe,2018,ILE-DE-FRANCE,PARIS,282136,27100,309236,
Musée Yves Saint Laurent,2018,ILE-DE-FRANCE,PARIS,183466,12590,196056,
Musée Municipal de Chelles Alfred Bonno,2018,ILE-DE-FRANCE,CHELLES,0,3121,3121,
Musée du Château de Fontainebleau,2018,ILE-DE-FRANCE,FONTAINEBLEAU,203870,171317,375187,
Musée d'Art et d'Histoire de Melun,2018,ILE-DE-FRANCE,MELUN,2760,9930,12690,
Musée Municipal,2018,ILE-DE-FRANCE,MORET-SUR-LOING,0,2417,2417,
Château-musée de Nemours,2018,ILE-DE-FRANCE,NEMOURS,5621,7127,12748,
Musée Adrien Mentienne,2018,ILE-DE-FRANCE,BRY-SUR-MARNE,0,4446,4446,
Musée de Nogent-Sur-Marne,2018,ILE-DE-FRANCE,NOGENT-SUR-MARNE,491,6566,7057,
Musée de la Renaissance - Château d'Ecouen,2018,ILE-DE-FRANCE,ECOUEN,14577,40713,55290,
Musée d'Art et d'Histoire Louis Senlecq,2018,ILE-DE-FRANCE,L'ISLE-ADAM,944,3167,4111,
Musée du Jouet Pierre Pinel,2018,ILE-DE-FRANCE,POISSY,460,4138,4598,
Etablissement Public du Musée et du Domaine National de Versailles,2018,ILE-DE-FRANCE,VERSAILLES,6197043,1935475,8132518,
Musée Départemental de la Réunion - Musée Léon Dierx,2018,LA REUNION,SAINT-DENIS,4098,15255,19353,
Musée Historique de Villèle,2018,LA REUNION,SAINT-GILLES-LES-HAUTS,19467,21090,40557,
Musée Départemental d'Archéologie Précolombienne et de Préhistoire de la Martinique,2018,MARTINIQUE,FORT-DE-FRANCE,4557,2420,6977,
Musée de La Canne,2018,MARTINIQUE,LES TROIS ILETS,12287,2194,14481,
Musée Volcanologique Franck Arnold Perret,2018,MARTINIQUE,SAINT-PIERRE,10976,0,10976,
MuMa - Musée de Mayotte,2018,MAYOTTE,DZAOUDZI,0,6157,6157,
Musée du Débarquement,2018,NORMANDIE,ARROMANCHES,286653,12948,299601,
Musée d'Initiation à la Nature,2018,NORMANDIE,CAEN,0,5950,5950,
Musée d'Art et d'Histoire de Lisieux,2018,NORMANDIE,LISIEUX,149,7278,7427,
Musée de l'Ancien Evêché,2018,NORMANDIE,EVREUX,0,21358,21358,
Musée Artisanal et Industriel d'Instruments à Vent,2018,NORMANDIE,LA COUTURE-BOUSSEY,0,2781,2781,
Musée Alfred Canel,2018,NORMANDIE,PONT-AUDEMER,663,5217,5880,
Musée Alphonse-Georges Poulain,2018,NORMANDIE,VERNON,9132,8516,17648,
Musée Thomas Henry,2018,NORMANDIE,CHERBOURG-EN-COTENTIN,2816,9810,12626,
Musée Christian Dior,2018,NORMANDIE,GRANVILLE,49563,7439,57002,
"Musée du Bocage Normand, ferme du bois Jugan",2018,NORMANDIE,SAINT-LO,1188,1660,2848,
Musée Municipal - Musée du Jouet,2018,NORMANDIE,LA FERTE-MACE,828,0,828,
Musée Départemental des Arts et Traditions Populaires du Perche,2018,NORMANDIE,SAINT-CYR LA ROSIERE,10492,10129,20621,
Musée Municipal,2018,NORMANDIE,BARENTIN,0,250,250,
Musée Louis-Philippe du Château d'Eu,2018,NORMANDIE,EU,14854,4173,19027,
"Les Pêcheries, Musée de Fécamp",2018,NORMANDIE,FECAMP,48788,27833,76621,
Musée d'Art Moderne André Malraux - MuMa,2018,NORMANDIE,LE HAVRE,39587,44319,83906,
La Maison de l'Armateur,2018,NORMANDIE,LE HAVRE,6107,6782,12889,
Abbaye de Graville - Musée du Prieuré de Graville,2018,NORMANDIE,LE HAVRE,2817,5784,8601,
Muséum d'Histoire Naturelle,2018,NORMANDIE,LE HAVRE,11545,34745,46290,
"Juliobona, Musée Gallo-Romain de Lillebonne",2018,NORMANDIE,LILLEBONNE,3372,1300,4672,
Ecomusée de la Basse-Seine (Plusieurs sites),2018,NORMANDIE,NOTRE-DAME-DE-BLIQUETUIT,17285,2814,20099,
Musée des Antiquités de la Seine-Maritime,2018,NORMANDIE,ROUEN,3151,32716,35867,
Musée-Maison Natale Pierre Corneille,2018,NORMANDIE,ROUEN,0,7699,7699,
Musée Victor Hugo,2018,NORMANDIE,VILLEQUIER,6125,7660,13785,
Musée Archéologique et Historique,2018,NOUVELLE-AQUITAINE,ANGOULEME,108,956,1064,
Atelier - Musée du Papier,2018,NOUVELLE-AQUITAINE,ANGOULEME,4206,13938,18144,
Musée du Nouveau Monde,2018,NOUVELLE-AQUITAINE,LA ROCHELLE,6972,14394,21366,
Musée des Beaux-Arts,2018,NOUVELLE-AQUITAINE,LA ROCHELLE,4511,11007,15518,
Musée Dupuy-Mestreau,2018,NOUVELLE-AQUITAINE,SAINTES,851,965,1816,
Musée d'Aquitaine,2018,NOUVELLE-AQUITAINE,BORDEAUX,50036,101573,151609,
Muséum d'Histoire Naturelle de Bordeaux,2018,NOUVELLE-AQUITAINE,BORDEAUX,0,11925,11925,
CAPC Musée d'Art Contemporain de Bordeaux,2018,NOUVELLE-AQUITAINE,BORDEAUX,43632,68615,112247,
Musée des Beaux-Arts,2018,NOUVELLE-AQUITAINE,BORDEAUX,36080,50891,86971,
Musée René Baubérot,2018,NOUVELLE-AQUITAINE,CHATEAUPONSAC,1328,741,2069,
Musée Historique de l'Hydravion,2018,NOUVELLE-AQUITAINE,BISCARROSSE,16589,2703,19292,
Musée Départemental d'Histoire et d'Archéologie,2018,NOUVELLE-AQUITAINE,HASTINGUES,4764,3075,7839,
Musée des Beaux-Arts,2018,NOUVELLE-AQUITAINE,AGEN,10123,12082,22205,
Musée du Château Henri IV,2018,NOUVELLE-AQUITAINE,NERAC,8851,4268,13119,
Musée Edmond Rostand,2018,NOUVELLE-AQUITAINE,CAMBO-LES-BAINS,76903,9698,86601,
Musée Municipal de Guéthary,2018,NOUVELLE-AQUITAINE,GUETHARY,0,150,150,
Musée d'Art et d'Histoire de Montmorillon,2018,NOUVELLE-AQUITAINE,MONTMORILLON,0,1160,1160,
Musée Petiet,2018,OCCITANIE,LIMOUX,709,2717,3426,
Palais-Musée des Archevêques de Narbonne,2018,OCCITANIE,NARBONNE,30316,105357,135673,
Musée Archéologique,2018,OCCITANIE,SALLELES D'AUDE,4549,4655,9204,
Musée des Beaux-Arts Denys Puech,2018,OCCITANIE,RODEZ,0,11755,11755,
Musée Albert André,2018,OCCITANIE,BAGNOLS-SUR-CEZE,44,4530,4574,
Musée des Beaux-Arts,2018,OCCITANIE,NIMES,5799,8067,13866,
Musée Campanaire,2018,OCCITANIE,L'ISLE JOURDAIN,8034,0,8034,
Musée Joseph Abeilhé,2018,OCCITANIE,MARCIAC,155,52,207,
Muséum d'Histoire Naturelle,2018,OCCITANIE,TOULOUSE,168455,137341,305796,
"Les Abattoirs, Musée d'Art Moderne et Contemporain",2018,OCCITANIE,TOULOUSE,42042,123861,165903,
Musée des Augustins,2018,OCCITANIE,TOULOUSE,49368,87764,137132,
Musée Pyrénéen,2018,OCCITANIE,LOURDES,68877,10465,79342,
Musée Massey,2018,OCCITANIE,TARBES,5007,5901,10908,
Musée des Beaux-Arts de Béziers,2018,OCCITANIE,BEZIERS,1153,1652,2805,
Musée Municipal,2018,OCCITANIE,FRONTIGNAN-LA-PEYRADE,0,2382,2382,
Musée de l'Ephèbe,2018,OCCITANIE,LE CAP D'AGDE,8764,4831,13595,
Musée Archéologique,2018,OCCITANIE,MINERVE,3275,0,3275,
Musée de Préhistoire Amédée Lémozi,2018,OCCITANIE,CABRERETS,78944,0,78944,
Musée Murat,2018,OCCITANIE,CŒUR DE CAUSSE,799,43,842,
Musée Champollion - Les Ecriture du Monde,2018,OCCITANIE,FIGEAC,29608,8738,38346,
Musée d'Art Moderne - Fonds Peskè,2018,OCCITANIE,COLLIOURE,8935,2325,11260,
Musée Toulouse Lautrec,2018,OCCITANIE,ALBI,121652,30201,151853,
Musée Eugénie et Maurice Guérin,2018,OCCITANIE,ANDILLAC,1701,2775,4476,
Musée du Protestantisme de la Réforme à la Laïcité,2018,OCCITANIE,FERRIERES,2754,895,3649,
Musée d'Histoire Naturelle Victor Brun,2018,OCCITANIE,MONTAUBAN,1589,7062,8651,
Musée des Marais Salant,2018,PAYS DE LA LOIRE,BATZ-SUR-MER,12734,7520,20254,
Musée Pincé,2018,PAYS DE LA LOIRE,ANGERS,0,190,190,
Musée d'Art et d'Archéologie Hôtel Fouquet,2018,PAYS DE LA LOIRE,CHATEAU-GONTIER,951,1539,2490,
Musée de Tessé,2018,PAYS DE LA LOIRE,LE MANS,8335,13258,21593,
Musée de la Reine Bérengère,2018,PAYS DE LA LOIRE,LE MANS,2423,8872,11295,
Bibliothèque-musée,2018,PAYS DE LA LOIRE,SAINT-CALAIS,89,1095,1184,
Musée La Bourrine du Bois-Juquaud,2018,PAYS DE LA LOIRE,SAINT-HILAIRE-DE-RIEZ,8960,2736,11696,
Musée Gassendi,2018,PROVENCE-ALPES-CÔTE D'AZUR,DIGNE-LES-BAINS,3335,12724,16059,
Musée Municipal,2018,PROVENCE-ALPES-CÔTE D'AZUR,FORCALQUIER,0,1280,1280,
Musée archéologique,2018,PROVENCE-ALPES-CÔTE D'AZUR,VACHERES,591,112,703,
Musée d'Histoire et d'Archéologie,2018,PROVENCE-ALPES-CÔTE D'AZUR,ANTIBES,5729,4406,10135,
Musée d'Histoire Locale,2018,PROVENCE-ALPES-CÔTE D'AZUR,BIOT,4056,0,4056,
Musée de la Mer,2018,PROVENCE-ALPES-CÔTE D'AZUR,CANNES,41397,33508,74905,
Musée International de la Parfumerie,2018,PROVENCE-ALPES-CÔTE D'AZUR,GRASSE,77066,44362,121428,
Muséum d'Histoire Naturelle,2018,PROVENCE-ALPES-CÔTE D'AZUR,NICE,1353,1100,2453,
Musée d'Art et d'Histoire,2018,PROVENCE-ALPES-CÔTE D'AZUR,NICE,32076,45189,77265,
Musée Picasso la guerre et la paix à Vallauris,2018,PROVENCE-ALPES-CÔTE D'AZUR,VALLAURIS,17269,8099,25368,
"Musée Magnelli, Musée de la Céramique",2018,PROVENCE-ALPES-CÔTE D'AZUR,VALLAURIS,17910,8502,26412,
Musée du Pavillon de Vendôme,2018,PROVENCE-ALPES-CÔTE D'AZUR,AIX-EN-PROVENCE,6742,14364,21106,
Musée Réattu,2018,PROVENCE-ALPES-CÔTE D'AZUR,ARLES,12974,17410,30384,
Musée Frédéric Mistral,2018,PROVENCE-ALPES-CÔTE D'AZUR,MAILLANE,758,10,768,
Musée des Docks Romains,2018,PROVENCE-ALPES-CÔTE D'AZUR,MARSEILLE,0,13870,13870,
Musée des Beaux-Arts de Marseille,2018,PROVENCE-ALPES-CÔTE D'AZUR,MARSEILLE,12525,27929,40454,
Musée Ziem,2018,PROVENCE-ALPES-CÔTE D'AZUR,MARTIGUES,0,14069,14069,
Musée des Alpilles,2018,PROVENCE-ALPES-CÔTE D'AZUR,SAINT-REMY-DE-PROVENCE,3018,5115,8133,
Musée de l'Empéri de Salon et de la Crau,2018,PROVENCE-ALPES-CÔTE D'AZUR,SALON-DE-PROVENCE,5557,24142,29699,
Musée de Salon et de la Crau,2018,PROVENCE-ALPES-CÔTE D'AZUR,SALON-DE-PROVENCE,0,8387,8387,
Musée Calvet (et musée Lapidaire),2018,PROVENCE-ALPES-CÔTE D'AZUR,AVIGNON,3376,70533,73909,
Musée du Bugey-Valmorey,2019,AUVERGNE-RHONE-ALPES,LOCHIEU,2426,1586,4012,M0967
Musée des Musiques Populaires - MuPop,2019,AUVERGNE-RHONE-ALPES,MONTLUCON,21241,2815,24056,M0104
Centre National du Costume de Scène et de la Scénographie,2019,AUVERGNE-RHONE-ALPES,MOULINS,75016,15847,90863,M5083
Musée du Château des Adhémars,2019,AUVERGNE-RHONE-ALPES,MONTELIMAR,11697,11239,22936,M0984
Musée des Beaux-Arts,2019,AUVERGNE-RHONE-ALPES,VALENCE,6863,31925,38788,M0988
Musée des Arts et Traditions Populaires de Haute Loire,2019,AUVERGNE-RHONE-ALPES,LAVAUDIEU,7570,66,7636,M0115
Musée Alpin,2019,AUVERGNE-RHONE-ALPES,CHAMONIX,21676,9290,30966,M1053
Musée de Grenoble,2019,AUVERGNE-RHONE-ALPES,GRENOBLE,116042,112647,228689,M0994
Musée Hébert,2019,AUVERGNE-RHONE-ALPES,LA TRONCHE,459,46879,47338,M1003
Musée Lapidaire Saint-Pierre,2019,AUVERGNE-RHONE-ALPES,VIENNE,4242,8390,12632,M1006
Musée Alice Taverne,2019,AUVERGNE-RHONE-ALPES,AMBIERLE,4092,1852,5944,M1009
Musée d'Allard,2019,AUVERGNE-RHONE-ALPES,MONTBRISON,4820,5746,10566,M1016
Château de la Bastie d'Urfé,2019,AUVERGNE-RHONE-ALPES,SAINT-ETIENNE-LE-MOLARD,8217,15274,23491,M1026
Musée des Civilisations : Daniel Pouget,2019,AUVERGNE-RHONE-ALPES,SAINT-JUST-SAINT-RAMBERT,3473,1188,4661,M1028
Musée d'Art Moderne et Contemporain de Saint-Etienne Métropole,2019,AUVERGNE-RHONE-ALPES,SAINT-PRIEST-EN-JAREZ,34865,27369,62234,M1024
Musée de la Dentelle,2019,AUVERGNE-RHONE-ALPES,ARLANC,1446,92,1538,M0119
Musée Municipal Marcel Sahut,2019,AUVERGNE-RHONE-ALPES,VOLVIC,320,782,1102,M0130
Lugdunum - Musée et Théâtres Romains,2019,AUVERGNE-RHONE-ALPES,LYON,43776,75325,119101,M1036
Musée d'Art Contemporain de Lyon,2019,AUVERGNE-RHONE-ALPES,LYON,77797,22925,100722,M1033
Musée Henri Malartre,2019,AUVERGNE-RHONE-ALPES,ROCHETAILLEE-SUR-SAONE,17197,16737,33934,M1040
Musée Archéologique,2019,AUVERGNE-RHONE-ALPES,SAINT-ROMAIN-EN-GAL,22898,51106,74004,M1042
Musée des Charmettes,2019,AUVERGNE-RHONE-ALPES,CHAMBERY,0,13723,13723,M1049
Musée du Vin de Bourgogne,2019,BOURGOGNE-FRANCHE-COMTE,BEAUNE,12265,3558,15823,M0133
Musée François Rude,2019,BOURGOGNE-FRANCHE-COMTE,DIJON,0,96288,96288,M0140
"Musée de la Vie Bourguignonne, Perrin de Puycousin",2019,BOURGOGNE-FRANCHE-COMTE,DIJON,0,37131,37131,M0139
Musée d'Art Sacré,2019,BOURGOGNE-FRANCHE-COMTE,DIJON,0,11129,11129,M1208
Musée Municipal,2019,BOURGOGNE-FRANCHE-COMTE,SEMUR-EN-AUXOIS,2263,1221,3484,M0147
Muséum d'Histoire Naturelle de Besançon,2019,BOURGOGNE-FRANCHE-COMTE,BESANCON,196966,0,196966,M7011
Musée du Temps,2019,BOURGOGNE-FRANCHE-COMTE,BESANCON,10603,27783,38386,M0333
Musée de la Grande Saline,2019,BOURGOGNE-FRANCHE-COMTE,SALINS-LES-BAINS,63964,6466,70430,M0353
Ecomusée de la Bresse Bourguignonne,2019,BOURGOGNE-FRANCHE-COMTE,PIERRE-DE-BRESSE,27396,11019,38415,M0177
Musée Départemental du Compagnonnage,2019,BOURGOGNE-FRANCHE-COMTE,ROMANECHE-THORINS,5603,0,5603,M0178
Musée Départemental de Préhistoire de Solutré,2019,BOURGOGNE-FRANCHE-COMTE,SOLUTRE-POUILLY,13650,12775,26425,M0180
Musée Frédéric Japy,2019,BOURGOGNE-FRANCHE-COMTE,BEAUCOURT,1031,476,1507,M0360
Musée Leblanc-Duvernois,2019,BOURGOGNE-FRANCHE-COMTE,AUXERRE,0,1682,1682,M0185
Musée Zervos - Maison Romain Rolland,2019,BOURGOGNE-FRANCHE-COMTE,VEZELAY,7183,4219,11402,M0191
Musée Villeneuvien,2019,BOURGOGNE-FRANCHE-COMTE,VILLENEUVE-SUR-YONNE,0,2719,2719,M0192
Musée d'Art et d'Histoire du Puisaye,2019,BOURGOGNE-FRANCHE-COMTE,VILLIERS-SAINT-BENOIT,666,889,1555,M0193
Musée de Dinan,2019,BRETAGNE,DINAN,0,19080,19080,M0194
Musée Mathurin Meheut,2019,BRETAGNE,LAMBALLE,7862,1011,8873,M0195
Le Port-Musée,2019,BRETAGNE,DOUARNENEZ,34187,5907,40094,M0200
Musée de Bretagne,2019,BRETAGNE,RENNES,16470,49551,66021,M0212
Musée d'Histoire de la Ville et d'Ethnographie du Pays Malouin,2019,BRETAGNE,SAINT-MALO,19379,12920,32299,M0214
Musée de la Compagnie des Indes,2019,BRETAGNE,PORT-LOUIS,41615,35427,77042,M0224
Musée Marcel Proust,2019,CENTRE-VAL DE LOIRE,ILLIERS-COMBRAY,5399,4000,9399,M0242
Musée François Rabelais,2019,CENTRE-VAL DE LOIRE,SEUILLY,11126,1805,12931,M0264
Musée du Compagnonnage,2019,CENTRE-VAL DE LOIRE,TOURS,24467,11959,36426,M0266
Maison de la Magie,2019,CENTRE-VAL DE LOIRE,BLOIS,82512,21934,104446,M1083
Musée Municipal Théâtre Forain et Archéologique,2019,CENTRE-VAL DE LOIRE,ARTENAY,6993,2344,9337,M0278
"Hôtel Cabu, Musée d'Histoire et d'Archéologie",2019,CENTRE-VAL DE LOIRE,ORLEANS,2433,10990,13423,M0287
Musée de l'Alta Rocca,2019,CORSE,LEVIE,5207,5678,10885,M0326
Musée de l'Ardenne,2019,GRAND EST,CHARLEVILLE-MEZIERES,6501,45274,51775,M0292
Musée du Feutre,2019,GRAND EST,MOUZON,2274,1534,3808,M0294
Musée des Beaux-Arts (Musée Pic Saint-Loup),2019,GRAND EST,TROYES,6490,23912,30402,M0303
Musée de la Poterie,2019,GRAND EST,BETSCHDORF,1956,642,2598,M0002
Musée du Pays de Hanau - Histoire et Vies d’un Territoire,2019,GRAND EST,BOUXWILLER,2006,4748,6754,M0003
Musée du Château des Rohan,2019,GRAND EST,SAVERNE,4674,3625,8299,M0012
Musée d'Art Moderne et Contemporain de Strasbourg,2019,GRAND EST,STRASBOURG,65604,93807,159411,M0016
Musée Zoologique de Strasbourg,2019,GRAND EST,STRASBOURG,8028,28079,36107,M7071
"Le Signe, Centre national du Graphisme",2019,GRAND EST,CHAUMONT,0,28245,28245,M0318
Maison des Lumières Denis Diderot,2019,GRAND EST,LANGRES,4507,7770,12277,M0320
Musée du Vignoble et des Vins d'Alsace,2019,GRAND EST,KAYSERSBERG VIGNOBLE,2488,0,2488,M0032
Musée Historique,2019,GRAND EST,MULHOUSE,0,40016,40016,M0034
Cité du Train,2019,GRAND EST,MULHOUSE,78441,27609,106050,M0036
Musée du Sapeur Pompier d'Alsace,2019,GRAND EST,VIEUX-FERRETTE,2946,859,3805,M0038
Musée Jeanne d'Arc,2019,GRAND EST,VAUCOULEURS,980,784,1764,M0524
Musée de la Princerie,2019,GRAND EST,VERDUN,1819,4438,6257,M0525
Musée Départemental du Sel,2019,GRAND EST,MARSAL,0,636,636,M0527
Musée des Mines de fer de Lorraine,2019,GRAND EST,NEUFCHEF,15157,1589,16746,M0530
La Tour aux Puces - Musée du Pays Thionvillois,2019,GRAND EST,THIONVILLE,972,9603,10575,M0534
Musée Départemental d'Art Ancien et Contemporain,2019,GRAND EST,EPINAL,3547,18077,21624,M0536
Musée Charles de Bruyères,2019,GRAND EST,REMIREMONT,676,2376,3052,M0540
Musée Départemental Victor Schoelcher,2019,GUADELOUPE,POINTE-A-PITRE,0,4953,4953,M1061
Musée Jean de la Fontaine,2019,HAUTS-DE-France,CHATEAU-THIERRY,9396,3111,12507,M0784
Familistère de Guise,2019,HAUTS-DE-France,GUISE,59507,2833,62340,M0787
Musée Départemental de Flandre,2019,HAUTS-DE-France,CASSEL,45189,21394,66583,M0617
Musée des Dentelles et Broderies,2019,HAUTS-DE-France,CAUDRY,8670,4444,13114,M1197
Musée d'Histoire Naturelle et de Géologie,2019,HAUTS-DE-France,LILLE,46199,76098,122297,M7001
Musée Gallé-Juillet,2019,HAUTS-DE-France,CREIL,2655,7219,9874,M0805
Musée des Beaux-Arts,2019,HAUTS-DE-France,ARRAS,4041,40860,44901,M0640
Musée Communautaire Opale-Sud,2019,HAUTS-DE-France,BERCK-SUR-MER,3291,1551,4842,M0641
Cité Internationale de la Dentelle et de la Mode de Calais,2019,HAUTS-DE-France,CALAIS,35171,16551,51722,M1177
Musée de la Céramique,2019,HAUTS-DE-France,DESVRES,7712,1542,9254,M0645
Musée d'Histoire et d'Archéologie,2019,HAUTS-DE-France,HARNES,0,100,100,M0647
Musée-Historial de la Grande Guerre,2019,HAUTS-DE-France,PERONNE,78889,8763,87652,M0816
Musée des Années Trente,2019,ILE-DE-France,BOULOGNE-BILLANCOURT,10652,14294,24946,M0406
"Albert-Kahn, Musée et Jardin Départementaux",2019,ILE-DE-France,BOULOGNE-BILLANCOURT,14631,28350,42981,M0407
Musée Roybet Fould,2019,ILE-DE-France,COURBEVOIE,859,9347,10206,M0410
Etablissement Public du Musée des Arts Asiatiques Guimet,2019,ILE-DE-France,PARIS,111624,141599,253223,M5005
Musée du Louvre,2019,ILE-DE-France,PARIS,5729967,3790306,9520273,M5031
Maison de Balzac,2019,ILE-DE-France,PARIS,9019,19265,28284,M1102
Musée Nissim de Camondo (MAD),2019,ILE-DE-France,PARIS,29013,16076,45089,M5073
Musée de la Franc-Maçonnerie,2019,ILE-DE-France,PARIS,13546,4460,18006,M0366
Musée de la Musique,2019,ILE-DE-France,PARIS,316089,96940,413029,M5057
Musée de l'Ecole Nationale Supérieure des Beaux-Arts,2019,ILE-DE-France,PARIS,0,59113,59113,M5051
"Petit Palais, Musée des Beaux-Arts de la ville de Paris",2019,ILE-DE-France,PARIS,204376,745912,950288,M1111
Musée Carnavalet-Histoire de Paris,2019,ILE-DE-France,PARIS,0,7870,7870,M1104
"Musée Cernuschi, Musée des Arts de l'Asie de la ville de Paris",2019,ILE-DE-France,PARIS,16917,29111,46028,M1106
Musée du 11 Conti - Monnaie de Paris,2019,ILE-DE-France,PARIS,96200,33800,130000,M5066
Musée du Quai Branly - Jacques Chirac,2019,ILE-DE-France,PARIS,526163,586260,1112423,M5055
Musée de la Poste,2019,ILE-DE-France,PARIS,12092,804,12896,M1116
"Musée des Transports Urbains, Interurbains et Ruraux",2019,ILE-DE-France,CHELLES,0,160,160,M0428
Musée Municipal,2019,ILE-DE-France,MORET-SUR-LOING-ET-ORVANNE,0,2574,2574,M0380
Musée d'Art et d'Histoire Paul Eluard,2019,ILE-DE-France,SAINT-DENIS,2886,13976,16862,M0422
Musée Adrien Mentienne,2019,ILE-DE-France,BRY-SUR-MARNE,0,3860,3860,M0424
"MAC VAL, Musée d'Art Contemporain du Val-de-Marne",2019,ILE-DE-France,VITRY SUR SEINE,5619,50065,55684,M0431
Musée de la Renaissance - Château d'Ecouen,2019,ILE-DE-France,ECOUEN,13953,39343,53296,M5012
Musée d'Art et d'Histoire Louis Senlecq,2019,ILE-DE-France,L'ISLE-ADAM,1009,4342,5351,M0435
Musée Lambinet,2019,ILE-DE-France,VERSAILLES,11943,6912,18855,M0400
Musée National des Châteaux de Versailles et de Trianon,2019,ILE-DE-France,VERSAILLES,6676633,1501062,8177695,M5077
Musée Départemental d'Archéologie Précolombienne et de Préhistoire de la Martinique,2019,MARTINIQUE,FORT-DE-FRANCE,3699,4483,8182,M1065
Musée du Débarquement,2019,NORMANDIE,ARROMANCHES,313472,13202,326674,M0654
Musée de Normandie,2019,NORMANDIE,CAEN,20973,35710,56683,M0658
Musée Municipal,2019,NORMANDIE,ORBEC,0,2148,2148,M0666
Musée Municipal,2019,NORMANDIE,LOUVIERS,0,6770,6770,M0706
Musée du Vieux Château,2019,NORMANDIE,BRICQUEBEC-EN-COTENTIN,471,150,621,M0675
Musée de l'Abbaye,2019,NORMANDIE,CERISY-LA-FORÊT,5463,1418,6881,M0676
Musée Thomas Henry,2019,NORMANDIE,CHERBOURG-EN-COTENTIN,20861,6165,27026,M0677
Musée de la Guerre et de la Libération,2019,NORMANDIE,CHERBOURG-EN-COTENTIN,6020,3446,9466,M0679
Musée des Beaux-Arts,2019,NORMANDIE,SAINT-LÔ,1733,8497,10230,M0685
Musée Barbey d'Aurevilly,2019,NORMANDIE,SAINT-SAUVEUR-LE-VICOMTE,677,530,1207,M0688
Musée Départemental des Arts et Traditions Populaires du Perche,2019,NORMANDIE,SAINT-CYR-LA-ROSIERE,11810,13530,25340,M0699
Musée Municipal,2019,NORMANDIE,BARENTIN,0,250,250,M0709
"Les Pêcheries, Musée de Fécamp",2019,NORMANDIE,FECAMP,40733,22206,62939,M0715
La Maison de l'Armateur,2019,NORMANDIE,LE HAVRE,6360,8439,14799,M0721
Musée des Sapeurs-Pompiers de France,2019,NORMANDIE,MONTVILLE,6542,3704,10246,M0726
Musée des Antiquités de la Seine-Maritime,2019,NORMANDIE,ROUEN,3290,59903,63193,M0733
Musée des Beaux-Arts,2019,NORMANDIE,ROUEN,50322,232596,282918,M0729
Musée-Maison Natale Pierre Corneille,2019,NORMANDIE,ROUEN,0,3534,3534,M0731
Atelier - Musée du Papier,2019,NOUVELLE-AQUITAINE,ANGOULEME,3902,14861,18763,M0819
Musée des Arts du Cognac,2019,NOUVELLE-AQUITAINE,COGNAC,6744,2574,9318,M0822
Musée des Beaux-Arts,2019,NOUVELLE-AQUITAINE,LA ROCHELLE,8018,10612,18630,M0825
Musée de l'Ile d'Oléron,2019,NOUVELLE-AQUITAINE,SAINT-PIERRE D'OLERON,10260,2828,13088,M0834
Musée Départemental de la Tapisserie,2019,NOUVELLE-AQUITAINE,AUBUSSON,25273,12086,37359,M0502
Musée Fernand Desmoulin,2019,NOUVELLE-AQUITAINE,BRANTOME EN PERIGORD,32054,5124,37178,M0051
Musée National de la Préhistoire,2019,NOUVELLE-AQUITAINE,LES EYZIES,36172,30695,66867,M5014
Musée Militaire - Souvenir du Périgord,2019,NOUVELLE-AQUITAINE,PERIGUEUX,2044,796,2840,M0056
Musée d'Art et d'Archéologie du Périgord (MAAP),2019,NOUVELLE-AQUITAINE,PERIGUEUX,7902,11970,19872,M0057
Musée Gallo-Romain de Vesunna,2019,NOUVELLE-AQUITAINE,PERIGUEUX,24769,13996,38765,M1188
Musée des Arts Décoratifs et du Design,2019,NOUVELLE-AQUITAINE,BORDEAUX,22514,70536,93050,M0066
Musée d'Aquitaine,2019,NOUVELLE-AQUITAINE,BORDEAUX,46995,96758,143753,M0064
Muséum d'Histoire Naturelle de Bordeaux,2019,NOUVELLE-AQUITAINE,BORDEAUX,108170,104269,212439,M7026
Musée National Adrien Dubouché,2019,NOUVELLE-AQUITAINE,LIMOGES,16225,17945,34170,M5015
Musée Départemental d'Art Contemporain,2019,NOUVELLE-AQUITAINE,ROCHECHOUART,9236,7231,16467,M0506
Musée Historique de l'Hydravion,2019,NOUVELLE-AQUITAINE,BISCARROSSE,19493,4004,23497,M0076
Musée de Borda,2019,NOUVELLE-AQUITAINE,DAX,5770,8413,14183,M0077
Musée Despiau-Wlérick,2019,NOUVELLE-AQUITAINE,MONT-DE-MARSAN,7243,48112,55355,M0081
Musée Municipal du Lac,2019,NOUVELLE-AQUITAINE,SANGUINET,2512,1177,3689,M0085
Musée de Préhistoire Mésolithique Laurent Coulonges,2019,NOUVELLE-AQUITAINE,SAUVETERRE-LA-LEMANCE,2438,366,2804,M0090
Musée Municipal (Moulin de Gajac),2019,NOUVELLE-AQUITAINE,VILLENEUVE-SUR-LOT,3476,3700,7176,M0091
Musée Bonnat-Helleu - Musée des Beaux-Arts de Bayonne,2019,NOUVELLE-AQUITAINE,BAYONNE,0,737,737,M0094
Musée Gallo-Romain de Claracq,2019,NOUVELLE-AQUITAINE,CLARACQ,2182,1276,3458,M1198
Musée Charbonneau-Lassay,2019,NOUVELLE-AQUITAINE,LOUDUN,0,1850,1850,M0850
Musée de l'hypogée des Dunes,2019,NOUVELLE-AQUITAINE,POITIERS,0,462,462,M0853
Collection d'Histoire Naturelle,2019,NOUVELLE-AQUITAINE,POITIERS,30740,42819,73559,M7057
Musée de la Préhistoire,2019,OCCITANIE,LE MAS-D'AZIL,48398,7798,56196,M0544
Musée de la Forge,2019,OCCITANIE,MONTGAILHARD,32509,0,32509,M1091
Musée Archéologique,2019,OCCITANIE,SALLELES-D'AUDE,5693,4123,9816,M0446
Musée Régional de Géologie Pierre Vetter,2019,OCCITANIE,DECAZEVILLE,0,100,100,M7066
Musée Municipal de Millau,2019,OCCITANIE,MILLAU,3489,9089,12578,M0549
Musée des Beaux-Arts,2019,OCCITANIE,NÎMES,5834,8247,14081,M0457
Musée Départemental d'Art Sacré du Gard,2019,OCCITANIE,PONT-SAINT-ESPRIT,75,9452,9527,M0461
Maison Rouge - Musée des Vallées Cévenoles,2019,OCCITANIE,SAINT-JEAN-DU-GARD,29106,9588,38694,M1079
Musée Municipal Georges Borias,2019,OCCITANIE,UZES,1237,2271,3508,M0463
Musée Archéologique,2019,OCCITANIE,EAUZE,7412,2324,9736,M0571
Musée des Beaux-Arts et des Arts Décoratifs,2019,OCCITANIE,MIRANDE,142,1853,1995,M0574
Musée des Augustins,2019,OCCITANIE,TOULOUSE,14585,45238,59823,M0562
Musée Georges Labit,2019,OCCITANIE,TOULOUSE,9096,32994,42090,M0564
Musée de l'Hôtel d'Espeyran,2019,OCCITANIE,MONTPELLIER,14501,0,14501,M0477
Musée Toulouse Lautrec,2019,OCCITANIE,ALBI,140517,35562,176079,M0592
Musée Eugénie et Maurice Guérin,2019,OCCITANIE,ANDILLAC,1467,3947,5414,M0593
Musée du Protestantisme de la Réforme à la Laïcité,2019,OCCITANIE,FONTRIEU,1188,731,1919,M0597
Musée de l'Abbaye Saint-Michel,2019,OCCITANIE,GAILLAC,1338,455,1793,M0598
Musée  Départemental Dobrée,2019,PAYS DE LA LOIRE,NANTES,0,23178,23178,M0745
Musée du Pays de Retz,2019,PAYS DE LA LOIRE,VILLENEUVE-EN-RETZ,2183,1321,3504,M0739
Musée de l'Ardoise,2019,PAYS DE LA LOIRE,TRELAZE,8130,464,8594,M0760
Musée des Tisserands Mayennais,2019,PAYS DE LA LOIRE,AMBRIERES-LES-VALLEES,196,89,285,M0761
Musée de l'Ardoise et de la Géologie,2019,PAYS DE LA LOIRE,RENAZE,143,1019,1162,M0768
Musée de la Reine Bérengère,2019,PAYS DE LA LOIRE,LE MANS,1862,6002,7864,M0771
Centre Minier de Faymoreau,2019,PAYS DE LA LOIRE,FAYMOREAU-LES-MINES,21098,5878,26976,M0772
Musée Municipal,2019,PAYS DE LA LOIRE,LA ROCHE-SUR-YON,0,17763,17763,M0776
Musée de la vallée,2019,PROVENCE-ALPES-CÔTE D'AZUR,BARCELONNETTE,7900,1762,9662,M0856
Musée départemental de préhistoire,2019,PROVENCE-ALPES-CÔTE D'AZUR,QUINSON,58681,10919,69600,M0861
Musée d'Art et d'Histoire - Palais Massena,2019,PROVENCE-ALPES-CÔTE D'AZUR,NICE,31463,48321,79784,M0881
Musée du Palais Lascaris,2019,PROVENCE-ALPES-CÔTE D'AZUR,NICE,20679,24662,45321,M0887
Musée Départemental des Arts Asiatiques,2019,PROVENCE-ALPES-CÔTE D'AZUR,NICE,1894,55739,57633,M0889
Musée d'art et d'histoire - Musées de la Citadelle,2019,PROVENCE-ALPES-CÔTE D'AZUR,VILLEFRANCHE-SUR-MER,0,13376,13376,M0893
Musée du Parlement de Provence et du Vieil Aix,2019,PROVENCE-ALPES-CÔTE D'AZUR,AIX-EN-PROVENCE,4974,6912,11886,M0898
Musée- Atelier de Paul Cézanne,2019,PROVENCE-ALPES-CÔTE D'AZUR,AIX-EN-PROVENCE,76013,5000,81013,M0895
Musée Réattu,2019,PROVENCE-ALPES-CÔTE D'AZUR,ARLES,8830,29799,38629,M0900
Muséon Arlaten,2019,PROVENCE-ALPES-CÔTE D'AZUR,ARLES,0,1486,1486,M0902
Musée Frédéric Mistral,2019,PROVENCE-ALPES-CÔTE D'AZUR,MAILLANE,1634,0,1634,M0911
Muséum d'Histoire Naturelle,2019,PROVENCE-ALPES-CÔTE D'AZUR,MARSEILLE,5371,28560,33931,M7044
Musée Cantini,2019,PROVENCE-ALPES-CÔTE D'AZUR,MARSEILLE,14917,30014,44931,M0915
Musée des Alpilles Pierre de Brun,2019,PROVENCE-ALPES-CÔTE D'AZUR,SAINT-REMY-DE-PROVENCE,2972,4728,7700,M0926
Musée Départemental des Hautes-Alpes,2019,PROVENCE-ALPES-CÔTE D'AZUR,GAP,0,17772,17772,M0866
Musée des Arts et d’Histoire,2019,PROVENCE-ALPES-CÔTE D'AZUR,BORMES-LES-MIMOSAS,0,12052,12052,M0931
Musée du Vêtement Provençal (Jean Aicard),2019,PROVENCE-ALPES-CÔTE D'AZUR,SOLLIES-VILLE,0,5459,5459,M0942
Musée du Petit Palais,2019,PROVENCE-ALPES-CÔTE D'AZUR,AVIGNON,0,43484,43484,M0947
Musée-Bibliothèque François Pétrarque,2019,PROVENCE-ALPES-CÔTE D'AZUR,FONTAINE-DE-VAUCLUSE,1545,1994,3539,M0956
Musée Jean Garcin 39-45 : L'appel de la Liberté,2019,PROVENCE-ALPES-CÔTE D'AZUR,FONTAINE-DE-VAUCLUSE,2806,7960,10766,M1180
Musée Départemental du Cartonnage et de l'Imprimerie,2019,PROVENCE-ALPES-CÔTE D'AZUR,VALREAS,3433,0,3433,M0962
Musée du Brou,2020,AUVERGNE-RHONE-ALPES,BOURG-EN-BRESSE,28135,16495,44630,M0963
Musée Archéologique,2020,AUVERGNE-RHONE-ALPES,IZERNORE,498,477,975,M0966
Musée du Peigne et de la Plasturgie,2020,AUVERGNE-RHONE-ALPES,OYONNAX,646,492,1138,M0969
Musée Charles-Louis Philippe,2020,AUVERGNE-RHONE-ALPES,CERILLY,18,26,44,M0102
Musée Anne de Beaujeu,2020,AUVERGNE-RHONE-ALPES,MOULINS,13561,4655,18216,M0106
Musée d'Art et d'Archéologie,2020,AUVERGNE-RHONE-ALPES,AURILLAC,426,4180,4606,M0110
Musée d'art et d'histoire Alfred Douët,2020,AUVERGNE-RHONE-ALPES,SAINT-FLOUR,1309,1035,2344,M0114
Musée des Beaux-Arts,2020,AUVERGNE-RHONE-ALPES,VALENCE,12071,4390,16461,M0988
Musée de Bourgoin-Jallieu,2020,AUVERGNE-RHONE-ALPES,BOURGOIN-JALLIEU,2454,2464,4918,M0991
Musée du Cloître Saint-André-Le-Bas,2020,AUVERGNE-RHONE-ALPES,VIENNE,4524,0,4524,M1007
Musée Départemental de la Révolution Française,2020,AUVERGNE-RHONE-ALPES,VIZILLE,0,38786,38786,M1008
Musée de la Soierie,2020,AUVERGNE-RHONE-ALPES,CHARLIEU,2126,263,2389,M1010
Musée de la Dentelle,2020,AUVERGNE-RHONE-ALPES,ARLANC,930,20,950,M0119
Musée d'Art Roger-Quillot,2020,AUVERGNE-RHONE-ALPES,CLERMONT-FERRAND,2052,9362,11414,M0121
Musée des Sapeurs-Pompiers de Lyon,2020,AUVERGNE-RHONE-ALPES,LYON,2219,3935,6154,M1128
Lugdunum - Musée et Théâtres Romains,2020,AUVERGNE-RHONE-ALPES,LYON,16599,22328,38927,M1036
Musée Archéologique,2020,AUVERGNE-RHONE-ALPES,SAINT-ROMAIN-EN-GAL,9362,14887,24249,M1042
Musée Municipal d'Albertville-Conflans,2020,AUVERGNE-RHONE-ALPES,ALBERTVILLE,2762,0,2762,M1046
Musée des Charmettes,2020,AUVERGNE-RHONE-ALPES,CHAMBERY,0,7901,7901,M1049
Muséum d'Histoire Naturelle - Jardin des Sciences,2020,BOURGOGNE-FRANCHE-COMTE,DIJON,4918,42402,47320,M7035
Musée des Beaux-Arts,2020,BOURGOGNE-FRANCHE-COMTE,DIJON Cedex,0,134995,134995,M0137
Musée Municipal François Pompon,2020,BOURGOGNE-FRANCHE-COMTE,SAULIEU,2669,1616,4285,M0146
Musée Comtois,2020,BOURGOGNE-FRANCHE-COMTE,BESANCON,20313,0,20313,M0334
Musée des Beaux-Arts et d'Archéologie,2020,BOURGOGNE-FRANCHE-COMTE,BESANCON,9311,43788,53099,M0332
Musée Départemental Albert-et-Félicie Demard - ATP,2020,BOURGOGNE-FRANCHE-COMTE,CHAMPLITTE,1948,2149,4097,M0354
Musée des Beaux-Arts,2020,BOURGOGNE-FRANCHE-COMTE,LONS-LE-SAUNIER,771,1402,2173,M0345
Musée d'Art et d'Histoire Romain Rolland,2020,BOURGOGNE-FRANCHE-COMTE,CLAMECY,1066,820,1886,M0150
Museum d'Histoire Naturelle Jacques de La Comble,2020,BOURGOGNE-FRANCHE-COMTE,AUTUN,586,1067,1653,M7019
Musée Saint-Nazaire,2020,BOURGOGNE-FRANCHE-COMTE,BOURBON-LANCY,0,598,598,M0164
Musée de la Tour du Moulin,2020,BOURGOGNE-FRANCHE-COMTE,MARCIGNY,463,322,785,M0174
Ecomusée de la Bresse Bourguignonne,2020,BOURGOGNE-FRANCHE-COMTE,PIERRE-DE-BRESSE,9142,5598,14740,M0177
Musée Frédéric Japy,2020,BOURGOGNE-FRANCHE-COMTE,BEAUCOURT,409,317,726,M0360
Musée d'Art et d'Histoire,2020,BOURGOGNE-FRANCHE-COMTE,BELFORT cedex,2477,10317,12794,M0361
Muséum - Maison de l'Eau,2020,BOURGOGNE-FRANCHE-COMTE,AUXERRE,0,5683,5683,M7020
Musée des Arts Naïfs et Populaires de Noyers sur Serein,2020,BOURGOGNE-FRANCHE-COMTE,NOYERS-SUR-SEREIN,1511,276,1787,M0187
Musée Mathurin Meheut,2020,BRETAGNE,LAMBALLE,3867,708,4575,M0195
Ecomusée de Saint-Dégan,2020,BRETAGNE,BRECH,4775,822,5597,M0220
Musée d'Histoire et d'Archéologie de Vannes,2020,BRETAGNE,VANNES,4267,1923,6190,M0227
Musée Municipal,2020,CENTRE-VAL DE LOIRE,VIERZON,235,3509,3744,M0236
Musées de Châteauroux - Hôtel Bertrand,2020,CENTRE-VAL DE LOIRE,CHATEAUROUX,0,3465,3465,M0247
Musée de l'Hospice Saint-Roch,2020,CENTRE-VAL DE LOIRE,ISSOUDUN,0,11811,11811,M0248
Musée Lansyer,2020,CENTRE-VAL DE LOIRE,LOCHES,1681,700,2381,M0260
Musée François Rabelais,2020,CENTRE-VAL DE LOIRE,SEUILLY,5779,1470,7249,M0264
Muséum d'Histoire Naturelle,2020,CENTRE-VAL DE LOIRE,TOURS,11598,0,11598,M7062
Musée des Beaux-Arts,2020,CENTRE-VAL DE LOIRE,TOURS,11525,16526,28051,M0265
Muséum d'Histoire Naturelle,2020,CENTRE-VAL DE LOIRE,BLOIS,2356,4736,7092,M7024
Maison de la Magie,2020,CENTRE-VAL DE LOIRE,BLOIS,42709,0,42709,M1083
Musée Municipal Théâtre Forain et Archéologique,2020,CENTRE-VAL DE LOIRE,ARTENAY,2295,741,3036,M0278
Musée Municipal,2020,CENTRE-VAL DE LOIRE,PITHIVIERS Cedex,0,771,771,M0289
Musée d'Histoire de Bastia,2020,CORSE,BASTIA Cedex,7827,3589,11416,M0329
Musée de la Corse,2020,CORSE,CORTE,20830,4395,25225,M0330
Musée Napoléon Ier,2020,GRAND EST,BRIENNE-LE-CHATEAU,4133,828,4961,M0299
Musée de la Bonneterie,2020,GRAND EST,TROYES,1681,4924,6605,M0304
Musée Historique,2020,GRAND EST,HAGUENAU,1090,1436,2526,M0005
Musée des Beaux-Arts,2020,GRAND EST,STRASBOURG,16099,16322,32421,M0019
Musée des Arts Décoratifs,2020,GRAND EST,STRASBOURG,13871,15054,28925,M0018
Muséum d'Histoire Naturelle et d'Ethnographie de Colmar,2020,GRAND EST,COLMAR,5735,3284,9019,M7033
Musée Théodore Deck et des Pays du Florival,2020,GRAND EST,GUEBWILLER,514,805,1319,M0029
Musée Historique et Militaire de Huningue,2020,GRAND EST,HUNINGUE,72,54,126,M0030
Ecomusée d'Alsace,2020,GRAND EST,UNGERSHEIM,68933,5725,74658,M0048
Musée du Château de Lunéville,2020,GRAND EST,LUNEVILLE,14239,22661,36900,M0511
Musée d'Art et d'Histoire de Toul,2020,GRAND EST,TOUL,0,2883,2883,M0515
Musée Jules Bastien-Lepage - Musée de la Fortification,2020,GRAND EST,MONTMEDY,7859,893,8752,M0519
Musée de la Princerie,2020,GRAND EST,VERDUN,0,3266,3266,M0525
Musée Départemental du Sel,2020,GRAND EST,MARSAL,470,5092,5562,M0527
Musée des Mines de fer de Lorraine,2020,GRAND EST,NEUFCHEF,4145,289,4434,M0530
Musée Charles de Bruyères,2020,GRAND EST,REMIREMONT,258,1056,1314,M0540
Ecomusée de Marie-Galante,2020,GUADELOUPE,GRAND-BOURG de MARIE-GALANTE,0,19499,19499,M1059
Musée Départemental Victor Schoelcher,2020,GUADELOUPE,POINTE-A-PITRE,0,159,159,M1061
Musée Jean de la Fontaine,2020,HAUTS-DE-France,CHATEAU-THIERRY,4476,1770,6246,M0784
Musée Jeanne d'Aboville,2020,HAUTS-DE-France,LA FERE,346,882,1228,M0789
Musée Municipal de Soissons,2020,HAUTS-DE-France,SOISSONS,2790,1648,4438,M0794
Musée de La Thiérache,2020,HAUTS-DE-France,VERVINS,0,3216,3216,M0795
Musée de l'Ostrevant,2020,HAUTS-DE-France,BOUCHAIN,80,11,91,M0614
Musée Portuaire,2020,HAUTS-DE-France,DUNKERQUE,16078,6816,22894,M0622
Musée du Dessin et de l'Estampe Originale,2020,HAUTS-DE-France,GRAVELINES,1283,1467,2750,M0625
Musée Départemental Matisse,2020,HAUTS-DE-France,LE CATEAU-CAMBRESIS,24320,12702,37022,M0627
MUDO - Musée de l'Oise,2020,HAUTS-DE-France,BEAUVAIS,0,27154,27154,M0798
Musée de la Figurine Historique,2020,HAUTS-DE-France,COMPIEGNE,1506,2616,4122,M0804
Musée Antoine Vivenel,2020,HAUTS-DE-France,COMPIEGNE,1024,7249,8273,M0803
Musée de Boulogne-sur-Mer,2020,HAUTS-DE-France,BOULOGNE-SUR-MER,6829,7044,13873,M0643
Cité Internationale de la Dentelle et de la Mode de Calais,2020,HAUTS-DE-France,CALAIS,14389,5088,19477,M1177
Musée d'Histoire et d'Archéologie,2020,HAUTS-DE-France,HARNES,0,161,161,M0647
Louvre-Lens,2020,HAUTS-DE-France,LENS,30730,185615,216345,
Musée Dunoyer de Segonzac,2020,ILE-DE-France,BOUSSY-SAINT-ANTOINE,0,0,0,M0402
Musée Municipal Robert Dubois-Corneau,2020,ILE-DE-France,BRUNOY,27,1686,1713,M0403
Musée National des Châteaux de Malmaison et de Bois-Préau,2020,ILE-DE-France,RUEIL-MALMAISON,11580,10338,21918,M5016
Musée des Avelines - Musée d'Art et d'Histoire,2020,ILE-DE-France,SAINT-CLOUD,2540,7668,10208,M0416
Musée d'Art et d'Histoire de l'Hôpital Sainte-Anne,2020,ILE-DE-France,PARIS,1251,2140,3391,M1202
Musée d'Art et d'Histoire du Judaïsme,2020,ILE-DE-France,PARIS,19357,22828,42185,M0364
Crypte Archéologique du Parvis Notre-Dame,2020,ILE-DE-France,PARIS,4618,5682,10300,M1104
Musée de l'Armée,2020,ILE-DE-France,PARIS,122497,228521,351018,M5025
Musée National Eugène Delacroix,2020,ILE-DE-France,PARIS,6946,13839,20785,M5004
Maison de Victor Hugo,2020,ILE-DE-France,PARIS,0,100,100,M1114
"Musée Cernuschi, Musée des Arts de l'Asie de la ville de Paris",2020,ILE-DE-France,PARIS,2859,23251,26110,M1106
Musée de la Vie Romantique,2020,ILE-DE-France,PARIS,18623,71952,90575,M1113
Établissement Public de la Porte Dorée - (MNHI - Aquarium - Palais),2020,ILE-DE-France,PARIS,108642,111070,219712,M5084
Musée Bourdelle,2020,ILE-DE-France,PARIS,15977,34827,50804,M1103
Musée des Monuments Français - CAPA,2020,ILE-DE-France,PARIS,51963,65900,117863,M5042
Etablissement Public du Musée des Arts Asiatiques Guimet,2020,ILE-DE-France,PARIS,45578,50758,96336,M5005
Musée du 11 Conti - Monnaie de Paris,2020,ILE-DE-France,PARIS,26100,18900,45000,M5066
Musée Gatien Bonnet,2020,ILE-DE-France,LAGNY-SUR-MARNE,0,1385,1385,M0376
Musée Bossuet,2020,ILE-DE-France,MEAUX,0,6175,6175,M0378
Musée de la Gendarmerie Nationale,2020,ILE-DE-France,MELUN,9482,6419,15901,M9013
Musée d'Art et d'Histoire Paul Eluard,2020,ILE-DE-France,SAINT-DENIS,1232,4480,5712,M0422
Musée Archéologique du Val d'Oise,2020,ILE-DE-France,GUIRY-EN-VEXIN,0,11527,11527,M0434
Musée d'Art et d'Histoire Louis Senlecq,2020,ILE-DE-France,L'ISLE-ADAM,1159,1353,2512,M0435
Musée Camille Pissarro,2020,ILE-DE-France,PONTOISE,1635,848,2483,M0439
Musée de la Toile de Jouy,2020,ILE-DE-France,JOUY-EN-JOSAS,4265,2044,6309,M0388
Musée-Maison Maurice Ravel,2020,ILE-DE-France,MONTFORT-L'AMAURY,687,72,759,M0392
Musée de la Ville,2020,ILE-DE-France,MONTIGNY-LE-BRETONNEUX,1079,4395,5474,M0398
Musée du Jouet Pierre Pinel,2020,ILE-DE-France,POISSY,6447,3395,9842,M0394
Musée National des Châteaux de Versailles et de Trianon,2020,ILE-DE-France,VERSAILLES,1441353,582363,2023716,M5077
Musée de La Canne,2020,MARTINIQUE,LES TROIS ILETS,4393,413,4806,M1067
Musée du Débarquement,2020,NORMANDIE,ARROMANCHES,90997,2969,93966,M0654
Musée de Normandie,2020,NORMANDIE,CAEN,9301,16037,25338,M0658
Musée d'Art et d'Histoire de Lisieux,2020,NORMANDIE,LISIEUX,13,1926,1939,M0665
Musée du Château,2020,NORMANDIE,PONTECOULANT,1330,1395,2725,M0667
Musée de la Bataille de Tilly-Sur-Seulles 1944,2020,NORMANDIE,TILLY-SUR-SEULLES,864,0,864,M0670
Musée Christian Dior,2020,NORMANDIE,GRANVILLE,0,39791,39791,M0684
Musée Barbey d'Aurevilly,2020,NORMANDIE,SAINT-SAUVEUR-LE-VICOMTE,559,214,773,M0688
Musée Maritime de l'Ile de Tatihou,2020,NORMANDIE,SAINT-VAAST-LA-HOUGUE,35421,1994,37415,M0689
Musée Régional du Cidre et du Calvados,2020,NORMANDIE,VALOGNES,1060,746,1806,M0691
Musée du Château de Flers,2020,NORMANDIE,FLERS cedex,26,4167,4193,M0695
Musée de l'Hôtel Dubocage de Bléville,2020,NORMANDIE,LE HAVRE,0,7214,7214,M0718
Musée Flaubert et d'Histoire de la Médecine,2020,NORMANDIE,ROUEN,738,1048,1786,M0734
Musée Archéologique et Historique,2020,NOUVELLE-AQUITAINE,ANGOULEME,0,116,116,M0821
Musée Municipal de Cognac,2020,NOUVELLE-AQUITAINE,COGNAC,1694,500,2194,M0822
Musée des Arts du Cognac,2020,NOUVELLE-AQUITAINE,COGNAC,6162,1149,7311,M0822
Musée du Nouveau Monde,2020,NOUVELLE-AQUITAINE,LA ROCHELLE,4479,8209,12688,M0827
Musée Protestant,2020,NOUVELLE-AQUITAINE,LA ROCHELLE,322,223,545,M0828
Muséum d'Histoire Naturelle et d'Ethnographie,2020,NOUVELLE-AQUITAINE,LA ROCHELLE,7582,22745,30327,M7040
Musée National de la Marine,2020,NOUVELLE-AQUITAINE,ROCHEFORT,4423,30521,34944,M5026
Ancienne École de médecine navale - Musée national de la Marine,2020,NOUVELLE-AQUITAINE,ROCHEFORT,1687,1661,3348,M5026
Musée Archéologique,2020,NOUVELLE-AQUITAINE,SAINTES,462,1204,1666,M0835
Musée Labenche d'Art et d'Histoire,2020,NOUVELLE-AQUITAINE,BRIVE-LA-GAILLARDE,1192,21032,22224,M0499
Musée du Tabac,2020,NOUVELLE-AQUITAINE,BERGERAC,3155,1373,4528,M0049
Château de Bourdeilles,2020,NOUVELLE-AQUITAINE,BOURDEILLES,22600,0,22600,M0050
Musée Fernand Desmoulin,2020,NOUVELLE-AQUITAINE,BRANTOME EN PERIGORD,33518,0,33518,M0051
Musée National de la Préhistoire,2020,NOUVELLE-AQUITAINE,LES EYZIES,25412,20800,46212,M5014
Musée des Arts Décoratifs et du Design,2020,NOUVELLE-AQUITAINE,BORDEAUX,7787,50761,58548,M0066
Musée Municipal des Beaux-Arts de Limoges - Palais de l'Evêché,2020,NOUVELLE-AQUITAINE,LIMOGES,2273,13791,16064,M0505
Ecomusée de la Grande Lande,2020,NOUVELLE-AQUITAINE,SABRES,43085,6480,49565,M0080
Muséum d'Histoire Naturelle,2020,NOUVELLE-AQUITAINE,BAYONNE,0,7099,7099,M7065
Musée Edmond Rostand,2020,NOUVELLE-AQUITAINE,CAMBO-LES-BAINS,51453,2156,53609,M0095
Musée d'Art et d'Histoire de Montmorillon,2020,NOUVELLE-AQUITAINE,MONTMORILLON,0,980,980,M0851
Musée Départemental de l'Ariège,2020,OCCITANIE,FOIX,68513,4527,73040,M0543
Musée d'Archéologie,2020,OCCITANIE,MONTSEGUR,5980,0,5980,M0545
Musée Petiet,2020,OCCITANIE,LIMOUX,242,892,1134,M0443
Musée Joseph Vaylet,2020,OCCITANIE,ESPALION,136,5794,5930,M0548
Musée Fenaille,2020,OCCITANIE,RODEZ,12362,3350,15712,M0551
Musée Soulages,2020,OCCITANIE,RODEZ,61980,19656,81636,M1129
Musée Albert André,2020,OCCITANIE,BAGNOLS-SUR-CEZE,24,1737,1761,M1207
Musée du Vieux Nîmes,2020,OCCITANIE,NÎMES,2492,1459,3951,M0458
Musée de la Maison Romane,2020,OCCITANIE,SAINT-GILLES-DU-GARD,0,111,111,M0462
Musée Pierre de Luxembourg,2020,OCCITANIE,VILLENEUVE-LES-AVIGNON,2099,1264,3363,M0464
Musée d'Archéologie,2020,OCCITANIE,LECTOURE,932,908,1840,M0572
Musée Massey,2020,OCCITANIE,TARBES,2155,2151,4306,M0591
Musée Agathois,2020,OCCITANIE,AGDE,349,2275,2624,M0466
Musée de l'Ephèbe,2020,OCCITANIE,LE CAP D'AGDE,10096,0,10096,M0465
Site Archéologique Lattara - Musée Henri Prades de Montpellier Agglomération,2020,OCCITANIE,LATTES Cédex,6608,4612,11220,M0472
Musée du Vieux Montpellier,2020,OCCITANIE,MONTPELLIER,447,1895,2342,M0478
Muséum d'Histoire Naturelle,2020,OCCITANIE,PERPIGNAN,0,5941,5941,M7055
Musée de Tautavel,2020,OCCITANIE,TAUTAVEL,28646,4881,33527,M0498
Musée Jean Jaurès,2020,OCCITANIE,CASTRES,1670,2687,4357,M0595
Musée Goya,2020,OCCITANIE,CASTRES,8362,2386,10748,M0594
Musée du Protestantisme de la Réforme à la Laïcité,2020,OCCITANIE,FONTRIEU,893,455,1348,M0597
Musée des Beaux-Arts,2020,OCCITANIE,GAILLAC,419,340,759,M0599
Archéosite de Montans,2020,OCCITANIE,MONTANS,940,1688,2628,M1210
Musée du Pays de Guérande et de la Porte Saint Michel,2020,PAYS DE LA LOIRE,GUERANDE Cedex,1153,580,1733,M0741
Musée Jules-Desbois,2020,PAYS DE LA LOIRE,PARCAY-LES-PINS,1543,424,1967,M1092
Musée de Fontenay-le-Comte,2020,PAYS DE LA LOIRE,FONTENAY-LE-COMTE,1112,579,1691,M0773
Historial de la Vendée,2020,PAYS DE LA LOIRE,LES LUCS-SUR-BOULOGNE,13862,14542,28404,M1121
Musée archéologique,2020,PROVENCE-ALPES-CÔTE D'AZUR,VACHERES,450,128,578,M0864
Musée Renoir,2020,PROVENCE-ALPES-CÔTE D'AZUR,CAGNES-SUR-MER,8080,5592,13672,M0871
Musée des Explorations du Monde,2020,PROVENCE-ALPES-CÔTE D'AZUR,CANNES,7073,8003,15076,M0872
Musée Départemental des Arts Asiatiques,2020,PROVENCE-ALPES-CÔTE D'AZUR,NICE,871,21977,22848,M0889
Musée d'Art et d'Histoire,2020,PROVENCE-ALPES-CÔTE D'AZUR,NICE,9623,25837,35460,M0881
Musée des Tapisseries,2020,PROVENCE-ALPES-CÔTE D'AZUR,AIX-EN-PROVENCE,1324,4213,5537,M0897
Musée Granet,2020,PROVENCE-ALPES-CÔTE D'AZUR,AIX-EN-PROVENCE,34082,34083,68165,M0894
Musée Municipal Méditerranéen de Cassis A.T.P.,2020,PROVENCE-ALPES-CÔTE D'AZUR,CASSIS,20,1214,1234,M0904
Musée Ciotaden,2020,PROVENCE-ALPES-CÔTE D'AZUR,LA CIOTAT,420,1172,1592,M0907
Musée Grobet-Labadié,2020,PROVENCE-ALPES-CÔTE D'AZUR,MARSEILLE,5672,0,5672,M0917
Muséum d'Histoire Naturelle,2020,PROVENCE-ALPES-CÔTE D'AZUR,MARSEILLE,2341,23360,25701,M7044
Musée Municipal Paul Lafran,2020,PROVENCE-ALPES-CÔTE D'AZUR,SAINT-CHAMAS,0,946,946,M0925
Musée des Arts et d’Histoire,2020,PROVENCE-ALPES-CÔTE D'AZUR,BORMES-LES-MIMOSAS,0,9856,9856,M0931
Musée du Pays Brignolais,2020,PROVENCE-ALPES-CÔTE D'AZUR,BRIGNOLES,806,200,1006,M0932
Musée d'Apt,2020,PROVENCE-ALPES-CÔTE D'AZUR,APT,1107,1669,2776,M0945
Musée Jean Garcin 39-45 : L'appel de la Liberté,2020,PROVENCE-ALPES-CÔTE D'AZUR,FONTAINE-DE-VAUCLUSE,3160,1035,4195,M1180
